,FLAG_CF,PREPARATION_DATE,PDT_COD,PDT_DSC,TRANSFORMABLE,INNO,IMPLUSE,Umbrella_Brand,Import_type,Usine,PLT_COD,PLT_DSC,PREVISION_NATIONAL,COMMANDE_NATIONAL,ALLOUE_NATIONAL,LIVRE_NATIONAL,ECART_ALLOC_NATIONAL,RUPTURE_NATIONAL,RUPTURE_STKA_NATIONAL,NO_FORECAST_NAT,ECART_PREVISION_NAT,ECART_PREVISION_NAT_PERCENT,PREVISION,COMMANDE,ALLOUE,LIVRE,ECART_ALLOC,RUPTURE,RUPTURE_STKA,NO_FORECAST,ECART_PREVISON,ECART_PREVISION_PERCENT,CSL_ALLOC,CSL,PERTE_CSL_vs_ALLOC,CSL_ALLOC_NATIONAL,CSL_NATIONAL,PERTE_CSL_vs_ALLOC_NATIONAL,Cause_Pareto
0,0,2019-01-02,122329,POT VERRE CITRUS x2 FR - AFH,0,0,1,DANONE,1,Aldaya(ES),0084,0024 FR AIX (DC),322,268,148,148,0,120,120,0,-54,16.770186335403725,54,1,1,1,0,0,0,0,-53,98.14814814814815,100.0,100.0,0.0,55.223880597014926,55.223880597014926,0.0,Previsions
1,0,2019-01-02,122329,POT VERRE CITRUS x2 FR - AFH,0,0,1,DANONE,1,Aldaya(ES),0081,0024 FR TOURS (DC),322,268,148,148,0,120,120,0,-54,16.770186335403725,10,3,3,3,0,0,0,0,-7,70.0,100.0,100.0,0.0,55.223880597014926,55.223880597014926,0.0,Previsions
2,0,2019-01-02,122329,POT VERRE CITRUS x2 FR - AFH,0,0,1,DANONE,1,Aldaya(ES),0082,0024 FR VALLET (DC),322,268,148,148,0,120,120,0,-54,16.770186335403725,25,47,47,47,0,0,0,0,22,-88.0,100.0,100.0,0.0,55.223880597014926,55.223880597014926,0.0,Previsions
3,0,2019-01-02,122329,POT VERRE CITRUS x2 FR - AFH,0,0,1,DANONE,1,Aldaya(ES),0085,0024 FR TOULOUSE (DC),322,268,148,148,0,120,120,0,-54,16.770186335403725,22,26,26,26,0,0,0,0,4,-18.181818181818183,100.0,100.0,0.0,55.223880597014926,55.223880597014926,0.0,Previsions
4,0,2019-01-02,122329,POT VERRE CITRUS x2 FR - AFH,0,0,1,DANONE,1,Aldaya(ES),0083,0024 FR CHAPONNAY (DC),322,268,148,148,0,120,120,0,-54,16.770186335403725,24,22,22,22,0,0,0,0,-2,8.333333333333334,100.0,100.0,0.0,55.223880597014926,55.223880597014926,0.0,Previsions
5,0,2019-01-02,122329,POT VERRE CITRUS x2 FR - AFH,0,0,1,DANONE,1,Aldaya(ES),0079,0024 FR PARIS SUD (DC),322,268,148,148,0,120,120,0,-54,16.770186335403725,187,169,49,49,0,120,120,0,-18,9.62566844919786,28.994082840236686,28.994082840236686,0.0,55.223880597014926,55.223880597014926,0.0,Previsions
6,0,2019-01-02,127908,GERVAIS GRIEGO 115X2 BLUEBERRY FR,0,0,0,GERVAIS,1,Rosenheim(ALL),0084,0024 FR AIX (DC),1298,812,812,646,166,166,0,0,-486,37.442218798151,135,76,76,76,0,0,0,0,-59,43.7037037037037,100.0,100.0,0.0,100.0,79.55665024630541,20.44334975369459,A Creuser
7,0,2019-01-02,127908,GERVAIS GRIEGO 115X2 BLUEBERRY FR,0,0,0,GERVAIS,1,Rosenheim(ALL),0080,0024 FR METZ (DC),1298,812,812,646,166,166,0,0,-486,37.442218798151,20,113,113,113,0,0,0,0,93,-465.0,100.0,100.0,0.0,100.0,79.55665024630541,20.44334975369459,A Creuser
8,0,2019-01-02,127908,GERVAIS GRIEGO 115X2 BLUEBERRY FR,0,0,0,GERVAIS,1,Rosenheim(ALL),0081,0024 FR TOURS (DC),1298,812,812,646,166,166,0,0,-486,37.442218798151,412,65,65,65,0,0,0,0,-347,84.22330097087378,100.0,100.0,0.0,100.0,79.55665024630541,20.44334975369459,A Creuser
9,0,2019-01-02,127908,GERVAIS GRIEGO 115X2 BLUEBERRY FR,0,0,0,GERVAIS,1,Rosenheim(ALL),0082,0024 FR VALLET (DC),1298,812,812,646,166,166,0,0,-486,37.442218798151,182,114,114,114,0,0,0,0,-68,37.362637362637365,100.0,100.0,0.0,100.0,79.55665024630541,20.44334975369459,A Creuser
10,0,2019-01-02,127908,GERVAIS GRIEGO 115X2 BLUEBERRY FR,0,0,0,GERVAIS,1,Rosenheim(ALL),0077,0024 FR LILPARK (DC),1298,812,812,646,166,166,0,0,-486,37.442218798151,98,71,71,71,0,0,0,0,-27,27.551020408163264,100.0,100.0,0.0,100.0,79.55665024630541,20.44334975369459,A Creuser
11,0,2019-01-02,127908,GERVAIS GRIEGO 115X2 BLUEBERRY FR,0,0,0,GERVAIS,1,Rosenheim(ALL),0083,0024 FR CHAPONNAY (DC),1298,812,812,646,166,166,0,0,-486,37.442218798151,291,166,166,0,166,166,0,0,-125,42.955326460481096,100.0,0.0,100.0,100.0,79.55665024630541,20.44334975369459,A Creuser
12,0,2019-01-02,127908,GERVAIS GRIEGO 115X2 BLUEBERRY FR,0,0,0,GERVAIS,1,Rosenheim(ALL),0079,0024 FR PARIS SUD (DC),1298,812,812,646,166,166,0,0,-486,37.442218798151,9,121,121,121,0,0,0,0,112,-1244.4444444444443,100.0,100.0,0.0,100.0,79.55665024630541,20.44334975369459,A Creuser
13,0,2019-01-02,127908,GERVAIS GRIEGO 115X2 BLUEBERRY FR,0,0,0,GERVAIS,1,Rosenheim(ALL),0078,0024 FR PARIS NORD (DC),1298,812,812,646,166,166,0,0,-486,37.442218798151,151,86,86,86,0,0,0,0,-65,43.04635761589404,100.0,100.0,0.0,100.0,79.55665024630541,20.44334975369459,A Creuser
14,1,2019-01-02,132457,ACTIVIA SAV COCO 125X4 OD,0,0,0,ACTIVIA,0,Bailleul(FR),0081,0024 FR TOURS (DC),214,168,42,42,0,126,126,0,-46,21.49532710280374,49,21,6,6,0,15,15,0,-28,57.142857142857146,28.57142857142857,28.57142857142857,0.0,25.0,25.0,0.0,Previsions
15,1,2019-01-02,132457,ACTIVIA SAV COCO 125X4 OD,0,0,0,ACTIVIA,0,Bailleul(FR),0085,0024 FR TOULOUSE (DC),214,168,42,42,0,126,126,0,-46,21.49532710280374,49,19,1,1,0,18,18,0,-30,61.224489795918366,5.263157894736842,5.263157894736842,0.0,25.0,25.0,0.0,Previsions
16,1,2019-01-02,132457,ACTIVIA SAV COCO 125X4 OD,0,0,0,ACTIVIA,0,Bailleul(FR),0083,0024 FR CHAPONNAY (DC),214,168,42,42,0,126,126,0,-46,21.49532710280374,111,81,4,4,0,77,77,0,-30,27.027027027027028,4.938271604938271,4.938271604938271,0.0,25.0,25.0,0.0,Previsions
17,1,2019-01-02,132457,ACTIVIA SAV COCO 125X4 OD,0,0,0,ACTIVIA,0,Bailleul(FR),0079,0024 FR PARIS SUD (DC),214,168,42,42,0,126,126,0,-46,21.49532710280374,5,24,8,8,0,16,16,0,19,-380.0,33.33333333333333,33.33333333333333,0.0,25.0,25.0,0.0,Previsions
18,0,2019-01-02,132458,ACTIVIA SAV CITRON 125X4 OD,0,0,0,ACTIVIA,0,Bailleul(FR),0080,0024 FR METZ (DC),125,81,55,55,0,26,26,0,-44,35.2,22,24,24,24,0,0,0,0,2,-9.090909090909092,100.0,100.0,0.0,67.90123456790124,67.90123456790124,0.0,Previsions
19,0,2019-01-02,132458,ACTIVIA SAV CITRON 125X4 OD,0,0,0,ACTIVIA,0,Bailleul(FR),0081,0024 FR TOURS (DC),125,81,55,55,0,26,26,0,-44,35.2,52,25,13,13,0,12,12,0,-27,51.92307692307692,52.0,52.0,0.0,67.90123456790124,67.90123456790124,0.0,Previsions
20,0,2019-01-02,132458,ACTIVIA SAV CITRON 125X4 OD,0,0,0,ACTIVIA,0,Bailleul(FR),0082,0024 FR VALLET (DC),125,81,55,55,0,26,26,0,-44,35.2,51,32,18,18,0,14,14,0,-19,37.254901960784316,56.25,56.25,0.0,67.90123456790124,67.90123456790124,0.0,Previsions
21,0,2019-01-02,132459,ACTIVIA SAV VANILLE 125X4 OD,0,0,0,ACTIVIA,0,Bailleul(FR),0080,0024 FR METZ (DC),248,102,37,37,0,65,65,0,-146,58.87096774193548,22,30,18,18,0,12,12,0,8,-36.36363636363637,60.0,60.0,0.0,36.27450980392157,36.27450980392157,0.0,Previsions
22,0,2019-01-02,132459,ACTIVIA SAV VANILLE 125X4 OD,0,0,0,ACTIVIA,0,Bailleul(FR),0081,0024 FR TOURS (DC),248,102,37,37,0,65,65,0,-146,58.87096774193548,54,27,4,4,0,23,23,0,-27,50.0,14.814814814814813,14.814814814814813,0.0,36.27450980392157,36.27450980392157,0.0,Previsions
23,1,2019-01-02,132459,ACTIVIA SAV VANILLE 125X4 OD,0,0,0,ACTIVIA,0,Bailleul(FR),0081,0024 FR TOURS (DC),248,102,37,37,0,65,65,0,-146,58.87096774193548,54,27,4,4,0,23,23,0,-27,50.0,14.814814814814813,14.814814814814813,0.0,36.27450980392157,36.27450980392157,0.0,Previsions
24,0,2019-01-02,132459,ACTIVIA SAV VANILLE 125X4 OD,0,0,0,ACTIVIA,0,Bailleul(FR),0077,0024 FR LILPARK (DC),248,102,37,37,0,65,65,0,-146,58.87096774193548,2,13,13,13,0,0,0,0,11,-550.0,100.0,100.0,0.0,36.27450980392157,36.27450980392157,0.0,Previsions
25,0,2019-01-02,132459,ACTIVIA SAV VANILLE 125X4 OD,0,0,0,ACTIVIA,0,Bailleul(FR),0079,0024 FR PARIS SUD (DC),248,102,37,37,0,65,65,0,-146,58.87096774193548,58,32,2,2,0,30,30,0,-26,44.827586206896555,6.25,6.25,0.0,36.27450980392157,36.27450980392157,0.0,Previsions
26,1,2019-01-02,132459,ACTIVIA SAV VANILLE 125X4 OD,0,0,0,ACTIVIA,0,Bailleul(FR),0079,0024 FR PARIS SUD (DC),248,102,37,37,0,65,65,0,-146,58.87096774193548,58,32,2,2,0,30,30,0,-26,44.827586206896555,6.25,6.25,0.0,36.27450980392157,36.27450980392157,0.0,Previsions
27,0,2019-01-02,135120,ACTIVIA SAV CIT 125X12 PLUS 4,0,0,0,ACTIVIA,0,Bailleul(FR),0084,0024 FR AIX (DC),2201,2075,1742,1739,3,336,333,0,-126,5.724670604270786,21,117,117,117,0,0,0,0,96,-457.14285714285717,100.0,100.0,0.0,83.95180722891567,83.80722891566265,0.14457831325302095,Previsions
28,0,2019-01-02,135120,ACTIVIA SAV CIT 125X12 PLUS 4,0,0,0,ACTIVIA,0,Bailleul(FR),0080,0024 FR METZ (DC),2201,2075,1742,1739,3,336,333,0,-126,5.724670604270786,120,73,73,73,0,0,0,0,-47,39.166666666666664,100.0,100.0,0.0,83.95180722891567,83.80722891566265,0.14457831325302095,Previsions
29,0,2019-01-02,135120,ACTIVIA SAV CIT 125X12 PLUS 4,0,0,0,ACTIVIA,0,Bailleul(FR),0081,0024 FR TOURS (DC),2201,2075,1742,1739,3,336,333,0,-126,5.724670604270786,220,244,244,244,0,0,0,0,24,-10.909090909090908,100.0,100.0,0.0,83.95180722891567,83.80722891566265,0.14457831325302095,Previsions
30,0,2019-01-02,135120,ACTIVIA SAV CIT 125X12 PLUS 4,0,0,0,ACTIVIA,0,Bailleul(FR),0082,0024 FR VALLET (DC),2201,2075,1742,1739,3,336,333,0,-126,5.724670604270786,58,77,77,77,0,0,0,0,19,-32.758620689655174,100.0,100.0,0.0,83.95180722891567,83.80722891566265,0.14457831325302095,Previsions
31,0,2019-01-02,135120,ACTIVIA SAV CIT 125X12 PLUS 4,0,0,0,ACTIVIA,0,Bailleul(FR),0077,0024 FR LILPARK (DC),2201,2075,1742,1739,3,336,333,0,-126,5.724670604270786,791,452,119,116,3,336,333,0,-339,42.857142857142854,26.327433628318587,25.663716814159294,0.6637168141592937,83.95180722891567,83.80722891566265,0.14457831325302095,Previsions
32,0,2019-01-02,135120,ACTIVIA SAV CIT 125X12 PLUS 4,0,0,0,ACTIVIA,0,Bailleul(FR),0085,0024 FR TOULOUSE (DC),2201,2075,1742,1739,3,336,333,0,-126,5.724670604270786,202,156,156,156,0,0,0,0,-46,22.77227722772277,100.0,100.0,0.0,83.95180722891567,83.80722891566265,0.14457831325302095,Previsions
33,0,2019-01-02,135120,ACTIVIA SAV CIT 125X12 PLUS 4,0,0,0,ACTIVIA,0,Bailleul(FR),0083,0024 FR CHAPONNAY (DC),2201,2075,1742,1739,3,336,333,0,-126,5.724670604270786,70,530,530,530,0,0,0,0,460,-657.1428571428571,100.0,100.0,0.0,83.95180722891567,83.80722891566265,0.14457831325302095,Previsions
34,0,2019-01-02,135120,ACTIVIA SAV CIT 125X12 PLUS 4,0,0,0,ACTIVIA,0,Bailleul(FR),0079,0024 FR PARIS SUD (DC),2201,2075,1742,1739,3,336,333,0,-126,5.724670604270786,429,239,239,239,0,0,0,0,-190,44.28904428904429,100.0,100.0,0.0,83.95180722891567,83.80722891566265,0.14457831325302095,Previsions
35,0,2019-01-02,135120,ACTIVIA SAV CIT 125X12 PLUS 4,0,0,0,ACTIVIA,0,Bailleul(FR),0078,0024 FR PARIS NORD (DC),2201,2075,1742,1739,3,336,333,0,-126,5.724670604270786,290,187,187,187,0,0,0,0,-103,35.51724137931034,100.0,100.0,0.0,83.95180722891567,83.80722891566265,0.14457831325302095,Previsions
36,0,2019-01-02,140278,Activia almond/muesli/chia 170g FR-copac,0,0,0,ACTIVIA,1,Roumanie(RO),0084,0024 FR AIX (DC),790,605,583,373,210,232,22,0,-185,23.417721518987342,90,66,66,55,11,11,0,0,-24,26.666666666666668,100.0,83.33333333333334,16.666666666666657,96.36363636363636,61.65289256198348,34.71074380165288,A Creuser
37,0,2019-01-02,140278,Activia almond/muesli/chia 170g FR-copac,0,0,0,ACTIVIA,1,Roumanie(RO),0080,0024 FR METZ (DC),790,605,583,373,210,232,22,0,-185,23.417721518987342,116,115,115,115,0,0,0,0,-1,0.8620689655172413,100.0,100.0,0.0,96.36363636363636,61.65289256198348,34.71074380165288,A Creuser
38,0,2019-01-02,140278,Activia almond/muesli/chia 170g FR-copac,0,0,0,ACTIVIA,1,Roumanie(RO),0081,0024 FR TOURS (DC),790,605,583,373,210,232,22,0,-185,23.417721518987342,62,28,6,0,6,28,22,0,-34,54.83870967741935,21.428571428571427,0.0,21.428571428571427,96.36363636363636,61.65289256198348,34.71074380165288,A Creuser
39,0,2019-01-02,140278,Activia almond/muesli/chia 170g FR-copac,0,0,0,ACTIVIA,1,Roumanie(RO),0082,0024 FR VALLET (DC),790,605,583,373,210,232,22,0,-185,23.417721518987342,123,91,91,16,75,75,0,0,-32,26.016260162601625,100.0,17.582417582417584,82.41758241758242,96.36363636363636,61.65289256198348,34.71074380165288,A Creuser
40,0,2019-01-02,140278,Activia almond/muesli/chia 170g FR-copac,0,0,0,ACTIVIA,1,Roumanie(RO),0077,0024 FR LILPARK (DC),790,605,583,373,210,232,22,0,-185,23.417721518987342,30,19,19,19,0,0,0,0,-11,36.666666666666664,100.0,100.0,0.0,96.36363636363636,61.65289256198348,34.71074380165288,A Creuser
41,0,2019-01-02,140278,Activia almond/muesli/chia 170g FR-copac,0,0,0,ACTIVIA,1,Roumanie(RO),0085,0024 FR TOULOUSE (DC),790,605,583,373,210,232,22,0,-185,23.417721518987342,94,66,66,52,14,14,0,0,-28,29.78723404255319,100.0,78.78787878787878,21.212121212121218,96.36363636363636,61.65289256198348,34.71074380165288,A Creuser
42,0,2019-01-02,140278,Activia almond/muesli/chia 170g FR-copac,0,0,0,ACTIVIA,1,Roumanie(RO),0079,0024 FR PARIS SUD (DC),790,605,583,373,210,232,22,0,-185,23.417721518987342,92,82,82,60,22,22,0,0,-10,10.869565217391305,100.0,73.17073170731707,26.829268292682926,96.36363636363636,61.65289256198348,34.71074380165288,A Creuser
43,0,2019-01-02,140278,Activia almond/muesli/chia 170g FR-copac,0,0,0,ACTIVIA,1,Roumanie(RO),0078,0024 FR PARIS NORD (DC),790,605,583,373,210,232,22,0,-185,23.417721518987342,183,138,138,56,82,82,0,0,-45,24.59016393442623,100.0,40.57971014492754,59.42028985507246,96.36363636363636,61.65289256198348,34.71074380165288,A Creuser
44,0,2019-01-02,140280,Activia chia/raspb/muesli 170g FR-copack,0,0,0,ACTIVIA,1,Roumanie(RO),0084,0024 FR AIX (DC),633,653,653,394,259,259,0,0,20,-3.1595576619273302,62,69,69,61,8,8,0,0,7,-11.290322580645162,100.0,88.40579710144928,11.59420289855072,100.0,60.33690658499234,39.66309341500766,A Creuser
45,0,2019-01-02,140280,Activia chia/raspb/muesli 170g FR-copack,0,0,0,ACTIVIA,1,Roumanie(RO),0080,0024 FR METZ (DC),633,653,653,394,259,259,0,0,20,-3.1595576619273302,74,96,96,96,0,0,0,0,22,-29.72972972972973,100.0,100.0,0.0,100.0,60.33690658499234,39.66309341500766,A Creuser
46,0,2019-01-02,140280,Activia chia/raspb/muesli 170g FR-copack,0,0,0,ACTIVIA,1,Roumanie(RO),0082,0024 FR VALLET (DC),633,653,653,394,259,259,0,0,20,-3.1595576619273302,102,109,109,17,92,92,0,0,7,-6.862745098039215,100.0,15.59633027522936,84.40366972477064,100.0,60.33690658499234,39.66309341500766,A Creuser
47,0,2019-01-02,140280,Activia chia/raspb/muesli 170g FR-copack,0,0,0,ACTIVIA,1,Roumanie(RO),0077,0024 FR LILPARK (DC),633,653,653,394,259,259,0,0,20,-3.1595576619273302,48,43,43,43,0,0,0,0,-5,10.416666666666666,100.0,100.0,0.0,100.0,60.33690658499234,39.66309341500766,A Creuser
48,0,2019-01-02,140280,Activia chia/raspb/muesli 170g FR-copack,0,0,0,ACTIVIA,1,Roumanie(RO),0085,0024 FR TOULOUSE (DC),633,653,653,394,259,259,0,0,20,-3.1595576619273302,106,112,112,100,12,12,0,0,6,-5.660377358490566,100.0,89.28571428571429,10.714285714285708,100.0,60.33690658499234,39.66309341500766,A Creuser
49,0,2019-01-02,140280,Activia chia/raspb/muesli 170g FR-copack,0,0,0,ACTIVIA,1,Roumanie(RO),0079,0024 FR PARIS SUD (DC),633,653,653,394,259,259,0,0,20,-3.1595576619273302,81,63,63,59,4,4,0,0,-18,22.22222222222222,100.0,93.65079365079364,6.349206349206355,100.0,60.33690658499234,39.66309341500766,A Creuser
50,0,2019-01-02,140280,Activia chia/raspb/muesli 170g FR-copack,0,0,0,ACTIVIA,1,Roumanie(RO),0078,0024 FR PARIS NORD (DC),633,653,653,394,259,259,0,0,20,-3.1595576619273302,160,161,161,18,143,143,0,0,1,-0.625,100.0,11.180124223602485,88.81987577639751,100.0,60.33690658499234,39.66309341500766,A Creuser
51,0,2019-01-03,127910,GERVAIS GRIEGO 115X4 LEMON FR,0,0,0,GERVAIS,1,Rosenheim(ALL),0084,0024 FR AIX (DC),1388,1232,943,943,0,289,289,0,-156,11.239193083573488,119,123,123,123,0,0,0,0,4,-3.361344537815126,100.0,100.0,0.0,76.54220779220779,76.54220779220779,0.0,A Creuser
52,0,2019-01-03,127910,GERVAIS GRIEGO 115X4 LEMON FR,0,0,0,GERVAIS,1,Rosenheim(ALL),0080,0024 FR METZ (DC),1388,1232,943,943,0,289,289,0,-156,11.239193083573488,92,104,104,104,0,0,0,0,12,-13.043478260869565,100.0,100.0,0.0,76.54220779220779,76.54220779220779,0.0,A Creuser
53,0,2019-01-03,127910,GERVAIS GRIEGO 115X4 LEMON FR,0,0,0,GERVAIS,1,Rosenheim(ALL),0081,0024 FR TOURS (DC),1388,1232,943,943,0,289,289,0,-156,11.239193083573488,241,216,216,216,0,0,0,0,-25,10.37344398340249,100.0,100.0,0.0,76.54220779220779,76.54220779220779,0.0,A Creuser
54,0,2019-01-03,127910,GERVAIS GRIEGO 115X4 LEMON FR,0,0,0,GERVAIS,1,Rosenheim(ALL),0082,0024 FR VALLET (DC),1388,1232,943,943,0,289,289,0,-156,11.239193083573488,138,123,123,123,0,0,0,0,-15,10.869565217391305,100.0,100.0,0.0,76.54220779220779,76.54220779220779,0.0,A Creuser
55,0,2019-01-03,127910,GERVAIS GRIEGO 115X4 LEMON FR,0,0,0,GERVAIS,1,Rosenheim(ALL),0077,0024 FR LILPARK (DC),1388,1232,943,943,0,289,289,0,-156,11.239193083573488,184,131,131,131,0,0,0,0,-53,28.804347826086957,100.0,100.0,0.0,76.54220779220779,76.54220779220779,0.0,A Creuser
56,0,2019-01-03,127910,GERVAIS GRIEGO 115X4 LEMON FR,0,0,0,GERVAIS,1,Rosenheim(ALL),0085,0024 FR TOULOUSE (DC),1388,1232,943,943,0,289,289,0,-156,11.239193083573488,240,179,64,64,0,115,115,0,-61,25.416666666666668,35.754189944134076,35.754189944134076,0.0,76.54220779220779,76.54220779220779,0.0,A Creuser
57,0,2019-01-03,127910,GERVAIS GRIEGO 115X4 LEMON FR,0,0,0,GERVAIS,1,Rosenheim(ALL),0079,0024 FR PARIS SUD (DC),1388,1232,943,943,0,289,289,0,-156,11.239193083573488,249,237,63,63,0,174,174,0,-12,4.819277108433735,26.582278481012654,26.582278481012654,0.0,76.54220779220779,76.54220779220779,0.0,A Creuser
58,0,2019-01-03,127910,GERVAIS GRIEGO 115X4 LEMON FR,0,0,0,GERVAIS,1,Rosenheim(ALL),0078,0024 FR PARIS NORD (DC),1388,1232,943,943,0,289,289,0,-156,11.239193083573488,125,119,119,119,0,0,0,0,-6,4.8,100.0,100.0,0.0,76.54220779220779,76.54220779220779,0.0,A Creuser
59,1,2019-01-03,131291,ACTIMEL 0% NATU 3x(8x100g) FR,1,0,0,ACTIMEL,1,Rotselaar(BE),0081,0024 FR TOURS (DC),46,891,891,838,53,53,0,0,845,-1836.9565217391305,46,87,87,34,53,53,0,0,41,-89.1304347826087,100.0,39.08045977011494,60.91954022988506,100.0,94.05162738496072,5.9483726150392755,Expe usine
60,1,2019-01-03,133133,LIGHT&FREE FRAIS BOIS 120X4 OD,1,0,0,LIGHT & FREE,0,Ferrières(FR),0077,0024 FR LILPARK (DC),78,680,680,558,122,122,0,0,602,-771.7948717948718,78,122,122,0,122,122,0,0,44,-56.41025641025641,100.0,0.0,100.0,100.0,82.05882352941177,17.941176470588232,Probleme Copacking
61,0,2019-01-04,59540,DANET MOU LIEG CHOCO 80gx8,0,0,0,DANETTE,1,Ochsenfurt(ALL),0084,0024 FR AIX (DC),4609,5559,5559,5267,292,292,0,0,950,-20.611846387502712,50,524,524,523,1,1,0,0,474,-948.0,100.0,99.80916030534351,0.1908396946564892,100.0,94.74725670084547,5.252743299154531,Transport
62,0,2019-01-04,59540,DANET MOU LIEG CHOCO 80gx8,0,0,0,DANETTE,1,Ochsenfurt(ALL),0080,0024 FR METZ (DC),4609,5559,5559,5267,292,292,0,0,950,-20.611846387502712,312,222,222,222,0,0,0,0,-90,28.846153846153847,100.0,100.0,0.0,100.0,94.74725670084547,5.252743299154531,Transport
63,0,2019-01-04,59540,DANET MOU LIEG CHOCO 80gx8,0,0,0,DANETTE,1,Ochsenfurt(ALL),0081,0024 FR TOURS (DC),4609,5559,5559,5267,292,292,0,0,950,-20.611846387502712,757,785,785,785,0,0,0,0,28,-3.6988110964332894,100.0,100.0,0.0,100.0,94.74725670084547,5.252743299154531,Transport
64,0,2019-01-04,59540,DANET MOU LIEG CHOCO 80gx8,0,0,0,DANETTE,1,Ochsenfurt(ALL),0082,0024 FR VALLET (DC),4609,5559,5559,5267,292,292,0,0,950,-20.611846387502712,494,584,584,293,291,291,0,0,90,-18.218623481781375,100.0,50.171232876712324,49.828767123287676,100.0,94.74725670084547,5.252743299154531,Transport
65,0,2019-01-04,59540,DANET MOU LIEG CHOCO 80gx8,0,0,0,DANETTE,1,Ochsenfurt(ALL),0077,0024 FR LILPARK (DC),4609,5559,5559,5267,292,292,0,0,950,-20.611846387502712,496,925,925,925,0,0,0,0,429,-86.49193548387096,100.0,100.0,0.0,100.0,94.74725670084547,5.252743299154531,Transport
66,0,2019-01-04,59540,DANET MOU LIEG CHOCO 80gx8,0,0,0,DANETTE,1,Ochsenfurt(ALL),0085,0024 FR TOULOUSE (DC),4609,5559,5559,5267,292,292,0,0,950,-20.611846387502712,718,753,753,753,0,0,0,0,35,-4.874651810584958,100.0,100.0,0.0,100.0,94.74725670084547,5.252743299154531,Transport
67,0,2019-01-04,59540,DANET MOU LIEG CHOCO 80gx8,0,0,0,DANETTE,1,Ochsenfurt(ALL),0083,0024 FR CHAPONNAY (DC),4609,5559,5559,5267,292,292,0,0,950,-20.611846387502712,831,793,793,793,0,0,0,0,-38,4.57280385078219,100.0,100.0,0.0,100.0,94.74725670084547,5.252743299154531,Transport
68,0,2019-01-04,59540,DANET MOU LIEG CHOCO 80gx8,0,0,0,DANETTE,1,Ochsenfurt(ALL),0079,0024 FR PARIS SUD (DC),4609,5559,5559,5267,292,292,0,0,950,-20.611846387502712,390,364,364,364,0,0,0,0,-26,6.666666666666667,100.0,100.0,0.0,100.0,94.74725670084547,5.252743299154531,Transport
69,0,2019-01-04,59540,DANET MOU LIEG CHOCO 80gx8,0,0,0,DANETTE,1,Ochsenfurt(ALL),0078,0024 FR PARIS NORD (DC),4609,5559,5559,5267,292,292,0,0,950,-20.611846387502712,561,609,609,609,0,0,0,0,48,-8.556149732620321,100.0,100.0,0.0,100.0,94.74725670084547,5.252743299154531,Transport
70,1,2019-01-04,121315,ACTIMEL NATU 4x(10x100g) FR,0,0,0,ACTIMEL,1,Rotselaar(BE),0084,0024 FR AIX (DC),475,2454,2231,2231,0,223,223,0,1979,-416.63157894736844,475,334,232,232,0,102,102,0,-141,29.68421052631579,69.46107784431138,69.46107784431138,0.0,90.91279543602282,90.91279543602282,0.0,Transport
71,1,2019-01-04,121428,ACTIMEL FOREST FR 4x(10x100g) FR,0,0,0,ACTIMEL,1,Rotselaar(BE),0084,0024 FR AIX (DC),385,896,758,726,32,170,138,0,511,-132.72727272727272,239,131,53,21,32,110,78,0,-108,45.18828451882845,40.458015267175576,16.030534351145036,24.42748091603054,84.59821428571429,81.02678571428571,3.5714285714285836,Transport
72,1,2019-01-04,121428,ACTIMEL FOREST FR 4x(10x100g) FR,0,0,0,ACTIMEL,1,Rotselaar(BE),0082,0024 FR VALLET (DC),385,896,758,726,32,170,138,0,511,-132.72727272727272,146,92,32,32,0,60,60,0,-54,36.986301369863014,34.78260869565217,34.78260869565217,0.0,84.59821428571429,81.02678571428571,3.5714285714285836,Expe usine
73,1,2019-01-04,121448,ACTIMEL RASP-BLUE 3x(8x100g) FR,0,0,0,ACTIMEL,1,Rotselaar(BE),0084,0024 FR AIX (DC),59,656,467,459,8,197,189,0,597,-1011.8644067796611,59,87,21,13,8,74,66,0,28,-47.45762711864407,24.137931034482758,14.942528735632186,9.195402298850572,71.1890243902439,69.96951219512195,1.2195121951219505,Transport
74,1,2019-01-04,121450,ACTIMEL 0% NATU 3x(8x100g) FR,0,0,0,ACTIMEL,1,Rotselaar(BE),0082,0024 FR VALLET (DC),180,2597,2601,2577,24,20,-4,0,2417,-1342.7777777777778,180,164,164,144,20,20,0,0,-16,8.88888888888889,100.0,87.8048780487805,12.195121951219505,100.15402387370042,99.22988063149788,0.9241432422025468,Expe usine
75,0,2019-01-04,122050,VELOUTE FRUIX ROUGES 125X8 OD,1,0,0,VELOUTE,0,Villecomtal(FR),0084,0024 FR AIX (DC),4078,2715,2589,2465,124,250,126,0,-1363,33.4232466895537,300,179,179,127,52,52,0,0,-121,40.333333333333336,100.0,70.94972067039106,29.05027932960894,95.35911602209944,90.79189686924494,4.567219152854506,Previsions
76,0,2019-01-04,122050,VELOUTE FRUIX ROUGES 125X8 OD,1,0,0,VELOUTE,0,Villecomtal(FR),0080,0024 FR METZ (DC),4078,2715,2589,2465,124,250,126,0,-1363,33.4232466895537,265,171,171,171,0,0,0,0,-94,35.471698113207545,100.0,100.0,0.0,95.35911602209944,90.79189686924494,4.567219152854506,Previsions
77,0,2019-01-04,122050,VELOUTE FRUIX ROUGES 125X8 OD,1,0,0,VELOUTE,0,Villecomtal(FR),0081,0024 FR TOURS (DC),4078,2715,2589,2465,124,250,126,0,-1363,33.4232466895537,446,316,316,316,0,0,0,0,-130,29.14798206278027,100.0,100.0,0.0,95.35911602209944,90.79189686924494,4.567219152854506,Previsions
78,0,2019-01-04,122050,VELOUTE FRUIX ROUGES 125X8 OD,1,0,0,VELOUTE,0,Villecomtal(FR),0082,0024 FR VALLET (DC),4078,2715,2589,2465,124,250,126,0,-1363,33.4232466895537,2,108,108,108,0,0,0,0,106,-5300.0,100.0,100.0,0.0,95.35911602209944,90.79189686924494,4.567219152854506,Previsions
79,0,2019-01-04,122050,VELOUTE FRUIX ROUGES 125X8 OD,1,0,0,VELOUTE,0,Villecomtal(FR),0077,0024 FR LILPARK (DC),4078,2715,2589,2465,124,250,126,0,-1363,33.4232466895537,788,540,540,538,2,2,0,0,-248,31.472081218274113,100.0,99.62962962962963,0.3703703703703667,95.35911602209944,90.79189686924494,4.567219152854506,Previsions
80,0,2019-01-04,122050,VELOUTE FRUIX ROUGES 125X8 OD,1,0,0,VELOUTE,0,Villecomtal(FR),0085,0024 FR TOULOUSE (DC),4078,2715,2589,2465,124,250,126,0,-1363,33.4232466895537,495,311,311,311,0,0,0,0,-184,37.17171717171717,100.0,100.0,0.0,95.35911602209944,90.79189686924494,4.567219152854506,Previsions
81,0,2019-01-04,122050,VELOUTE FRUIX ROUGES 125X8 OD,1,0,0,VELOUTE,0,Villecomtal(FR),0083,0024 FR CHAPONNAY (DC),4078,2715,2589,2465,124,250,126,0,-1363,33.4232466895537,601,381,255,185,70,196,126,0,-220,36.605657237936775,66.92913385826772,48.55643044619423,18.37270341207349,95.35911602209944,90.79189686924494,4.567219152854506,Previsions
82,0,2019-01-04,122050,VELOUTE FRUIX ROUGES 125X8 OD,1,0,0,VELOUTE,0,Villecomtal(FR),0079,0024 FR PARIS SUD (DC),4078,2715,2589,2465,124,250,126,0,-1363,33.4232466895537,658,395,395,395,0,0,0,0,-263,39.96960486322188,100.0,100.0,0.0,95.35911602209944,90.79189686924494,4.567219152854506,Previsions
83,0,2019-01-04,122050,VELOUTE FRUIX ROUGES 125X8 OD,1,0,0,VELOUTE,0,Villecomtal(FR),0078,0024 FR PARIS NORD (DC),4078,2715,2589,2465,124,250,126,0,-1363,33.4232466895537,523,314,314,314,0,0,0,0,-209,39.961759082217974,100.0,100.0,0.0,95.35911602209944,90.79189686924494,4.567219152854506,Previsions
84,0,2019-01-04,127908,GERVAIS GRIEGO 115X2 BLUEBERRY FR,0,0,0,GERVAIS,1,Rosenheim(ALL),0084,0024 FR AIX (DC),5181,718,720,511,209,207,-2,0,-4463,86.14167149198997,688,70,70,70,0,0,0,0,-618,89.82558139534883,100.0,100.0,0.0,100.27855153203342,71.1699164345404,29.10863509749302,Déploiement/Quarantaine
85,0,2019-01-04,127908,GERVAIS GRIEGO 115X2 BLUEBERRY FR,0,0,0,GERVAIS,1,Rosenheim(ALL),0080,0024 FR METZ (DC),5181,718,720,511,209,207,-2,0,-4463,86.14167149198997,509,79,79,79,0,0,0,0,-430,84.47937131630648,100.0,100.0,0.0,100.27855153203342,71.1699164345404,29.10863509749302,Déploiement/Quarantaine
86,0,2019-01-04,127908,GERVAIS GRIEGO 115X2 BLUEBERRY FR,0,0,0,GERVAIS,1,Rosenheim(ALL),0081,0024 FR TOURS (DC),5181,718,720,511,209,207,-2,0,-4463,86.14167149198997,1787,70,72,70,2,0,-2,0,-1717,96.08282036933407,102.85714285714285,100.0,2.857142857142847,100.27855153203342,71.1699164345404,29.10863509749302,Déploiement/Quarantaine
87,0,2019-01-04,127908,GERVAIS GRIEGO 115X2 BLUEBERRY FR,0,0,0,GERVAIS,1,Rosenheim(ALL),0082,0024 FR VALLET (DC),5181,718,720,511,209,207,-2,0,-4463,86.14167149198997,912,52,52,52,0,0,0,0,-860,94.29824561403508,100.0,100.0,0.0,100.27855153203342,71.1699164345404,29.10863509749302,Déploiement/Quarantaine
88,0,2019-01-04,127908,GERVAIS GRIEGO 115X2 BLUEBERRY FR,0,0,0,GERVAIS,1,Rosenheim(ALL),0077,0024 FR LILPARK (DC),5181,718,720,511,209,207,-2,0,-4463,86.14167149198997,11,48,48,48,0,0,0,0,37,-336.3636363636364,100.0,100.0,0.0,100.27855153203342,71.1699164345404,29.10863509749302,Déploiement/Quarantaine
89,0,2019-01-04,127908,GERVAIS GRIEGO 115X2 BLUEBERRY FR,0,0,0,GERVAIS,1,Rosenheim(ALL),0085,0024 FR TOULOUSE (DC),5181,718,720,511,209,207,-2,0,-4463,86.14167149198997,641,208,208,1,207,207,0,0,-433,67.55070202808112,100.0,0.4807692307692308,99.51923076923077,100.27855153203342,71.1699164345404,29.10863509749302,Déploiement/Quarantaine
90,0,2019-01-04,127908,GERVAIS GRIEGO 115X2 BLUEBERRY FR,0,0,0,GERVAIS,1,Rosenheim(ALL),0079,0024 FR PARIS SUD (DC),5181,718,720,511,209,207,-2,0,-4463,86.14167149198997,107,116,116,116,0,0,0,0,9,-8.411214953271028,100.0,100.0,0.0,100.27855153203342,71.1699164345404,29.10863509749302,Déploiement/Quarantaine
91,0,2019-01-04,127908,GERVAIS GRIEGO 115X2 BLUEBERRY FR,0,0,0,GERVAIS,1,Rosenheim(ALL),0078,0024 FR PARIS NORD (DC),5181,718,720,511,209,207,-2,0,-4463,86.14167149198997,526,75,75,75,0,0,0,0,-451,85.74144486692015,100.0,100.0,0.0,100.27855153203342,71.1699164345404,29.10863509749302,Déploiement/Quarantaine
92,1,2019-01-04,133134,LIGHT & FREE FRAMB GREN 120X4 OD,1,0,0,LIGHT & FREE,0,Ferrières(FR),0083,0024 FR CHAPONNAY (DC),43,437,433,413,20,24,4,0,394,-916.2790697674419,43,64,60,40,20,24,4,0,21,-48.83720930232558,93.75,62.5,31.25,99.08466819221968,94.50800915331807,4.57665903890161,A Creuser
93,1,2019-01-04,136435,ACTIVIA FRUITS MYRTILLE 125X4 OD,1,0,0,ACTIVIA,0,Ferrières(FR),0079,0024 FR PARIS SUD (DC),26,929,906,770,136,159,23,0,903,-3473.076923076923,26,150,150,82,68,68,0,0,124,-476.9230769230769,100.0,54.666666666666664,45.333333333333336,97.52421959095801,82.88482238966631,14.6393972012917,Probleme Copacking
94,1,2019-01-04,138549,L2V PTITS MIAM FRUITS 50X6,1,0,0,LES 2 VACHES,0,Ferrières(FR),0080,0024 FR METZ (DC),3,819,792,723,69,96,27,0,816,-27200.0,3,280,253,184,69,96,27,0,277,-9233.333333333334,90.35714285714286,65.71428571428571,24.642857142857153,96.7032967032967,88.27838827838828,8.424908424908423,Probleme Copacking
95,1,2019-01-04,139555,FJORD FRT FRAM CRAN 125X4,0,1,0,FJORD,0,LeMolay(FR),0079,0024 FR PARIS SUD (DC),129,189,161,159,2,30,28,0,60,-46.51162790697674,129,130,102,100,2,30,28,0,1,-0.7751937984496124,78.46153846153847,76.92307692307693,1.538461538461533,85.18518518518519,84.12698412698413,1.058201058201064,Qualité
96,1,2019-01-05,121315,ACTIMEL NATU 4x(10x100g) FR,0,0,0,ACTIMEL,1,Rotselaar(BE),0084,0024 FR AIX (DC),5,2415,2415,2209,206,206,0,0,2410,-48200.0,5,206,206,0,206,206,0,0,201,-4020.0,100.0,0.0,100.0,100.0,91.46997929606626,8.530020703933744,Transport
97,1,2019-01-05,121428,ACTIMEL FOREST FR 4x(10x100g) FR,0,0,0,ACTIMEL,1,Rotselaar(BE),0084,0024 FR AIX (DC),764,1521,1521,1207,314,314,0,0,757,-99.08376963350786,233,128,128,0,128,128,0,0,-105,45.06437768240343,100.0,0.0,100.0,100.0,79.35568704799473,20.644312952005265,Transport
98,1,2019-01-05,121428,ACTIMEL FOREST FR 4x(10x100g) FR,0,0,0,ACTIMEL,1,Rotselaar(BE),0077,0024 FR LILPARK (DC),764,1521,1521,1207,314,314,0,0,757,-99.08376963350786,531,292,292,106,186,186,0,0,-239,45.00941619585687,100.0,36.3013698630137,63.6986301369863,100.0,79.35568704799473,20.644312952005265,Transport
99,1,2019-01-05,121429,ACTIMEL 0% NATU 4x(10x100g) FR,0,0,0,ACTIMEL,1,Rotselaar(BE),0084,0024 FR AIX (DC),388,1708,1708,1587,121,121,0,0,1320,-340.2061855670103,388,183,183,62,121,121,0,0,-205,52.83505154639175,100.0,33.87978142076503,66.12021857923497,100.0,92.91569086651053,7.0843091334894694,Transport
100,1,2019-01-05,127336,ACTIVIA SAV FRTS ROUGES 125X4,0,0,0,ACTIVIA,0,Bailleul(FR),0078,0024 FR PARIS NORD (DC),74,394,394,370,24,24,0,0,320,-432.43243243243245,74,89,89,65,24,24,0,0,15,-20.27027027027027,100.0,73.03370786516854,26.966292134831463,100.0,93.90862944162437,6.09137055837563,Transport
101,1,2019-01-05,133131,LIGHT & FREE POIRE VAN 120X4 OD,1,0,0,LIGHT & FREE,0,Ferrières(FR),0081,0024 FR TOURS (DC),58,220,220,190,30,30,0,0,162,-279.3103448275862,58,77,77,47,30,30,0,0,19,-32.758620689655174,100.0,61.038961038961034,38.961038961038966,100.0,86.36363636363636,13.63636363636364,Transport
102,1,2019-01-08,101201,DANETTE POP SA VA BIL CA 120X4,0,0,0,DANETTE,0,LeMolay(FR),0080,0024 FR METZ (DC),11,703,622,622,0,81,81,0,692,-6290.909090909091,11,91,10,10,0,81,81,0,80,-727.2727272727273,10.989010989010989,10.989010989010989,0.0,88.47795163584638,88.47795163584638,0.0,Expe usine
103,0,2019-01-08,120160,DANONE FERME NATURE 125X8,0,0,0,DANONE,0,Bailleul(FR),0084,0024 FR AIX (DC),2889,3312,2878,1042,1836,2270,434,0,423,-14.641744548286605,714,368,265,20,245,348,103,0,-346,48.4593837535014,72.01086956521739,5.434782608695652,66.57608695652173,86.89613526570048,31.46135265700483,55.43478260869565,Qualité
104,0,2019-01-08,120160,DANONE FERME NATURE 125X8,0,0,0,DANONE,0,Bailleul(FR),0080,0024 FR METZ (DC),2889,3312,2878,1042,1836,2270,434,0,423,-14.641744548286605,246,181,172,151,21,30,9,0,-65,26.422764227642276,95.02762430939227,83.42541436464089,11.60220994475138,86.89613526570048,31.46135265700483,55.43478260869565,Qualité
105,0,2019-01-08,120160,DANONE FERME NATURE 125X8,0,0,0,DANONE,0,Bailleul(FR),0081,0024 FR TOURS (DC),2889,3312,2878,1042,1836,2270,434,0,423,-14.641744548286605,328,367,362,216,146,151,5,0,39,-11.890243902439025,98.63760217983652,58.855585831062676,39.782016348773844,86.89613526570048,31.46135265700483,55.43478260869565,Qualité
106,0,2019-01-08,120160,DANONE FERME NATURE 125X8,0,0,0,DANONE,0,Bailleul(FR),0082,0024 FR VALLET (DC),2889,3312,2878,1042,1836,2270,434,0,423,-14.641744548286605,265,244,111,0,111,244,133,0,-21,7.9245283018867925,45.49180327868852,0.0,45.49180327868852,86.89613526570048,31.46135265700483,55.43478260869565,Qualité
107,0,2019-01-08,120160,DANONE FERME NATURE 125X8,0,0,0,DANONE,0,Bailleul(FR),0077,0024 FR LILPARK (DC),2889,3312,2878,1042,1836,2270,434,0,423,-14.641744548286605,71,257,220,160,60,97,37,0,186,-261.9718309859155,85.60311284046692,62.2568093385214,23.34630350194552,86.89613526570048,31.46135265700483,55.43478260869565,Qualité
108,0,2019-01-08,120160,DANONE FERME NATURE 125X8,0,0,0,DANONE,0,Bailleul(FR),0085,0024 FR TOULOUSE (DC),2889,3312,2878,1042,1836,2270,434,0,423,-14.641744548286605,251,249,249,67,182,182,0,0,-2,0.796812749003984,100.0,26.907630522088354,73.09236947791165,86.89613526570048,31.46135265700483,55.43478260869565,Qualité
109,0,2019-01-08,120160,DANONE FERME NATURE 125X8,0,0,0,DANONE,0,Bailleul(FR),0083,0024 FR CHAPONNAY (DC),2889,3312,2878,1042,1836,2270,434,0,423,-14.641744548286605,39,401,401,1,400,400,0,0,362,-928.2051282051282,100.0,0.24937655860349126,99.75062344139651,86.89613526570048,31.46135265700483,55.43478260869565,Qualité
110,0,2019-01-08,120160,DANONE FERME NATURE 125X8,0,0,0,DANONE,0,Bailleul(FR),0079,0024 FR PARIS SUD (DC),2889,3312,2878,1042,1836,2270,434,0,423,-14.641744548286605,459,436,436,427,9,9,0,0,-23,5.010893246187364,100.0,97.93577981651376,2.064220183486242,86.89613526570048,31.46135265700483,55.43478260869565,Qualité
111,0,2019-01-08,120160,DANONE FERME NATURE 125X8,0,0,0,DANONE,0,Bailleul(FR),0078,0024 FR PARIS NORD (DC),2889,3312,2878,1042,1836,2270,434,0,423,-14.641744548286605,516,809,662,0,662,809,147,0,293,-56.78294573643411,81.82941903584673,0.0,81.82941903584673,86.89613526570048,31.46135265700483,55.43478260869565,Qualité
112,0,2019-01-08,122525,DANONINO FRTS FRAI FRAM ABR 50X6,0,0,0,DANONINO,0,Ferrières(FR),0084,0024 FR AIX (DC),1511,1547,1441,951,490,596,106,0,36,-2.382528127068167,205,161,161,161,0,0,0,0,-44,21.463414634146343,100.0,100.0,0.0,93.14802844214609,61.47382029734971,31.674208144796374,Schéma
113,0,2019-01-08,122525,DANONINO FRTS FRAI FRAM ABR 50X6,0,0,0,DANONINO,0,Ferrières(FR),0080,0024 FR METZ (DC),1511,1547,1441,951,490,596,106,0,36,-2.382528127068167,109,113,60,60,0,53,53,0,4,-3.669724770642202,53.09734513274337,53.09734513274337,0.0,93.14802844214609,61.47382029734971,31.674208144796374,Schéma
114,0,2019-01-08,122525,DANONINO FRTS FRAI FRAM ABR 50X6,0,0,0,DANONINO,0,Ferrières(FR),0081,0024 FR TOURS (DC),1511,1547,1441,951,490,596,106,0,36,-2.382528127068167,205,178,178,6,172,172,0,0,-27,13.170731707317072,100.0,3.3707865168539324,96.62921348314607,93.14802844214609,61.47382029734971,31.674208144796374,Schéma
115,0,2019-01-08,122525,DANONINO FRTS FRAI FRAM ABR 50X6,0,0,0,DANONINO,0,Ferrières(FR),0082,0024 FR VALLET (DC),1511,1547,1441,951,490,596,106,0,36,-2.382528127068167,95,100,100,19,81,81,0,0,5,-5.2631578947368425,100.0,19.0,81.0,93.14802844214609,61.47382029734971,31.674208144796374,Schéma
116,0,2019-01-08,122525,DANONINO FRTS FRAI FRAM ABR 50X6,0,0,0,DANONINO,0,Ferrières(FR),0077,0024 FR LILPARK (DC),1511,1547,1441,951,490,596,106,0,36,-2.382528127068167,137,142,120,117,3,25,22,0,5,-3.6496350364963503,84.50704225352112,82.3943661971831,2.1126760563380174,93.14802844214609,61.47382029734971,31.674208144796374,Schéma
117,0,2019-01-08,122525,DANONINO FRTS FRAI FRAM ABR 50X6,0,0,0,DANONINO,0,Ferrières(FR),0085,0024 FR TOULOUSE (DC),1511,1547,1441,951,490,596,106,0,36,-2.382528127068167,122,173,173,111,62,62,0,0,51,-41.80327868852459,100.0,64.16184971098265,35.83815028901735,93.14802844214609,61.47382029734971,31.674208144796374,Schéma
118,0,2019-01-08,122525,DANONINO FRTS FRAI FRAM ABR 50X6,0,0,0,DANONINO,0,Ferrières(FR),0083,0024 FR CHAPONNAY (DC),1511,1547,1441,951,490,596,106,0,36,-2.382528127068167,316,307,307,254,53,53,0,0,-9,2.848101265822785,100.0,82.73615635179154,17.263843648208464,93.14802844214609,61.47382029734971,31.674208144796374,Schéma
119,0,2019-01-08,122525,DANONINO FRTS FRAI FRAM ABR 50X6,0,0,0,DANONINO,0,Ferrières(FR),0079,0024 FR PARIS SUD (DC),1511,1547,1441,951,490,596,106,0,36,-2.382528127068167,234,251,220,220,0,31,31,0,17,-7.264957264957265,87.64940239043824,87.64940239043824,0.0,93.14802844214609,61.47382029734971,31.674208144796374,Schéma
120,0,2019-01-08,122525,DANONINO FRTS FRAI FRAM ABR 50X6,0,0,0,DANONINO,0,Ferrières(FR),0078,0024 FR PARIS NORD (DC),1511,1547,1441,951,490,596,106,0,36,-2.382528127068167,88,122,122,3,119,119,0,0,34,-38.63636363636363,100.0,2.459016393442623,97.54098360655738,93.14802844214609,61.47382029734971,31.674208144796374,Schéma
121,1,2019-01-08,131291,ACTIMEL 0% NATU 3x(8x100g) FR,1,0,0,ACTIMEL,1,Rotselaar(BE),0082,0024 FR VALLET (DC),66,837,837,809,28,28,0,0,771,-1168.1818181818182,66,40,40,12,28,28,0,0,-26,39.39393939393939,100.0,30.0,70.0,100.0,96.6547192353644,3.3452807646356035,Transport
122,1,2019-01-08,139555,FJORD FRT FRAM CRAN 125X4,0,1,0,FJORD,0,LeMolay(FR),0079,0024 FR PARIS SUD (DC),74,100,71,67,4,33,29,0,26,-35.13513513513514,74,56,27,27,0,29,29,0,-18,24.324324324324323,48.214285714285715,48.214285714285715,0.0,71.0,67.0,4.0,Qualité
123,0,2019-01-09,26950,TAILLEF MOU STRW-PCH 115gx4,0,0,0,TAILLEFINE,1,Rosenheim(ALL),0084,0024 FR AIX (DC),1335,1455,1240,1005,235,450,215,0,120,-8.98876404494382,236,263,189,63,126,200,74,0,27,-11.440677966101696,71.86311787072243,23.954372623574145,47.90874524714829,85.2233676975945,69.0721649484536,16.151202749140893,Transport
124,0,2019-01-09,26950,TAILLEF MOU STRW-PCH 115gx4,0,0,0,TAILLEFINE,1,Rosenheim(ALL),0080,0024 FR METZ (DC),1335,1455,1240,1005,235,450,215,0,120,-8.98876404494382,154,138,33,0,33,138,105,0,-16,10.38961038961039,23.91304347826087,0.0,23.91304347826087,85.2233676975945,69.0721649484536,16.151202749140893,Transport
125,0,2019-01-09,26950,TAILLEF MOU STRW-PCH 115gx4,0,0,0,TAILLEFINE,1,Rosenheim(ALL),0081,0024 FR TOURS (DC),1335,1455,1240,1005,235,450,215,0,120,-8.98876404494382,167,181,181,181,0,0,0,0,14,-8.383233532934131,100.0,100.0,0.0,85.2233676975945,69.0721649484536,16.151202749140893,Transport
126,0,2019-01-09,26950,TAILLEF MOU STRW-PCH 115gx4,0,0,0,TAILLEFINE,1,Rosenheim(ALL),0082,0024 FR VALLET (DC),1335,1455,1240,1005,235,450,215,0,120,-8.98876404494382,229,166,166,166,0,0,0,0,-63,27.510917030567686,100.0,100.0,0.0,85.2233676975945,69.0721649484536,16.151202749140893,Transport
127,0,2019-01-09,26950,TAILLEF MOU STRW-PCH 115gx4,0,0,0,TAILLEFINE,1,Rosenheim(ALL),0077,0024 FR LILPARK (DC),1335,1455,1240,1005,235,450,215,0,120,-8.98876404494382,1,49,49,49,0,0,0,0,48,-4800.0,100.0,100.0,0.0,85.2233676975945,69.0721649484536,16.151202749140893,Transport
128,0,2019-01-09,26950,TAILLEF MOU STRW-PCH 115gx4,0,0,0,TAILLEFINE,1,Rosenheim(ALL),0085,0024 FR TOULOUSE (DC),1335,1455,1240,1005,235,450,215,0,120,-8.98876404494382,19,194,194,194,0,0,0,0,175,-921.0526315789474,100.0,100.0,0.0,85.2233676975945,69.0721649484536,16.151202749140893,Transport
129,0,2019-01-09,26950,TAILLEF MOU STRW-PCH 115gx4,0,0,0,TAILLEFINE,1,Rosenheim(ALL),0083,0024 FR CHAPONNAY (DC),1335,1455,1240,1005,235,450,215,0,120,-8.98876404494382,175,206,206,206,0,0,0,0,31,-17.714285714285715,100.0,100.0,0.0,85.2233676975945,69.0721649484536,16.151202749140893,Transport
130,0,2019-01-09,26950,TAILLEF MOU STRW-PCH 115gx4,0,0,0,TAILLEFINE,1,Rosenheim(ALL),0079,0024 FR PARIS SUD (DC),1335,1455,1240,1005,235,450,215,0,120,-8.98876404494382,151,114,114,114,0,0,0,0,-37,24.503311258278146,100.0,100.0,0.0,85.2233676975945,69.0721649484536,16.151202749140893,Transport
131,0,2019-01-09,26950,TAILLEF MOU STRW-PCH 115gx4,0,0,0,TAILLEFINE,1,Rosenheim(ALL),0078,0024 FR PARIS NORD (DC),1335,1455,1240,1005,235,450,215,0,120,-8.98876404494382,203,144,108,32,76,112,36,0,-59,29.064039408866996,75.0,22.22222222222222,52.77777777777778,85.2233676975945,69.0721649484536,16.151202749140893,Transport
132,0,2019-01-09,113631,GERVITA NATURE 100X8 OPL,0,0,0,GERVITA,0,Ferrières(FR),0084,0024 FR AIX (DC),7549,3890,3890,3890,0,0,0,0,-3659,48.4699960259637,142,91,91,91,0,0,0,0,-51,35.91549295774648,100.0,100.0,0.0,100.0,100.0,0.0,Expe usine
133,0,2019-01-09,113631,GERVITA NATURE 100X8 OPL,0,0,0,GERVITA,0,Ferrières(FR),0080,0024 FR METZ (DC),7549,3890,3890,3890,0,0,0,0,-3659,48.4699960259637,2007,29,29,29,0,0,0,0,-1978,98.55505729945192,100.0,100.0,0.0,100.0,100.0,0.0,Expe usine
134,0,2019-01-09,113631,GERVITA NATURE 100X8 OPL,0,0,0,GERVITA,0,Ferrières(FR),0081,0024 FR TOURS (DC),7549,3890,3890,3890,0,0,0,0,-3659,48.4699960259637,1808,1356,1356,1356,0,0,0,0,-452,25.0,100.0,100.0,0.0,100.0,100.0,0.0,Expe usine
135,1,2019-01-09,113631,GERVITA NATURE 100X8 OPL,0,0,0,GERVITA,0,Ferrières(FR),0081,0024 FR TOURS (DC),7549,3890,3890,3890,0,0,0,0,-3659,48.4699960259637,1808,1356,1356,1356,0,0,0,0,-452,25.0,100.0,100.0,0.0,100.0,100.0,0.0,Expe usine
136,0,2019-01-09,113631,GERVITA NATURE 100X8 OPL,0,0,0,GERVITA,0,Ferrières(FR),0077,0024 FR LILPARK (DC),7549,3890,3890,3890,0,0,0,0,-3659,48.4699960259637,263,172,172,172,0,0,0,0,-91,34.60076045627376,100.0,100.0,0.0,100.0,100.0,0.0,Expe usine
137,0,2019-01-09,113631,GERVITA NATURE 100X8 OPL,0,0,0,GERVITA,0,Ferrières(FR),0085,0024 FR TOULOUSE (DC),7549,3890,3890,3890,0,0,0,0,-3659,48.4699960259637,10,66,66,66,0,0,0,0,56,-560.0,100.0,100.0,0.0,100.0,100.0,0.0,Expe usine
138,0,2019-01-09,113631,GERVITA NATURE 100X8 OPL,0,0,0,GERVITA,0,Ferrières(FR),0083,0024 FR CHAPONNAY (DC),7549,3890,3890,3890,0,0,0,0,-3659,48.4699960259637,11,75,75,75,0,0,0,0,64,-581.8181818181819,100.0,100.0,0.0,100.0,100.0,0.0,Expe usine
139,0,2019-01-09,113631,GERVITA NATURE 100X8 OPL,0,0,0,GERVITA,0,Ferrières(FR),0079,0024 FR PARIS SUD (DC),7549,3890,3890,3890,0,0,0,0,-3659,48.4699960259637,1486,2012,2012,2012,0,0,0,0,526,-35.39703903095558,100.0,100.0,0.0,100.0,100.0,0.0,Expe usine
140,0,2019-01-09,113631,GERVITA NATURE 100X8 OPL,0,0,0,GERVITA,0,Ferrières(FR),0078,0024 FR PARIS NORD (DC),7549,3890,3890,3890,0,0,0,0,-3659,48.4699960259637,14,89,89,89,0,0,0,0,75,-535.7142857142857,100.0,100.0,0.0,100.0,100.0,0.0,Expe usine
141,1,2019-01-09,121314,ACTIMEL STRA 4x(10x100g) FR,0,0,0,ACTIMEL,1,Rotselaar(BE),0081,0024 FR TOURS (DC),569,4362,4362,4362,0,0,0,0,3793,-666.6080843585237,569,1366,1366,1366,0,0,0,0,797,-140.07029876977154,100.0,100.0,0.0,100.0,100.0,0.0,Transport
142,1,2019-01-09,121428,ACTIMEL FOREST FR 4x(10x100g) FR,0,0,0,ACTIMEL,1,Rotselaar(BE),0081,0024 FR TOURS (DC),557,2490,2490,2490,0,0,0,0,1933,-347.03770197486534,557,995,995,995,0,0,0,0,438,-78.63554757630162,100.0,100.0,0.0,100.0,100.0,0.0,Transport
143,1,2019-01-09,121429,ACTIMEL 0% NATU 4x(10x100g) FR,0,0,0,ACTIMEL,1,Rotselaar(BE),0081,0024 FR TOURS (DC),365,2099,2099,2087,12,12,0,0,1734,-475.06849315068496,365,859,859,847,12,12,0,0,494,-135.34246575342465,100.0,98.60302677532013,1.3969732246798685,100.0,99.42829919009051,0.5717008099094869,Transport
144,1,2019-01-09,131414,DANONINO FRTS PANACHE 50X12 OD,1,0,0,DANONINO,0,Ferrières(FR),0083,0024 FR CHAPONNAY (DC),73,129,129,63,66,66,0,0,56,-76.71232876712328,73,39,39,11,28,28,0,0,-34,46.57534246575342,100.0,28.205128205128204,71.7948717948718,100.0,48.837209302325576,51.162790697674424,Expe usine
145,0,2019-01-09,138549,L2V PTITS MIAM FRUITS 50X6,1,0,0,LES 2 VACHES,0,Ferrières(FR),0080,0024 FR METZ (DC),442,523,455,320,135,203,68,0,81,-18.32579185520362,96,103,103,103,0,0,0,0,7,-7.291666666666667,100.0,100.0,0.0,86.9980879541109,61.18546845124283,25.812619502868067,Expe usine
146,0,2019-01-09,138549,L2V PTITS MIAM FRUITS 50X6,1,0,0,LES 2 VACHES,0,Ferrières(FR),0081,0024 FR TOURS (DC),442,523,455,320,135,203,68,0,81,-18.32579185520362,52,54,54,9,45,45,0,0,2,-3.8461538461538463,100.0,16.666666666666664,83.33333333333334,86.9980879541109,61.18546845124283,25.812619502868067,Expe usine
147,0,2019-01-09,138549,L2V PTITS MIAM FRUITS 50X6,1,0,0,LES 2 VACHES,0,Ferrières(FR),0082,0024 FR VALLET (DC),442,523,455,320,135,203,68,0,81,-18.32579185520362,53,48,48,48,0,0,0,0,-5,9.433962264150944,100.0,100.0,0.0,86.9980879541109,61.18546845124283,25.812619502868067,Expe usine
148,0,2019-01-09,138549,L2V PTITS MIAM FRUITS 50X6,1,0,0,LES 2 VACHES,0,Ferrières(FR),0077,0024 FR LILPARK (DC),442,523,455,320,135,203,68,0,81,-18.32579185520362,3,28,28,28,0,0,0,0,25,-833.3333333333334,100.0,100.0,0.0,86.9980879541109,61.18546845124283,25.812619502868067,Expe usine
149,0,2019-01-09,138549,L2V PTITS MIAM FRUITS 50X6,1,0,0,LES 2 VACHES,0,Ferrières(FR),0085,0024 FR TOULOUSE (DC),442,523,455,320,135,203,68,0,81,-18.32579185520362,57,56,56,56,0,0,0,0,-1,1.7543859649122806,100.0,100.0,0.0,86.9980879541109,61.18546845124283,25.812619502868067,Expe usine
150,0,2019-01-09,138549,L2V PTITS MIAM FRUITS 50X6,1,0,0,LES 2 VACHES,0,Ferrières(FR),0083,0024 FR CHAPONNAY (DC),442,523,455,320,135,203,68,0,81,-18.32579185520362,49,55,55,55,0,0,0,0,6,-12.244897959183673,100.0,100.0,0.0,86.9980879541109,61.18546845124283,25.812619502868067,Expe usine
151,0,2019-01-09,138549,L2V PTITS MIAM FRUITS 50X6,1,0,0,LES 2 VACHES,0,Ferrières(FR),0079,0024 FR PARIS SUD (DC),442,523,455,320,135,203,68,0,81,-18.32579185520362,129,138,70,0,70,138,68,0,9,-6.976744186046512,50.72463768115942,0.0,50.72463768115942,86.9980879541109,61.18546845124283,25.812619502868067,Expe usine
152,0,2019-01-09,138549,L2V PTITS MIAM FRUITS 50X6,1,0,0,LES 2 VACHES,0,Ferrières(FR),0078,0024 FR PARIS NORD (DC),442,523,455,320,135,203,68,0,81,-18.32579185520362,3,41,41,21,20,20,0,0,38,-1266.6666666666667,100.0,51.21951219512195,48.78048780487805,86.9980879541109,61.18546845124283,25.812619502868067,Expe usine
153,1,2019-01-10,127336,ACTIVIA SAV FRTS ROUGES 125X4,0,0,0,ACTIVIA,0,Bailleul(FR),0078,0024 FR PARIS NORD (DC),38,312,312,289,23,23,0,0,274,-721.0526315789474,38,40,40,17,23,23,0,0,2,-5.2631578947368425,100.0,42.5,57.5,100.0,92.62820512820514,7.371794871794862,Transport
154,1,2019-01-11,69004,DANETTE MOU LIEG 80X8 CAFE NEW,0,0,0,DANETTE,1,Ochsenfurt(ALL),0079,0024 FR PARIS SUD (DC),51,1105,1002,838,164,267,103,0,1054,-2066.6666666666665,50,145,145,29,116,116,0,0,95,-190.0,100.0,20.0,80.0,90.67873303167421,75.83710407239819,14.841628959276022,Transport
155,1,2019-01-11,69004,DANETTE MOU LIEG 80X8 CAFE NEW,0,0,0,DANETTE,1,Ochsenfurt(ALL),0078,0024 FR PARIS NORD (DC),51,1105,1002,838,164,267,103,0,1054,-2066.6666666666665,1,133,133,94,39,39,0,0,132,-13200.0,100.0,70.67669172932331,29.32330827067669,90.67873303167421,75.83710407239819,14.841628959276022,Transport
156,1,2019-01-11,83923,ACTIMEL NATU 3x(14x100g) FR,0,0,0,ACTIMEL,1,Rotselaar(BE),0082,0024 FR VALLET (DC),103,1006,930,834,96,172,76,0,903,-876.6990291262136,103,117,94,0,94,117,23,0,14,-13.592233009708737,80.34188034188034,0.0,80.34188034188034,92.44532803180915,82.90258449304176,9.542743538767397,Transport
157,1,2019-01-11,113939,ACTIVIA NATURE 125X12 OD,1,0,0,ACTIVIA,0,Bailleul(FR),0080,0024 FR METZ (DC),66,870,845,817,28,53,25,0,804,-1218.1818181818182,21,12,12,2,10,10,0,0,-9,42.857142857142854,100.0,16.666666666666664,83.33333333333334,97.12643678160919,93.90804597701148,3.2183908045977034,Qualité
158,1,2019-01-11,113939,ACTIVIA NATURE 125X12 OD,1,0,0,ACTIVIA,0,Bailleul(FR),0077,0024 FR LILPARK (DC),66,870,845,817,28,53,25,0,804,-1218.1818181818182,45,25,25,7,18,18,0,0,-20,44.44444444444444,100.0,28.000000000000004,72.0,97.12643678160919,93.90804597701148,3.2183908045977034,Qualité
159,1,2019-01-11,121313,ACTIMEL MULTI 4x(10x100g) FR,0,0,0,ACTIMEL,1,Rotselaar(BE),0082,0024 FR VALLET (DC),351,4790,4789,4274,515,516,1,0,4439,-1264.6723646723647,351,655,655,140,515,515,0,0,304,-86.6096866096866,100.0,21.374045801526716,78.62595419847328,99.97912317327766,89.22755741127348,10.751565762004176,Transport
160,1,2019-01-11,121315,ACTIMEL NATU 4x(10x100g) FR,0,0,0,ACTIMEL,1,Rotselaar(BE),0082,0024 FR VALLET (DC),492,5377,5440,4727,713,650,-63,0,4885,-992.8861788617886,492,834,834,128,706,706,0,0,342,-69.51219512195122,100.0,15.347721822541965,84.65227817745803,101.17165705783894,87.9114748000744,13.26018225776454,Transport
161,1,2019-01-11,122061,VELOUTE FRUIX JAUNES 125X8 OD,1,0,0,VELOUTE,0,Villecomtal(FR),0080,0024 FR METZ (DC),71,435,418,389,29,46,17,0,364,-512.6760563380282,71,46,29,0,29,46,17,0,-25,35.2112676056338,63.04347826086957,0.0,63.04347826086957,96.0919540229885,89.42528735632183,6.666666666666671,Transport
162,1,2019-01-11,131291,ACTIMEL 0% NATU 3x(8x100g) FR,1,0,0,ACTIMEL,1,Rotselaar(BE),0082,0024 FR VALLET (DC),144,1405,1405,1215,190,190,0,0,1261,-875.6944444444445,144,77,77,35,42,42,0,0,-67,46.52777777777778,100.0,45.45454545454545,54.54545454545455,100.0,86.47686832740213,13.52313167259787,Transport
163,1,2019-01-11,134010,VELOUTE FRUIX PANACHE 125X16 OD,1,0,0,VELOUTE,0,Villecomtal(FR),0080,0024 FR METZ (DC),7033,16792,15920,16721,-801,71,872,0,9759,-138.76013081188682,7033,2157,2157,2051,106,106,0,0,-4876,69.33030001421868,100.0,95.08576726935559,4.9142327306444145,94.80705097665555,99.57717960933779,-4.770128632682244,Transport
164,1,2019-01-11,139555,FJORD FRT FRAM CRAN 125X4,0,1,0,FJORD,0,LeMolay(FR),0079,0024 FR PARIS SUD (DC),74,151,145,135,10,16,6,0,77,-104.05405405405405,74,75,69,60,9,15,6,0,1,-1.3513513513513513,92.0,80.0,12.0,96.02649006622516,89.40397350993378,6.622516556291387,Previsions
165,0,2019-01-14,127660,DANONINO ARO RIGO PANACHE 125X12,1,0,0,DANONINO,0,Bailleul(FR),0084,0024 FR AIX (DC),1710,1190,1143,875,268,315,47,0,-520,30.4093567251462,228,101,94,94,0,7,7,0,-127,55.70175438596491,93.06930693069307,93.06930693069307,0.0,96.05042016806723,73.52941176470588,22.52100840336135,Production
166,0,2019-01-14,127660,DANONINO ARO RIGO PANACHE 125X12,1,0,0,DANONINO,0,Bailleul(FR),0080,0024 FR METZ (DC),1710,1190,1143,875,268,315,47,0,-520,30.4093567251462,285,268,268,0,268,268,0,0,-17,5.964912280701754,100.0,0.0,100.0,96.05042016806723,73.52941176470588,22.52100840336135,Production
167,0,2019-01-14,127660,DANONINO ARO RIGO PANACHE 125X12,1,0,0,DANONINO,0,Bailleul(FR),0081,0024 FR TOURS (DC),1710,1190,1143,875,268,315,47,0,-520,30.4093567251462,137,124,124,124,0,0,0,0,-13,9.489051094890511,100.0,100.0,0.0,96.05042016806723,73.52941176470588,22.52100840336135,Production
168,0,2019-01-14,127660,DANONINO ARO RIGO PANACHE 125X12,1,0,0,DANONINO,0,Bailleul(FR),0082,0024 FR VALLET (DC),1710,1190,1143,875,268,315,47,0,-520,30.4093567251462,120,121,121,121,0,0,0,0,1,-0.8333333333333334,100.0,100.0,0.0,96.05042016806723,73.52941176470588,22.52100840336135,Production
169,0,2019-01-14,127660,DANONINO ARO RIGO PANACHE 125X12,1,0,0,DANONINO,0,Bailleul(FR),0077,0024 FR LILPARK (DC),1710,1190,1143,875,268,315,47,0,-520,30.4093567251462,93,53,53,53,0,0,0,0,-40,43.01075268817204,100.0,100.0,0.0,96.05042016806723,73.52941176470588,22.52100840336135,Production
170,0,2019-01-14,127660,DANONINO ARO RIGO PANACHE 125X12,1,0,0,DANONINO,0,Bailleul(FR),0085,0024 FR TOULOUSE (DC),1710,1190,1143,875,268,315,47,0,-520,30.4093567251462,175,125,125,125,0,0,0,0,-50,28.571428571428573,100.0,100.0,0.0,96.05042016806723,73.52941176470588,22.52100840336135,Production
171,0,2019-01-14,127660,DANONINO ARO RIGO PANACHE 125X12,1,0,0,DANONINO,0,Bailleul(FR),0083,0024 FR CHAPONNAY (DC),1710,1190,1143,875,268,315,47,0,-520,30.4093567251462,278,185,172,172,0,13,13,0,-93,33.45323741007194,92.97297297297298,92.97297297297298,0.0,96.05042016806723,73.52941176470588,22.52100840336135,Production
172,0,2019-01-14,127660,DANONINO ARO RIGO PANACHE 125X12,1,0,0,DANONINO,0,Bailleul(FR),0079,0024 FR PARIS SUD (DC),1710,1190,1143,875,268,315,47,0,-520,30.4093567251462,193,103,87,87,0,16,16,0,-90,46.63212435233161,84.46601941747572,84.46601941747572,0.0,96.05042016806723,73.52941176470588,22.52100840336135,Production
173,0,2019-01-14,127660,DANONINO ARO RIGO PANACHE 125X12,1,0,0,DANONINO,0,Bailleul(FR),0078,0024 FR PARIS NORD (DC),1710,1190,1143,875,268,315,47,0,-520,30.4093567251462,201,110,99,99,0,11,11,0,-91,45.27363184079602,90.0,90.0,0.0,96.05042016806723,73.52941176470588,22.52100840336135,Production
174,1,2019-01-14,135065,ACTIVIA SAV PANACHE 125X12 OD,1,0,0,ACTIVIA,0,Bailleul(FR),0079,0024 FR PARIS SUD (DC),59,892,892,851,41,41,0,0,833,-1411.864406779661,59,34,34,0,34,34,0,0,-25,42.3728813559322,100.0,0.0,100.0,100.0,95.4035874439462,4.5964125560538065,Probleme Copacking
175,1,2019-01-14,137033,ACTIVIA 0% NATURE 125X16 OD,0,0,0,ACTIVIA,0,Bailleul(FR),0085,0024 FR TOULOUSE (DC),367,1155,1155,1100,55,55,0,0,788,-214.71389645776566,367,224,224,169,55,55,0,0,-143,38.96457765667575,100.0,75.44642857142857,24.55357142857143,100.0,95.23809523809523,4.761904761904773,Previsions
176,0,2019-01-14,140280,Activia chia/raspb/muesli 170g FR-copack,0,0,0,ACTIVIA,1,Roumanie(RO),0084,0024 FR AIX (DC),594,812,693,367,326,445,119,0,218,-36.7003367003367,71,78,74,47,27,31,4,0,7,-9.859154929577464,94.87179487179486,60.256410256410255,34.615384615384606,85.34482758620689,45.19704433497537,40.14778325123152,Transport
177,0,2019-01-14,140280,Activia chia/raspb/muesli 170g FR-copack,0,0,0,ACTIVIA,1,Roumanie(RO),0080,0024 FR METZ (DC),594,812,693,367,326,445,119,0,218,-36.7003367003367,75,94,73,10,63,84,21,0,19,-25.333333333333332,77.6595744680851,10.638297872340425,67.02127659574467,85.34482758620689,45.19704433497537,40.14778325123152,Transport
178,0,2019-01-14,140280,Activia chia/raspb/muesli 170g FR-copack,0,0,0,ACTIVIA,1,Roumanie(RO),0081,0024 FR TOURS (DC),594,812,693,367,326,445,119,0,218,-36.7003367003367,47,58,58,58,0,0,0,0,11,-23.404255319148938,100.0,100.0,0.0,85.34482758620689,45.19704433497537,40.14778325123152,Transport
179,0,2019-01-14,140280,Activia chia/raspb/muesli 170g FR-copack,0,0,0,ACTIVIA,1,Roumanie(RO),0082,0024 FR VALLET (DC),594,812,693,367,326,445,119,0,218,-36.7003367003367,52,57,23,23,0,34,34,0,5,-9.615384615384615,40.35087719298245,40.35087719298245,0.0,85.34482758620689,45.19704433497537,40.14778325123152,Transport
180,0,2019-01-14,140280,Activia chia/raspb/muesli 170g FR-copack,0,0,0,ACTIVIA,1,Roumanie(RO),0077,0024 FR LILPARK (DC),594,812,693,367,326,445,119,0,218,-36.7003367003367,27,41,41,0,41,41,0,0,14,-51.851851851851855,100.0,0.0,100.0,85.34482758620689,45.19704433497537,40.14778325123152,Transport
181,0,2019-01-14,140280,Activia chia/raspb/muesli 170g FR-copack,0,0,0,ACTIVIA,1,Roumanie(RO),0085,0024 FR TOULOUSE (DC),594,812,693,367,326,445,119,0,218,-36.7003367003367,8,90,90,8,82,82,0,0,82,-1025.0,100.0,8.88888888888889,91.11111111111111,85.34482758620689,45.19704433497537,40.14778325123152,Transport
182,0,2019-01-14,140280,Activia chia/raspb/muesli 170g FR-copack,0,0,0,ACTIVIA,1,Roumanie(RO),0083,0024 FR CHAPONNAY (DC),594,812,693,367,326,445,119,0,218,-36.7003367003367,72,99,93,93,0,6,6,0,27,-37.5,93.93939393939394,93.93939393939394,0.0,85.34482758620689,45.19704433497537,40.14778325123152,Transport
183,0,2019-01-14,140280,Activia chia/raspb/muesli 170g FR-copack,0,0,0,ACTIVIA,1,Roumanie(RO),0079,0024 FR PARIS SUD (DC),594,812,693,367,326,445,119,0,218,-36.7003367003367,74,85,39,0,39,85,46,0,11,-14.864864864864865,45.88235294117647,0.0,45.88235294117647,85.34482758620689,45.19704433497537,40.14778325123152,Transport
184,0,2019-01-14,140280,Activia chia/raspb/muesli 170g FR-copack,0,0,0,ACTIVIA,1,Roumanie(RO),0078,0024 FR PARIS NORD (DC),594,812,693,367,326,445,119,0,218,-36.7003367003367,168,210,202,128,74,82,8,0,42,-25.0,96.19047619047619,60.952380952380956,35.238095238095234,85.34482758620689,45.19704433497537,40.14778325123152,Transport
185,1,2019-01-15,121315,ACTIMEL NATU 4x(10x100g) FR,0,0,0,ACTIMEL,1,Rotselaar(BE),0082,0024 FR VALLET (DC),251,2966,2784,2663,121,303,182,0,2715,-1081.6733067729083,251,445,263,142,121,303,182,0,194,-77.29083665338645,59.10112359550562,31.910112359550563,27.191011235955056,93.86378961564397,89.78422117329737,4.0795684423465985,Transport
186,0,2019-01-15,127660,DANONINO ARO RIGO PANACHE 125X12,1,0,0,DANONINO,0,Bailleul(FR),0084,0024 FR AIX (DC),1818,1573,1573,1368,205,205,0,0,-245,13.476347634763476,110,86,86,86,0,0,0,0,-24,21.818181818181817,100.0,100.0,0.0,100.0,86.96757787666878,13.032422123331216,Production
187,0,2019-01-15,127660,DANONINO ARO RIGO PANACHE 125X12,1,0,0,DANONINO,0,Bailleul(FR),0080,0024 FR METZ (DC),1818,1573,1573,1368,205,205,0,0,-245,13.476347634763476,280,205,205,0,205,205,0,0,-75,26.785714285714285,100.0,0.0,100.0,100.0,86.96757787666878,13.032422123331216,Production
188,0,2019-01-15,127660,DANONINO ARO RIGO PANACHE 125X12,1,0,0,DANONINO,0,Bailleul(FR),0081,0024 FR TOURS (DC),1818,1573,1573,1368,205,205,0,0,-245,13.476347634763476,278,271,271,271,0,0,0,0,-7,2.5179856115107913,100.0,100.0,0.0,100.0,86.96757787666878,13.032422123331216,Production
189,0,2019-01-15,127660,DANONINO ARO RIGO PANACHE 125X12,1,0,0,DANONINO,0,Bailleul(FR),0082,0024 FR VALLET (DC),1818,1573,1573,1368,205,205,0,0,-245,13.476347634763476,125,121,121,121,0,0,0,0,-4,3.2,100.0,100.0,0.0,100.0,86.96757787666878,13.032422123331216,Production
190,0,2019-01-15,127660,DANONINO ARO RIGO PANACHE 125X12,1,0,0,DANONINO,0,Bailleul(FR),0077,0024 FR LILPARK (DC),1818,1573,1573,1368,205,205,0,0,-245,13.476347634763476,216,216,216,216,0,0,0,0,0,0.0,100.0,100.0,0.0,100.0,86.96757787666878,13.032422123331216,Production
191,0,2019-01-15,127660,DANONINO ARO RIGO PANACHE 125X12,1,0,0,DANONINO,0,Bailleul(FR),0085,0024 FR TOULOUSE (DC),1818,1573,1573,1368,205,205,0,0,-245,13.476347634763476,121,124,124,124,0,0,0,0,3,-2.479338842975207,100.0,100.0,0.0,100.0,86.96757787666878,13.032422123331216,Production
192,0,2019-01-15,127660,DANONINO ARO RIGO PANACHE 125X12,1,0,0,DANONINO,0,Bailleul(FR),0083,0024 FR CHAPONNAY (DC),1818,1573,1573,1368,205,205,0,0,-245,13.476347634763476,273,226,226,226,0,0,0,0,-47,17.216117216117215,100.0,100.0,0.0,100.0,86.96757787666878,13.032422123331216,Production
193,0,2019-01-15,127660,DANONINO ARO RIGO PANACHE 125X12,1,0,0,DANONINO,0,Bailleul(FR),0079,0024 FR PARIS SUD (DC),1818,1573,1573,1368,205,205,0,0,-245,13.476347634763476,156,151,151,151,0,0,0,0,-5,3.2051282051282053,100.0,100.0,0.0,100.0,86.96757787666878,13.032422123331216,Production
194,0,2019-01-15,127660,DANONINO ARO RIGO PANACHE 125X12,1,0,0,DANONINO,0,Bailleul(FR),0078,0024 FR PARIS NORD (DC),1818,1573,1573,1368,205,205,0,0,-245,13.476347634763476,259,173,173,173,0,0,0,0,-86,33.204633204633204,100.0,100.0,0.0,100.0,86.96757787666878,13.032422123331216,Production
195,0,2019-01-15,127911,GERVAIS GRIEGO 115X4 VANILLA FR,0,0,0,GERVAIS,1,Rosenheim(ALL),0084,0024 FR AIX (DC),1699,1843,1689,1679,10,164,154,0,144,-8.475573866980577,184,203,203,203,0,0,0,0,19,-10.326086956521738,100.0,100.0,0.0,91.64405860010851,91.10146500271297,0.5425935973955376,Schéma
196,0,2019-01-15,127911,GERVAIS GRIEGO 115X4 VANILLA FR,0,0,0,GERVAIS,1,Rosenheim(ALL),0080,0024 FR METZ (DC),1699,1843,1689,1679,10,164,154,0,144,-8.475573866980577,99,88,55,55,0,33,33,0,-11,11.11111111111111,62.5,62.5,0.0,91.64405860010851,91.10146500271297,0.5425935973955376,Schéma
197,0,2019-01-15,127911,GERVAIS GRIEGO 115X4 VANILLA FR,0,0,0,GERVAIS,1,Rosenheim(ALL),0081,0024 FR TOURS (DC),1699,1843,1689,1679,10,164,154,0,144,-8.475573866980577,313,248,186,182,4,66,62,0,-65,20.766773162939298,75.0,73.38709677419355,1.6129032258064484,91.64405860010851,91.10146500271297,0.5425935973955376,Schéma
198,0,2019-01-15,127911,GERVAIS GRIEGO 115X4 VANILLA FR,0,0,0,GERVAIS,1,Rosenheim(ALL),0082,0024 FR VALLET (DC),1699,1843,1689,1679,10,164,154,0,144,-8.475573866980577,17,186,186,186,0,0,0,0,169,-994.1176470588235,100.0,100.0,0.0,91.64405860010851,91.10146500271297,0.5425935973955376,Schéma
199,0,2019-01-15,127911,GERVAIS GRIEGO 115X4 VANILLA FR,0,0,0,GERVAIS,1,Rosenheim(ALL),0077,0024 FR LILPARK (DC),1699,1843,1689,1679,10,164,154,0,144,-8.475573866980577,141,140,81,75,6,65,59,0,-1,0.7092198581560284,57.85714285714286,53.57142857142857,4.285714285714292,91.64405860010851,91.10146500271297,0.5425935973955376,Schéma
200,0,2019-01-15,127911,GERVAIS GRIEGO 115X4 VANILLA FR,0,0,0,GERVAIS,1,Rosenheim(ALL),0085,0024 FR TOULOUSE (DC),1699,1843,1689,1679,10,164,154,0,144,-8.475573866980577,187,235,235,235,0,0,0,0,48,-25.668449197860962,100.0,100.0,0.0,91.64405860010851,91.10146500271297,0.5425935973955376,Schéma
201,0,2019-01-15,127911,GERVAIS GRIEGO 115X4 VANILLA FR,0,0,0,GERVAIS,1,Rosenheim(ALL),0083,0024 FR CHAPONNAY (DC),1699,1843,1689,1679,10,164,154,0,144,-8.475573866980577,240,221,221,221,0,0,0,0,-19,7.916666666666667,100.0,100.0,0.0,91.64405860010851,91.10146500271297,0.5425935973955376,Schéma
202,0,2019-01-15,127911,GERVAIS GRIEGO 115X4 VANILLA FR,0,0,0,GERVAIS,1,Rosenheim(ALL),0079,0024 FR PARIS SUD (DC),1699,1843,1689,1679,10,164,154,0,144,-8.475573866980577,313,315,315,315,0,0,0,0,2,-0.6389776357827476,100.0,100.0,0.0,91.64405860010851,91.10146500271297,0.5425935973955376,Schéma
203,0,2019-01-15,127911,GERVAIS GRIEGO 115X4 VANILLA FR,0,0,0,GERVAIS,1,Rosenheim(ALL),0078,0024 FR PARIS NORD (DC),1699,1843,1689,1679,10,164,154,0,144,-8.475573866980577,205,207,207,207,0,0,0,0,2,-0.975609756097561,100.0,100.0,0.0,91.64405860010851,91.10146500271297,0.5425935973955376,Schéma
204,0,2019-01-16,69190,FJORD NATURE 125GX8,0,0,0,FJORD,0,LeMolay(FR),0084,0024 FR AIX (DC),5356,4620,4303,4294,9,326,317,0,-736,13.741598207617626,614,576,576,576,0,0,0,0,-38,6.188925081433225,100.0,100.0,0.0,93.13852813852814,92.94372294372295,0.1948051948051983,A Creuser
205,0,2019-01-16,69190,FJORD NATURE 125GX8,0,0,0,FJORD,0,LeMolay(FR),0080,0024 FR METZ (DC),5356,4620,4303,4294,9,326,317,0,-736,13.741598207617626,127,215,107,106,1,109,108,0,88,-69.29133858267717,49.76744186046512,49.30232558139535,0.46511627906976827,93.13852813852814,92.94372294372295,0.1948051948051983,A Creuser
206,0,2019-01-16,69190,FJORD NATURE 125GX8,0,0,0,FJORD,0,LeMolay(FR),0081,0024 FR TOURS (DC),5356,4620,4303,4294,9,326,317,0,-736,13.741598207617626,467,466,390,384,6,82,76,0,-1,0.21413276231263384,83.69098712446352,82.40343347639485,1.2875536480686662,93.13852813852814,92.94372294372295,0.1948051948051983,A Creuser
207,0,2019-01-16,69190,FJORD NATURE 125GX8,0,0,0,FJORD,0,LeMolay(FR),0082,0024 FR VALLET (DC),5356,4620,4303,4294,9,326,317,0,-736,13.741598207617626,286,268,135,135,0,133,133,0,-18,6.293706293706293,50.373134328358205,50.373134328358205,0.0,93.13852813852814,92.94372294372295,0.1948051948051983,A Creuser
208,0,2019-01-16,69190,FJORD NATURE 125GX8,0,0,0,FJORD,0,LeMolay(FR),0077,0024 FR LILPARK (DC),5356,4620,4303,4294,9,326,317,0,-736,13.741598207617626,254,202,202,200,2,2,0,0,-52,20.47244094488189,100.0,99.00990099009901,0.9900990099009874,93.13852813852814,92.94372294372295,0.1948051948051983,A Creuser
209,0,2019-01-16,69190,FJORD NATURE 125GX8,0,0,0,FJORD,0,LeMolay(FR),0085,0024 FR TOULOUSE (DC),5356,4620,4303,4294,9,326,317,0,-736,13.741598207617626,894,664,664,664,0,0,0,0,-230,25.727069351230426,100.0,100.0,0.0,93.13852813852814,92.94372294372295,0.1948051948051983,A Creuser
210,0,2019-01-16,69190,FJORD NATURE 125GX8,0,0,0,FJORD,0,LeMolay(FR),0083,0024 FR CHAPONNAY (DC),5356,4620,4303,4294,9,326,317,0,-736,13.741598207617626,1344,1162,1162,1162,0,0,0,0,-182,13.541666666666666,100.0,100.0,0.0,93.13852813852814,92.94372294372295,0.1948051948051983,A Creuser
211,0,2019-01-16,69190,FJORD NATURE 125GX8,0,0,0,FJORD,0,LeMolay(FR),0079,0024 FR PARIS SUD (DC),5356,4620,4303,4294,9,326,317,0,-736,13.741598207617626,690,576,576,576,0,0,0,0,-114,16.52173913043478,100.0,100.0,0.0,93.13852813852814,92.94372294372295,0.1948051948051983,A Creuser
212,0,2019-01-16,69190,FJORD NATURE 125GX8,0,0,0,FJORD,0,LeMolay(FR),0078,0024 FR PARIS NORD (DC),5356,4620,4303,4294,9,326,317,0,-736,13.741598207617626,680,491,491,491,0,0,0,0,-189,27.794117647058822,100.0,100.0,0.0,93.13852813852814,92.94372294372295,0.1948051948051983,A Creuser
213,0,2019-01-16,79537,LES 2 VACHES FLAN BIO 100X4,0,0,0,LES 2 VACHES,0,LeMolay(FR),0084,0024 FR AIX (DC),1393,2016,1641,1637,4,379,375,0,623,-44.72361809045226,207,854,479,479,0,375,375,0,647,-312.56038647342996,56.08899297423887,56.08899297423887,0.0,81.39880952380952,81.20039682539682,0.19841269841269593,Previsions
214,0,2019-01-16,79537,LES 2 VACHES FLAN BIO 100X4,0,0,0,LES 2 VACHES,0,LeMolay(FR),0080,0024 FR METZ (DC),1393,2016,1641,1637,4,379,375,0,623,-44.72361809045226,131,118,118,118,0,0,0,0,-13,9.923664122137405,100.0,100.0,0.0,81.39880952380952,81.20039682539682,0.19841269841269593,Previsions
215,0,2019-01-16,79537,LES 2 VACHES FLAN BIO 100X4,0,0,0,LES 2 VACHES,0,LeMolay(FR),0081,0024 FR TOURS (DC),1393,2016,1641,1637,4,379,375,0,623,-44.72361809045226,217,146,146,146,0,0,0,0,-71,32.71889400921659,100.0,100.0,0.0,81.39880952380952,81.20039682539682,0.19841269841269593,Previsions
216,0,2019-01-16,79537,LES 2 VACHES FLAN BIO 100X4,0,0,0,LES 2 VACHES,0,LeMolay(FR),0082,0024 FR VALLET (DC),1393,2016,1641,1637,4,379,375,0,623,-44.72361809045226,136,64,64,60,4,4,0,0,-72,52.94117647058823,100.0,93.75,6.25,81.39880952380952,81.20039682539682,0.19841269841269593,Previsions
217,0,2019-01-16,79537,LES 2 VACHES FLAN BIO 100X4,0,0,0,LES 2 VACHES,0,LeMolay(FR),0077,0024 FR LILPARK (DC),1393,2016,1641,1637,4,379,375,0,623,-44.72361809045226,81,71,71,71,0,0,0,0,-10,12.345679012345679,100.0,100.0,0.0,81.39880952380952,81.20039682539682,0.19841269841269593,Previsions
218,0,2019-01-16,79537,LES 2 VACHES FLAN BIO 100X4,0,0,0,LES 2 VACHES,0,LeMolay(FR),0085,0024 FR TOULOUSE (DC),1393,2016,1641,1637,4,379,375,0,623,-44.72361809045226,218,180,180,180,0,0,0,0,-38,17.431192660550458,100.0,100.0,0.0,81.39880952380952,81.20039682539682,0.19841269841269593,Previsions
219,0,2019-01-16,79537,LES 2 VACHES FLAN BIO 100X4,0,0,0,LES 2 VACHES,0,LeMolay(FR),0083,0024 FR CHAPONNAY (DC),1393,2016,1641,1637,4,379,375,0,623,-44.72361809045226,3,220,220,220,0,0,0,0,217,-7233.333333333333,100.0,100.0,0.0,81.39880952380952,81.20039682539682,0.19841269841269593,Previsions
220,0,2019-01-16,79537,LES 2 VACHES FLAN BIO 100X4,0,0,0,LES 2 VACHES,0,LeMolay(FR),0079,0024 FR PARIS SUD (DC),1393,2016,1641,1637,4,379,375,0,623,-44.72361809045226,178,137,137,137,0,0,0,0,-41,23.03370786516854,100.0,100.0,0.0,81.39880952380952,81.20039682539682,0.19841269841269593,Previsions
221,0,2019-01-16,79537,LES 2 VACHES FLAN BIO 100X4,0,0,0,LES 2 VACHES,0,LeMolay(FR),0078,0024 FR PARIS NORD (DC),1393,2016,1641,1637,4,379,375,0,623,-44.72361809045226,222,226,226,226,0,0,0,0,4,-1.8018018018018018,100.0,100.0,0.0,81.39880952380952,81.20039682539682,0.19841269841269593,Previsions
222,0,2019-01-16,113631,GERVITA NATURE 100X8 OPL,0,0,0,GERVITA,0,Ferrières(FR),0084,0024 FR AIX (DC),9693,5364,5166,4546,620,818,198,0,-4329,44.661095636026,1524,1057,1055,1047,8,10,2,0,-467,30.64304461942257,99.81078524124882,99.05392620624409,0.7568590350047373,96.30872483221476,84.75018642803877,11.55853840417599,A Creuser
223,0,2019-01-16,113631,GERVITA NATURE 100X8 OPL,0,0,0,GERVITA,0,Ferrières(FR),0080,0024 FR METZ (DC),9693,5364,5166,4546,620,818,198,0,-4329,44.661095636026,918,666,666,666,0,0,0,0,-252,27.45098039215686,100.0,100.0,0.0,96.30872483221476,84.75018642803877,11.55853840417599,A Creuser
224,0,2019-01-16,113631,GERVITA NATURE 100X8 OPL,0,0,0,GERVITA,0,Ferrières(FR),0081,0024 FR TOURS (DC),9693,5364,5166,4546,620,818,198,0,-4329,44.661095636026,579,460,460,460,0,0,0,0,-119,20.552677029360968,100.0,100.0,0.0,96.30872483221476,84.75018642803877,11.55853840417599,A Creuser
225,0,2019-01-16,113631,GERVITA NATURE 100X8 OPL,0,0,0,GERVITA,0,Ferrières(FR),0082,0024 FR VALLET (DC),9693,5364,5166,4546,620,818,198,0,-4329,44.661095636026,1052,774,774,774,0,0,0,0,-278,26.425855513307983,100.0,100.0,0.0,96.30872483221476,84.75018642803877,11.55853840417599,A Creuser
226,0,2019-01-16,113631,GERVITA NATURE 100X8 OPL,0,0,0,GERVITA,0,Ferrières(FR),0077,0024 FR LILPARK (DC),9693,5364,5166,4546,620,818,198,0,-4329,44.661095636026,950,648,648,648,0,0,0,0,-302,31.789473684210527,100.0,100.0,0.0,96.30872483221476,84.75018642803877,11.55853840417599,A Creuser
227,0,2019-01-16,113631,GERVITA NATURE 100X8 OPL,0,0,0,GERVITA,0,Ferrières(FR),0085,0024 FR TOULOUSE (DC),9693,5364,5166,4546,620,818,198,0,-4329,44.661095636026,1813,1358,1162,550,612,808,196,0,-455,25.096525096525095,85.56701030927834,40.500736377025035,45.06627393225331,96.30872483221476,84.75018642803877,11.55853840417599,A Creuser
228,1,2019-01-16,113631,GERVITA NATURE 100X8 OPL,0,0,0,GERVITA,0,Ferrières(FR),0085,0024 FR TOULOUSE (DC),9693,5364,5166,4546,620,818,198,0,-4329,44.661095636026,1813,1358,1162,550,612,808,196,0,-455,25.096525096525095,85.56701030927834,40.500736377025035,45.06627393225331,96.30872483221476,84.75018642803877,11.55853840417599,A Creuser
229,0,2019-01-16,113631,GERVITA NATURE 100X8 OPL,0,0,0,GERVITA,0,Ferrières(FR),0083,0024 FR CHAPONNAY (DC),9693,5364,5166,4546,620,818,198,0,-4329,44.661095636026,433,201,201,201,0,0,0,0,-232,53.5796766743649,100.0,100.0,0.0,96.30872483221476,84.75018642803877,11.55853840417599,A Creuser
230,0,2019-01-16,113631,GERVITA NATURE 100X8 OPL,0,0,0,GERVITA,0,Ferrières(FR),0079,0024 FR PARIS SUD (DC),9693,5364,5166,4546,620,818,198,0,-4329,44.661095636026,611,200,200,200,0,0,0,0,-411,67.26677577741407,100.0,100.0,0.0,96.30872483221476,84.75018642803877,11.55853840417599,A Creuser
231,0,2019-01-16,121321,ACTIMEL MULTI 3x(8x100g) FR,0,0,0,ACTIMEL,1,Rotselaar(BE),0084,0024 FR AIX (DC),1560,985,860,858,2,127,125,0,-575,36.85897435897436,224,165,96,96,0,69,69,0,-59,26.339285714285715,58.18181818181818,58.18181818181818,0.0,87.30964467005076,87.10659898477158,0.20304568527917866,Schéma
232,0,2019-01-16,121321,ACTIMEL MULTI 3x(8x100g) FR,0,0,0,ACTIMEL,1,Rotselaar(BE),0082,0024 FR VALLET (DC),1560,985,860,858,2,127,125,0,-575,36.85897435897436,186,118,62,60,2,58,56,0,-68,36.55913978494624,52.54237288135594,50.847457627118644,1.6949152542372943,87.30964467005076,87.10659898477158,0.20304568527917866,Schéma
233,0,2019-01-16,121321,ACTIMEL MULTI 3x(8x100g) FR,0,0,0,ACTIMEL,1,Rotselaar(BE),0085,0024 FR TOULOUSE (DC),1560,985,860,858,2,127,125,0,-575,36.85897435897436,249,157,157,157,0,0,0,0,-92,36.94779116465863,100.0,100.0,0.0,87.30964467005076,87.10659898477158,0.20304568527917866,Schéma
234,0,2019-01-16,121321,ACTIMEL MULTI 3x(8x100g) FR,0,0,0,ACTIMEL,1,Rotselaar(BE),0083,0024 FR CHAPONNAY (DC),1560,985,860,858,2,127,125,0,-575,36.85897435897436,298,209,209,209,0,0,0,0,-89,29.86577181208054,100.0,100.0,0.0,87.30964467005076,87.10659898477158,0.20304568527917866,Schéma
235,0,2019-01-16,121321,ACTIMEL MULTI 3x(8x100g) FR,0,0,0,ACTIMEL,1,Rotselaar(BE),0079,0024 FR PARIS SUD (DC),1560,985,860,858,2,127,125,0,-575,36.85897435897436,294,188,188,188,0,0,0,0,-106,36.054421768707485,100.0,100.0,0.0,87.30964467005076,87.10659898477158,0.20304568527917866,Schéma
236,0,2019-01-16,121321,ACTIMEL MULTI 3x(8x100g) FR,0,0,0,ACTIMEL,1,Rotselaar(BE),0078,0024 FR PARIS NORD (DC),1560,985,860,858,2,127,125,0,-575,36.85897435897436,309,148,148,148,0,0,0,0,-161,52.103559870550164,100.0,100.0,0.0,87.30964467005076,87.10659898477158,0.20304568527917866,Schéma
237,1,2019-01-16,121428,ACTIMEL FOREST FR 4x(10x100g) FR,0,0,0,ACTIMEL,1,Rotselaar(BE),0082,0024 FR VALLET (DC),138,2038,1947,1947,0,91,91,0,1900,-1376.8115942028985,138,213,124,124,0,89,89,0,75,-54.34782608695652,58.21596244131455,58.21596244131455,0.0,95.53483807654564,95.53483807654564,0.0,Previsions
238,1,2019-01-16,131384,ACTIVIA FIGUE 125X4 OD,1,0,0,ACTIVIA,0,Ferrières(FR),0077,0024 FR LILPARK (DC),325,1661,1656,1603,53,58,5,0,1336,-411.0769230769231,325,195,192,139,53,56,3,0,-130,40.0,98.46153846153847,71.28205128205128,27.179487179487182,99.69897652016857,96.50812763395545,3.190848886213118,Qualité
239,0,2019-01-16,131597,VELOUTE FRUIX 125X16 PX CHOC,1,0,0,VELOUTE,0,Villecomtal(FR),0084,0024 FR AIX (DC),2273,2950,2950,2636,314,314,0,0,677,-29.78442586889573,152,192,192,192,0,0,0,0,40,-26.31578947368421,100.0,100.0,0.0,100.0,89.35593220338983,10.644067796610173,Previsions
240,0,2019-01-16,131597,VELOUTE FRUIX 125X16 PX CHOC,1,0,0,VELOUTE,0,Villecomtal(FR),0080,0024 FR METZ (DC),2273,2950,2950,2636,314,314,0,0,677,-29.78442586889573,422,502,502,188,314,314,0,0,80,-18.95734597156398,100.0,37.45019920318725,62.54980079681275,100.0,89.35593220338983,10.644067796610173,Previsions
241,0,2019-01-16,131597,VELOUTE FRUIX 125X16 PX CHOC,1,0,0,VELOUTE,0,Villecomtal(FR),0081,0024 FR TOURS (DC),2273,2950,2950,2636,314,314,0,0,677,-29.78442586889573,145,217,217,217,0,0,0,0,72,-49.6551724137931,100.0,100.0,0.0,100.0,89.35593220338983,10.644067796610173,Previsions
242,0,2019-01-16,131597,VELOUTE FRUIX 125X16 PX CHOC,1,0,0,VELOUTE,0,Villecomtal(FR),0077,0024 FR LILPARK (DC),2273,2950,2950,2636,314,314,0,0,677,-29.78442586889573,230,307,307,307,0,0,0,0,77,-33.47826086956522,100.0,100.0,0.0,100.0,89.35593220338983,10.644067796610173,Previsions
243,0,2019-01-16,131597,VELOUTE FRUIX 125X16 PX CHOC,1,0,0,VELOUTE,0,Villecomtal(FR),0085,0024 FR TOULOUSE (DC),2273,2950,2950,2636,314,314,0,0,677,-29.78442586889573,118,156,156,156,0,0,0,0,38,-32.20338983050848,100.0,100.0,0.0,100.0,89.35593220338983,10.644067796610173,Previsions
244,0,2019-01-16,131597,VELOUTE FRUIX 125X16 PX CHOC,1,0,0,VELOUTE,0,Villecomtal(FR),0083,0024 FR CHAPONNAY (DC),2273,2950,2950,2636,314,314,0,0,677,-29.78442586889573,409,504,504,504,0,0,0,0,95,-23.227383863080686,100.0,100.0,0.0,100.0,89.35593220338983,10.644067796610173,Previsions
245,0,2019-01-16,131597,VELOUTE FRUIX 125X16 PX CHOC,1,0,0,VELOUTE,0,Villecomtal(FR),0079,0024 FR PARIS SUD (DC),2273,2950,2950,2636,314,314,0,0,677,-29.78442586889573,526,693,693,693,0,0,0,0,167,-31.749049429657795,100.0,100.0,0.0,100.0,89.35593220338983,10.644067796610173,Previsions
246,0,2019-01-16,131597,VELOUTE FRUIX 125X16 PX CHOC,1,0,0,VELOUTE,0,Villecomtal(FR),0078,0024 FR PARIS NORD (DC),2273,2950,2950,2636,314,314,0,0,677,-29.78442586889573,271,379,379,379,0,0,0,0,108,-39.85239852398524,100.0,100.0,0.0,100.0,89.35593220338983,10.644067796610173,Previsions
247,0,2019-01-16,134010,VELOUTE FRUIX PANACHE 125X16 OD,1,0,0,VELOUTE,0,Villecomtal(FR),0084,0024 FR AIX (DC),10224,12179,12177,12168,9,11,2,0,1955,-19.121674491392803,1001,1251,1249,1241,8,10,2,0,250,-24.975024975024976,99.84012789768185,99.20063948840927,0.6394884092725874,99.98357829050005,99.90968059775022,0.07389769274982427,Client
248,0,2019-01-16,134010,VELOUTE FRUIX PANACHE 125X16 OD,1,0,0,VELOUTE,0,Villecomtal(FR),0080,0024 FR METZ (DC),10224,12179,12177,12168,9,11,2,0,1955,-19.121674491392803,2686,2581,2581,2580,1,1,0,0,-105,3.9091586001489205,100.0,99.96125532739248,0.038744672607521125,99.98357829050005,99.90968059775022,0.07389769274982427,Client
249,0,2019-01-16,134010,VELOUTE FRUIX PANACHE 125X16 OD,1,0,0,VELOUTE,0,Villecomtal(FR),0081,0024 FR TOURS (DC),10224,12179,12177,12168,9,11,2,0,1955,-19.121674491392803,1208,1449,1449,1449,0,0,0,0,241,-19.950331125827816,100.0,100.0,0.0,99.98357829050005,99.90968059775022,0.07389769274982427,Client
250,0,2019-01-16,134010,VELOUTE FRUIX PANACHE 125X16 OD,1,0,0,VELOUTE,0,Villecomtal(FR),0082,0024 FR VALLET (DC),10224,12179,12177,12168,9,11,2,0,1955,-19.121674491392803,2045,2284,2284,2284,0,0,0,0,239,-11.687041564792176,100.0,100.0,0.0,99.98357829050005,99.90968059775022,0.07389769274982427,Client
251,0,2019-01-16,134010,VELOUTE FRUIX PANACHE 125X16 OD,1,0,0,VELOUTE,0,Villecomtal(FR),0077,0024 FR LILPARK (DC),10224,12179,12177,12168,9,11,2,0,1955,-19.121674491392803,1807,2041,2041,2041,0,0,0,0,234,-12.949640287769784,100.0,100.0,0.0,99.98357829050005,99.90968059775022,0.07389769274982427,Client
252,0,2019-01-16,134010,VELOUTE FRUIX PANACHE 125X16 OD,1,0,0,VELOUTE,0,Villecomtal(FR),0085,0024 FR TOULOUSE (DC),10224,12179,12177,12168,9,11,2,0,1955,-19.121674491392803,1368,1610,1610,1610,0,0,0,0,242,-17.690058479532162,100.0,100.0,0.0,99.98357829050005,99.90968059775022,0.07389769274982427,Client
253,0,2019-01-16,134010,VELOUTE FRUIX PANACHE 125X16 OD,1,0,0,VELOUTE,0,Villecomtal(FR),0083,0024 FR CHAPONNAY (DC),10224,12179,12177,12168,9,11,2,0,1955,-19.121674491392803,109,963,963,963,0,0,0,0,854,-783.4862385321101,100.0,100.0,0.0,99.98357829050005,99.90968059775022,0.07389769274982427,Client
254,1,2019-01-16,139219,ALPRO SOJA CHERRY 500X1,0,0,0,ALPRO,1,Wevelgem(BE),0083,0024 FR CHAPONNAY (DC),36,170,77,57,20,113,93,0,134,-372.22222222222223,34,43,3,1,2,42,40,0,9,-26.470588235294116,6.976744186046512,2.3255813953488373,4.651162790697674,45.294117647058826,33.52941176470588,11.76470588235295,A Creuser
255,1,2019-01-16,139219,ALPRO SOJA CHERRY 500X1,0,0,0,ALPRO,1,Wevelgem(BE),0078,0024 FR PARIS NORD (DC),36,170,77,57,20,113,93,0,134,-372.22222222222223,2,22,3,0,3,22,19,0,20,-1000.0,13.636363636363635,0.0,13.636363636363635,45.294117647058826,33.52941176470588,11.76470588235295,A Creuser
256,0,2019-01-17,105287,DANET MOUS CHOC LIEG 80gx4 Lidl,0,0,0,DANETTE,1,Ochsenfurt(ALL),0084,0024 FR AIX (DC),995,2416,1932,1864,68,552,484,0,1421,-142.8140703517588,163,240,232,232,0,8,8,0,77,-47.239263803680984,96.66666666666667,96.66666666666667,0.0,79.96688741721854,77.15231788079471,2.814569536423832,Previsions
257,0,2019-01-17,105287,DANET MOUS CHOC LIEG 80gx4 Lidl,0,0,0,DANETTE,1,Ochsenfurt(ALL),0080,0024 FR METZ (DC),995,2416,1932,1864,68,552,484,0,1421,-142.8140703517588,15,240,42,42,0,198,198,0,225,-1500.0,17.5,17.5,0.0,79.96688741721854,77.15231788079471,2.814569536423832,Previsions
258,0,2019-01-17,105287,DANET MOUS CHOC LIEG 80gx4 Lidl,0,0,0,DANETTE,1,Ochsenfurt(ALL),0081,0024 FR TOURS (DC),995,2416,1932,1864,68,552,484,0,1421,-142.8140703517588,106,240,136,68,68,172,104,0,134,-126.41509433962264,56.666666666666664,28.333333333333332,28.333333333333332,79.96688741721854,77.15231788079471,2.814569536423832,Previsions
259,0,2019-01-17,105287,DANET MOUS CHOC LIEG 80gx4 Lidl,0,0,0,DANETTE,1,Ochsenfurt(ALL),0082,0024 FR VALLET (DC),995,2416,1932,1864,68,552,484,0,1421,-142.8140703517588,34,240,168,168,0,72,72,0,206,-605.8823529411765,70.0,70.0,0.0,79.96688741721854,77.15231788079471,2.814569536423832,Previsions
260,0,2019-01-17,105287,DANET MOUS CHOC LIEG 80gx4 Lidl,0,0,0,DANETTE,1,Ochsenfurt(ALL),0077,0024 FR LILPARK (DC),995,2416,1932,1864,68,552,484,0,1421,-142.8140703517588,205,240,146,146,0,94,94,0,35,-17.073170731707318,60.83333333333333,60.83333333333333,0.0,79.96688741721854,77.15231788079471,2.814569536423832,Previsions
261,0,2019-01-17,105287,DANET MOUS CHOC LIEG 80gx4 Lidl,0,0,0,DANETTE,1,Ochsenfurt(ALL),0085,0024 FR TOULOUSE (DC),995,2416,1932,1864,68,552,484,0,1421,-142.8140703517588,174,360,360,360,0,0,0,0,186,-106.89655172413794,100.0,100.0,0.0,79.96688741721854,77.15231788079471,2.814569536423832,Previsions
262,0,2019-01-17,105287,DANET MOUS CHOC LIEG 80gx4 Lidl,0,0,0,DANETTE,1,Ochsenfurt(ALL),0083,0024 FR CHAPONNAY (DC),995,2416,1932,1864,68,552,484,0,1421,-142.8140703517588,19,360,352,352,0,8,8,0,341,-1794.7368421052631,97.77777777777777,97.77777777777777,0.0,79.96688741721854,77.15231788079471,2.814569536423832,Previsions
263,0,2019-01-17,105287,DANET MOUS CHOC LIEG 80gx4 Lidl,0,0,0,DANETTE,1,Ochsenfurt(ALL),0079,0024 FR PARIS SUD (DC),995,2416,1932,1864,68,552,484,0,1421,-142.8140703517588,96,136,136,136,0,0,0,0,40,-41.666666666666664,100.0,100.0,0.0,79.96688741721854,77.15231788079471,2.814569536423832,Previsions
264,0,2019-01-17,105287,DANET MOUS CHOC LIEG 80gx4 Lidl,0,0,0,DANETTE,1,Ochsenfurt(ALL),0078,0024 FR PARIS NORD (DC),995,2416,1932,1864,68,552,484,0,1421,-142.8140703517588,183,360,360,360,0,0,0,0,177,-96.72131147540983,100.0,100.0,0.0,79.96688741721854,77.15231788079471,2.814569536423832,Previsions
265,1,2019-01-17,131597,VELOUTE FRUIX 125X16 PX CHOC,1,0,0,VELOUTE,0,Villecomtal(FR),0080,0024 FR METZ (DC),1002,4271,4271,4082,189,189,0,0,3269,-326.24750499001993,267,318,318,234,84,84,0,0,51,-19.10112359550562,100.0,73.58490566037736,26.41509433962264,100.0,95.57480683680637,4.425193163193626,Probleme Copacking
266,1,2019-01-17,131597,VELOUTE FRUIX 125X16 PX CHOC,1,0,0,VELOUTE,0,Villecomtal(FR),0079,0024 FR PARIS SUD (DC),1002,4271,4271,4082,189,189,0,0,3269,-326.24750499001993,735,968,968,864,104,104,0,0,233,-31.700680272108844,100.0,89.25619834710744,10.743801652892557,100.0,95.57480683680637,4.425193163193626,Probleme Copacking
267,0,2019-01-17,133234,VELOUTE FRUIX PANACHE 125X12 D,1,0,0,VELOUTE,0,Villecomtal(FR),0084,0024 FR AIX (DC),2389,3552,3538,2960,578,592,14,0,1163,-48.681456676433655,277,432,432,432,0,0,0,0,155,-55.95667870036101,100.0,100.0,0.0,99.60585585585585,83.33333333333334,16.272522522522507,Production
268,0,2019-01-17,133234,VELOUTE FRUIX PANACHE 125X12 D,1,0,0,VELOUTE,0,Villecomtal(FR),0080,0024 FR METZ (DC),2389,3552,3538,2960,578,592,14,0,1163,-48.681456676433655,214,384,384,384,0,0,0,0,170,-79.4392523364486,100.0,100.0,0.0,99.60585585585585,83.33333333333334,16.272522522522507,Production
269,0,2019-01-17,133234,VELOUTE FRUIX PANACHE 125X12 D,1,0,0,VELOUTE,0,Villecomtal(FR),0081,0024 FR TOURS (DC),2389,3552,3538,2960,578,592,14,0,1163,-48.681456676433655,117,432,432,432,0,0,0,0,315,-269.2307692307692,100.0,100.0,0.0,99.60585585585585,83.33333333333334,16.272522522522507,Production
270,0,2019-01-17,133234,VELOUTE FRUIX PANACHE 125X12 D,1,0,0,VELOUTE,0,Villecomtal(FR),0082,0024 FR VALLET (DC),2389,3552,3538,2960,578,592,14,0,1163,-48.681456676433655,83,288,288,288,0,0,0,0,205,-246.9879518072289,100.0,100.0,0.0,99.60585585585585,83.33333333333334,16.272522522522507,Production
271,0,2019-01-17,133234,VELOUTE FRUIX PANACHE 125X12 D,1,0,0,VELOUTE,0,Villecomtal(FR),0077,0024 FR LILPARK (DC),2389,3552,3538,2960,578,592,14,0,1163,-48.681456676433655,194,288,274,274,0,14,14,0,94,-48.45360824742268,95.13888888888889,95.13888888888889,0.0,99.60585585585585,83.33333333333334,16.272522522522507,Production
272,0,2019-01-17,133234,VELOUTE FRUIX PANACHE 125X12 D,1,0,0,VELOUTE,0,Villecomtal(FR),0085,0024 FR TOULOUSE (DC),2389,3552,3538,2960,578,592,14,0,1163,-48.681456676433655,318,432,432,430,2,2,0,0,114,-35.84905660377358,100.0,99.53703703703704,0.4629629629629619,99.60585585585585,83.33333333333334,16.272522522522507,Production
273,0,2019-01-17,133234,VELOUTE FRUIX PANACHE 125X12 D,1,0,0,VELOUTE,0,Villecomtal(FR),0083,0024 FR CHAPONNAY (DC),2389,3552,3538,2960,578,592,14,0,1163,-48.681456676433655,417,576,576,0,576,576,0,0,159,-38.1294964028777,100.0,0.0,100.0,99.60585585585585,83.33333333333334,16.272522522522507,Production
274,0,2019-01-17,133234,VELOUTE FRUIX PANACHE 125X12 D,1,0,0,VELOUTE,0,Villecomtal(FR),0079,0024 FR PARIS SUD (DC),2389,3552,3538,2960,578,592,14,0,1163,-48.681456676433655,177,144,144,144,0,0,0,0,-33,18.64406779661017,100.0,100.0,0.0,99.60585585585585,83.33333333333334,16.272522522522507,Production
275,0,2019-01-17,133234,VELOUTE FRUIX PANACHE 125X12 D,1,0,0,VELOUTE,0,Villecomtal(FR),0078,0024 FR PARIS NORD (DC),2389,3552,3538,2960,578,592,14,0,1163,-48.681456676433655,592,576,576,576,0,0,0,0,-16,2.7027027027027026,100.0,100.0,0.0,99.60585585585585,83.33333333333334,16.272522522522507,Production
276,0,2019-01-18,69189,GERVITA NATURE 100G X 8,0,0,0,GERVITA,0,Ferrières(FR),0084,0024 FR AIX (DC),3582,4556,4021,3608,413,948,535,0,974,-27.191513121161364,68,857,766,450,316,407,91,0,789,-1160.2941176470588,89.38156359393233,52.50875145857643,36.8728121353559,88.25724319578578,79.19227392449517,9.064969271290607,Qualité
277,0,2019-01-18,69189,GERVITA NATURE 100G X 8,0,0,0,GERVITA,0,Ferrières(FR),0080,0024 FR METZ (DC),3582,4556,4021,3608,413,948,535,0,974,-27.191513121161364,168,187,187,187,0,0,0,0,19,-11.30952380952381,100.0,100.0,0.0,88.25724319578578,79.19227392449517,9.064969271290607,Qualité
278,0,2019-01-18,69189,GERVITA NATURE 100G X 8,0,0,0,GERVITA,0,Ferrières(FR),0081,0024 FR TOURS (DC),3582,4556,4021,3608,413,948,535,0,974,-27.191513121161364,390,437,399,399,0,38,38,0,47,-12.051282051282051,91.30434782608695,91.30434782608695,0.0,88.25724319578578,79.19227392449517,9.064969271290607,Qualité
279,0,2019-01-18,69189,GERVITA NATURE 100G X 8,0,0,0,GERVITA,0,Ferrières(FR),0082,0024 FR VALLET (DC),3582,4556,4021,3608,413,948,535,0,974,-27.191513121161364,226,237,142,142,0,95,95,0,11,-4.867256637168142,59.91561181434599,59.91561181434599,0.0,88.25724319578578,79.19227392449517,9.064969271290607,Qualité
280,0,2019-01-18,69189,GERVITA NATURE 100G X 8,0,0,0,GERVITA,0,Ferrières(FR),0077,0024 FR LILPARK (DC),3582,4556,4021,3608,413,948,535,0,974,-27.191513121161364,227,186,186,128,58,58,0,0,-41,18.061674008810574,100.0,68.81720430107528,31.18279569892472,88.25724319578578,79.19227392449517,9.064969271290607,Qualité
281,0,2019-01-18,69189,GERVITA NATURE 100G X 8,0,0,0,GERVITA,0,Ferrières(FR),0085,0024 FR TOULOUSE (DC),3582,4556,4021,3608,413,948,535,0,974,-27.191513121161364,846,919,804,804,0,115,115,0,73,-8.628841607565011,87.48639825897715,87.48639825897715,0.0,88.25724319578578,79.19227392449517,9.064969271290607,Qualité
282,0,2019-01-18,69189,GERVITA NATURE 100G X 8,0,0,0,GERVITA,0,Ferrières(FR),0083,0024 FR CHAPONNAY (DC),3582,4556,4021,3608,413,948,535,0,974,-27.191513121161364,614,773,620,620,0,153,153,0,159,-25.895765472312704,80.20698576972833,80.20698576972833,0.0,88.25724319578578,79.19227392449517,9.064969271290607,Qualité
283,0,2019-01-18,69189,GERVITA NATURE 100G X 8,0,0,0,GERVITA,0,Ferrières(FR),0079,0024 FR PARIS SUD (DC),3582,4556,4021,3608,413,948,535,0,974,-27.191513121161364,571,555,512,512,0,43,43,0,-16,2.8021015761821366,92.25225225225225,92.25225225225225,0.0,88.25724319578578,79.19227392449517,9.064969271290607,Qualité
284,0,2019-01-18,69189,GERVITA NATURE 100G X 8,0,0,0,GERVITA,0,Ferrières(FR),0078,0024 FR PARIS NORD (DC),3582,4556,4021,3608,413,948,535,0,974,-27.191513121161364,472,405,405,366,39,39,0,0,-67,14.194915254237289,100.0,90.37037037037037,9.629629629629633,88.25724319578578,79.19227392449517,9.064969271290607,Qualité
285,0,2019-01-18,105287,DANET MOUS CHOC LIEG 80gx4 Lidl,0,0,0,DANETTE,1,Ochsenfurt(ALL),0080,0024 FR METZ (DC),520,736,556,556,0,180,180,0,216,-41.53846153846154,138,120,120,120,0,0,0,0,-18,13.043478260869565,100.0,100.0,0.0,75.54347826086956,75.54347826086956,0.0,Previsions
286,0,2019-01-18,105287,DANET MOUS CHOC LIEG 80gx4 Lidl,0,0,0,DANETTE,1,Ochsenfurt(ALL),0081,0024 FR TOURS (DC),520,736,556,556,0,180,180,0,216,-41.53846153846154,33,120,68,68,0,52,52,0,87,-263.6363636363636,56.666666666666664,56.666666666666664,0.0,75.54347826086956,75.54347826086956,0.0,Previsions
287,0,2019-01-18,105287,DANET MOUS CHOC LIEG 80gx4 Lidl,0,0,0,DANETTE,1,Ochsenfurt(ALL),0085,0024 FR TOULOUSE (DC),520,736,556,556,0,180,180,0,216,-41.53846153846154,64,240,112,112,0,128,128,0,176,-275.0,46.666666666666664,46.666666666666664,0.0,75.54347826086956,75.54347826086956,0.0,Previsions
288,0,2019-01-18,105287,DANET MOUS CHOC LIEG 80gx4 Lidl,0,0,0,DANETTE,1,Ochsenfurt(ALL),0079,0024 FR PARIS SUD (DC),520,736,556,556,0,180,180,0,216,-41.53846153846154,80,136,136,136,0,0,0,0,56,-70.0,100.0,100.0,0.0,75.54347826086956,75.54347826086956,0.0,Previsions
289,0,2019-01-18,105287,DANET MOUS CHOC LIEG 80gx4 Lidl,0,0,0,DANETTE,1,Ochsenfurt(ALL),0078,0024 FR PARIS NORD (DC),520,736,556,556,0,180,180,0,216,-41.53846153846154,205,120,120,120,0,0,0,0,-85,41.46341463414634,100.0,100.0,0.0,75.54347826086956,75.54347826086956,0.0,Previsions
290,0,2019-01-19,2118,GERVITA NATUR 100gx4,0,0,0,GERVITA,0,Ferrières(FR),0084,0024 FR AIX (DC),5884,5827,5072,5067,5,760,755,0,-57,0.9687287559483345,855,858,664,664,0,194,194,0,3,-0.3508771929824561,77.3892773892774,77.3892773892774,0.0,87.04307533893942,86.95726789085293,0.08580744808648433,Production
291,0,2019-01-19,2118,GERVITA NATUR 100gx4,0,0,0,GERVITA,0,Ferrières(FR),0080,0024 FR METZ (DC),5884,5827,5072,5067,5,760,755,0,-57,0.9687287559483345,3,286,286,286,0,0,0,0,283,-9433.333333333334,100.0,100.0,0.0,87.04307533893942,86.95726789085293,0.08580744808648433,Production
292,0,2019-01-19,2118,GERVITA NATUR 100gx4,0,0,0,GERVITA,0,Ferrières(FR),0081,0024 FR TOURS (DC),5884,5827,5072,5067,5,760,755,0,-57,0.9687287559483345,792,666,666,666,0,0,0,0,-126,15.909090909090908,100.0,100.0,0.0,87.04307533893942,86.95726789085293,0.08580744808648433,Production
293,0,2019-01-19,2118,GERVITA NATUR 100gx4,0,0,0,GERVITA,0,Ferrières(FR),0082,0024 FR VALLET (DC),5884,5827,5072,5067,5,760,755,0,-57,0.9687287559483345,491,329,329,329,0,0,0,0,-162,32.9938900203666,100.0,100.0,0.0,87.04307533893942,86.95726789085293,0.08580744808648433,Production
294,0,2019-01-19,2118,GERVITA NATUR 100gx4,0,0,0,GERVITA,0,Ferrières(FR),0077,0024 FR LILPARK (DC),5884,5827,5072,5067,5,760,755,0,-57,0.9687287559483345,43,439,363,358,5,81,76,0,396,-920.9302325581396,82.6879271070615,81.54897494305239,1.1389521640091118,87.04307533893942,86.95726789085293,0.08580744808648433,Production
295,0,2019-01-19,2118,GERVITA NATUR 100gx4,0,0,0,GERVITA,0,Ferrières(FR),0085,0024 FR TOULOUSE (DC),5884,5827,5072,5067,5,760,755,0,-57,0.9687287559483345,1174,935,935,935,0,0,0,0,-239,20.357751277683136,100.0,100.0,0.0,87.04307533893942,86.95726789085293,0.08580744808648433,Production
296,0,2019-01-19,2118,GERVITA NATUR 100gx4,0,0,0,GERVITA,0,Ferrières(FR),0083,0024 FR CHAPONNAY (DC),5884,5827,5072,5067,5,760,755,0,-57,0.9687287559483345,749,522,522,522,0,0,0,0,-227,30.307076101468624,100.0,100.0,0.0,87.04307533893942,86.95726789085293,0.08580744808648433,Production
297,0,2019-01-19,2118,GERVITA NATUR 100gx4,0,0,0,GERVITA,0,Ferrières(FR),0079,0024 FR PARIS SUD (DC),5884,5827,5072,5067,5,760,755,0,-57,0.9687287559483345,1086,1003,740,740,0,263,263,0,-83,7.642725598526703,73.77866400797608,73.77866400797608,0.0,87.04307533893942,86.95726789085293,0.08580744808648433,Production
298,0,2019-01-19,2118,GERVITA NATUR 100gx4,0,0,0,GERVITA,0,Ferrières(FR),0078,0024 FR PARIS NORD (DC),5884,5827,5072,5067,5,760,755,0,-57,0.9687287559483345,691,789,567,567,0,222,222,0,98,-14.182344428364688,71.86311787072243,71.86311787072243,0.0,87.04307533893942,86.95726789085293,0.08580744808648433,Production
299,0,2019-01-19,2631,GERVITA STRAW 100gx4,0,0,0,GERVITA,0,Ferrières(FR),0084,0024 FR AIX (DC),1574,1595,1595,1595,0,0,0,0,21,-1.3341804320203303,273,224,224,224,0,0,0,0,-49,17.94871794871795,100.0,100.0,0.0,100.0,100.0,0.0,Qualité
300,0,2019-01-19,2631,GERVITA STRAW 100gx4,0,0,0,GERVITA,0,Ferrières(FR),0080,0024 FR METZ (DC),1574,1595,1595,1595,0,0,0,0,21,-1.3341804320203303,98,110,110,110,0,0,0,0,12,-12.244897959183673,100.0,100.0,0.0,100.0,100.0,0.0,Qualité
301,0,2019-01-19,2631,GERVITA STRAW 100gx4,0,0,0,GERVITA,0,Ferrières(FR),0081,0024 FR TOURS (DC),1574,1595,1595,1595,0,0,0,0,21,-1.3341804320203303,195,230,230,230,0,0,0,0,35,-17.94871794871795,100.0,100.0,0.0,100.0,100.0,0.0,Qualité
302,0,2019-01-19,2631,GERVITA STRAW 100gx4,0,0,0,GERVITA,0,Ferrières(FR),0082,0024 FR VALLET (DC),1574,1595,1595,1595,0,0,0,0,21,-1.3341804320203303,198,207,207,207,0,0,0,0,9,-4.545454545454546,100.0,100.0,0.0,100.0,100.0,0.0,Qualité
303,0,2019-01-19,2631,GERVITA STRAW 100gx4,0,0,0,GERVITA,0,Ferrières(FR),0085,0024 FR TOULOUSE (DC),1574,1595,1595,1595,0,0,0,0,21,-1.3341804320203303,230,280,280,280,0,0,0,0,50,-21.73913043478261,100.0,100.0,0.0,100.0,100.0,0.0,Qualité
304,0,2019-01-19,2631,GERVITA STRAW 100gx4,0,0,0,GERVITA,0,Ferrières(FR),0083,0024 FR CHAPONNAY (DC),1574,1595,1595,1595,0,0,0,0,21,-1.3341804320203303,143,131,131,131,0,0,0,0,-12,8.391608391608392,100.0,100.0,0.0,100.0,100.0,0.0,Qualité
305,0,2019-01-19,2631,GERVITA STRAW 100gx4,0,0,0,GERVITA,0,Ferrières(FR),0079,0024 FR PARIS SUD (DC),1574,1595,1595,1595,0,0,0,0,21,-1.3341804320203303,205,254,254,254,0,0,0,0,49,-23.902439024390244,100.0,100.0,0.0,100.0,100.0,0.0,Qualité
306,0,2019-01-19,2631,GERVITA STRAW 100gx4,0,0,0,GERVITA,0,Ferrières(FR),0078,0024 FR PARIS NORD (DC),1574,1595,1595,1595,0,0,0,0,21,-1.3341804320203303,232,159,159,159,0,0,0,0,-73,31.46551724137931,100.0,100.0,0.0,100.0,100.0,0.0,Qualité
307,1,2019-01-19,83925,ACTIMEL 0% NATU 3x(14x100g) FR,0,0,0,ACTIMEL,1,Rotselaar(BE),0085,0024 FR TOULOUSE (DC),191,1765,1726,1723,3,42,39,0,1574,-824.0837696335078,191,127,92,89,3,38,35,0,-64,33.50785340314136,72.44094488188976,70.07874015748031,2.3622047244094517,97.79036827195468,97.62039660056658,0.16997167138809743,Client
308,0,2019-01-19,102497,ACTIVIA CHEESE STRAWBERRY 120X4,0,0,0,ACTIVIA,0,Ferrières(FR),0084,0024 FR AIX (DC),961,994,901,694,207,300,93,0,33,-3.433922996878252,103,87,80,62,18,25,7,0,-16,15.533980582524272,91.95402298850574,71.26436781609196,20.68965517241378,90.64386317907444,69.81891348088531,20.82494969818913,Schéma
309,0,2019-01-19,102497,ACTIVIA CHEESE STRAWBERRY 120X4,0,0,0,ACTIVIA,0,Ferrières(FR),0080,0024 FR METZ (DC),961,994,901,694,207,300,93,0,33,-3.433922996878252,38,31,31,28,3,3,0,0,-7,18.42105263157895,100.0,90.32258064516128,9.677419354838719,90.64386317907444,69.81891348088531,20.82494969818913,Schéma
310,0,2019-01-19,102497,ACTIVIA CHEESE STRAWBERRY 120X4,0,0,0,ACTIVIA,0,Ferrières(FR),0081,0024 FR TOURS (DC),961,994,901,694,207,300,93,0,33,-3.433922996878252,14,94,94,83,11,11,0,0,80,-571.4285714285714,100.0,88.29787234042553,11.702127659574472,90.64386317907444,69.81891348088531,20.82494969818913,Schéma
311,0,2019-01-19,102497,ACTIVIA CHEESE STRAWBERRY 120X4,0,0,0,ACTIVIA,0,Ferrières(FR),0082,0024 FR VALLET (DC),961,994,901,694,207,300,93,0,33,-3.433922996878252,103,82,82,56,26,26,0,0,-21,20.388349514563107,100.0,68.29268292682927,31.707317073170728,90.64386317907444,69.81891348088531,20.82494969818913,Schéma
312,0,2019-01-19,102497,ACTIVIA CHEESE STRAWBERRY 120X4,0,0,0,ACTIVIA,0,Ferrières(FR),0077,0024 FR LILPARK (DC),961,994,901,694,207,300,93,0,33,-3.433922996878252,111,117,31,0,31,117,86,0,6,-5.405405405405405,26.495726495726498,0.0,26.495726495726498,90.64386317907444,69.81891348088531,20.82494969818913,Schéma
313,0,2019-01-19,102497,ACTIVIA CHEESE STRAWBERRY 120X4,0,0,0,ACTIVIA,0,Ferrières(FR),0085,0024 FR TOULOUSE (DC),961,994,901,694,207,300,93,0,33,-3.433922996878252,144,149,149,133,16,16,0,0,5,-3.4722222222222223,100.0,89.26174496644296,10.738255033557039,90.64386317907444,69.81891348088531,20.82494969818913,Schéma
314,0,2019-01-19,102497,ACTIVIA CHEESE STRAWBERRY 120X4,0,0,0,ACTIVIA,0,Ferrières(FR),0083,0024 FR CHAPONNAY (DC),961,994,901,694,207,300,93,0,33,-3.433922996878252,133,122,122,85,37,37,0,0,-11,8.270676691729323,100.0,69.67213114754098,30.32786885245902,90.64386317907444,69.81891348088531,20.82494969818913,Schéma
315,0,2019-01-19,102497,ACTIVIA CHEESE STRAWBERRY 120X4,0,0,0,ACTIVIA,0,Ferrières(FR),0079,0024 FR PARIS SUD (DC),961,994,901,694,207,300,93,0,33,-3.433922996878252,188,183,183,118,65,65,0,0,-5,2.6595744680851063,100.0,64.48087431693989,35.51912568306011,90.64386317907444,69.81891348088531,20.82494969818913,Schéma
316,0,2019-01-19,102497,ACTIVIA CHEESE STRAWBERRY 120X4,0,0,0,ACTIVIA,0,Ferrières(FR),0078,0024 FR PARIS NORD (DC),961,994,901,694,207,300,93,0,33,-3.433922996878252,127,129,129,129,0,0,0,0,2,-1.5748031496062993,100.0,100.0,0.0,90.64386317907444,69.81891348088531,20.82494969818913,Schéma
317,1,2019-01-19,131291,ACTIMEL 0% NATU 3x(8x100g) FR,1,0,0,ACTIMEL,1,Rotselaar(BE),0078,0024 FR PARIS NORD (DC),390,1363,1363,1344,19,19,0,0,973,-249.48717948717947,390,482,482,464,18,18,0,0,92,-23.58974358974359,100.0,96.2655601659751,3.734439834024897,100.0,98.60601614086573,1.3939838591342664,Previsions
318,1,2019-01-19,140870,ACTIVIA BIO NATURE 125X8,0,0,0,ACTIVIA,0,Bailleul(FR),0078,0024 FR PARIS NORD (DC),47,402,402,354,48,48,0,0,355,-755.3191489361702,47,60,60,12,48,48,0,0,13,-27.659574468085108,100.0,20.0,80.0,100.0,88.05970149253731,11.940298507462686,Previsions
319,0,2019-01-21,107076,LES 2 VACHES VANILLA 115X4,0,0,0,LES 2 VACHES,0,LeMolay(FR),0084,0024 FR AIX (DC),4960,4792,4618,4618,0,174,174,0,-168,3.3870967741935485,436,328,328,328,0,0,0,0,-108,24.770642201834864,100.0,100.0,0.0,96.36894824707846,96.36894824707846,0.0,Previsions
320,0,2019-01-21,107076,LES 2 VACHES VANILLA 115X4,0,0,0,LES 2 VACHES,0,LeMolay(FR),0080,0024 FR METZ (DC),4960,4792,4618,4618,0,174,174,0,-168,3.3870967741935485,322,402,402,402,0,0,0,0,80,-24.84472049689441,100.0,100.0,0.0,96.36894824707846,96.36894824707846,0.0,Previsions
321,0,2019-01-21,107076,LES 2 VACHES VANILLA 115X4,0,0,0,LES 2 VACHES,0,LeMolay(FR),0081,0024 FR TOURS (DC),4960,4792,4618,4618,0,174,174,0,-168,3.3870967741935485,423,417,417,417,0,0,0,0,-6,1.4184397163120568,100.0,100.0,0.0,96.36894824707846,96.36894824707846,0.0,Previsions
322,0,2019-01-21,107076,LES 2 VACHES VANILLA 115X4,0,0,0,LES 2 VACHES,0,LeMolay(FR),0082,0024 FR VALLET (DC),4960,4792,4618,4618,0,174,174,0,-168,3.3870967741935485,367,372,372,372,0,0,0,0,5,-1.3623978201634876,100.0,100.0,0.0,96.36894824707846,96.36894824707846,0.0,Previsions
323,0,2019-01-21,107076,LES 2 VACHES VANILLA 115X4,0,0,0,LES 2 VACHES,0,LeMolay(FR),0077,0024 FR LILPARK (DC),4960,4792,4618,4618,0,174,174,0,-168,3.3870967741935485,202,402,402,402,0,0,0,0,200,-99.00990099009901,100.0,100.0,0.0,96.36894824707846,96.36894824707846,0.0,Previsions
324,0,2019-01-21,107076,LES 2 VACHES VANILLA 115X4,0,0,0,LES 2 VACHES,0,LeMolay(FR),0085,0024 FR TOULOUSE (DC),4960,4792,4618,4618,0,174,174,0,-168,3.3870967741935485,782,841,841,841,0,0,0,0,59,-7.544757033248082,100.0,100.0,0.0,96.36894824707846,96.36894824707846,0.0,Previsions
325,0,2019-01-21,107076,LES 2 VACHES VANILLA 115X4,0,0,0,LES 2 VACHES,0,LeMolay(FR),0083,0024 FR CHAPONNAY (DC),4960,4792,4618,4618,0,174,174,0,-168,3.3870967741935485,742,658,658,658,0,0,0,0,-84,11.320754716981131,100.0,100.0,0.0,96.36894824707846,96.36894824707846,0.0,Previsions
326,0,2019-01-21,107076,LES 2 VACHES VANILLA 115X4,0,0,0,LES 2 VACHES,0,LeMolay(FR),0079,0024 FR PARIS SUD (DC),4960,4792,4618,4618,0,174,174,0,-168,3.3870967741935485,831,514,514,514,0,0,0,0,-317,38.146811070998794,100.0,100.0,0.0,96.36894824707846,96.36894824707846,0.0,Previsions
327,0,2019-01-21,107076,LES 2 VACHES VANILLA 115X4,0,0,0,LES 2 VACHES,0,LeMolay(FR),0078,0024 FR PARIS NORD (DC),4960,4792,4618,4618,0,174,174,0,-168,3.3870967741935485,855,858,684,684,0,174,174,0,3,-0.3508771929824561,79.72027972027972,79.72027972027972,0.0,96.36894824707846,96.36894824707846,0.0,Previsions
328,0,2019-01-21,120841,VELOUTE FRUIX PANACHES 125X8 AFH,0,0,1,VELOUTE,0,Villecomtal(FR),0084,0024 FR AIX (DC),3723,2299,2040,2040,0,259,259,0,-1424,38.24872414719312,1,117,117,117,0,0,0,0,116,-11600.0,100.0,100.0,0.0,88.73423227490214,88.73423227490214,0.0,Previsions
329,0,2019-01-21,120841,VELOUTE FRUIX PANACHES 125X8 AFH,0,0,1,VELOUTE,0,Villecomtal(FR),0080,0024 FR METZ (DC),3723,2299,2040,2040,0,259,259,0,-1424,38.24872414719312,136,177,177,177,0,0,0,0,41,-30.147058823529413,100.0,100.0,0.0,88.73423227490214,88.73423227490214,0.0,Previsions
330,0,2019-01-21,120841,VELOUTE FRUIX PANACHES 125X8 AFH,0,0,1,VELOUTE,0,Villecomtal(FR),0081,0024 FR TOURS (DC),3723,2299,2040,2040,0,259,259,0,-1424,38.24872414719312,48,270,270,270,0,0,0,0,222,-462.5,100.0,100.0,0.0,88.73423227490214,88.73423227490214,0.0,Previsions
331,0,2019-01-21,120841,VELOUTE FRUIX PANACHES 125X8 AFH,0,0,1,VELOUTE,0,Villecomtal(FR),0082,0024 FR VALLET (DC),3723,2299,2040,2040,0,259,259,0,-1424,38.24872414719312,528,346,87,87,0,259,259,0,-182,34.46969696969697,25.14450867052023,25.14450867052023,0.0,88.73423227490214,88.73423227490214,0.0,Previsions
332,0,2019-01-21,120841,VELOUTE FRUIX PANACHES 125X8 AFH,0,0,1,VELOUTE,0,Villecomtal(FR),0077,0024 FR LILPARK (DC),3723,2299,2040,2040,0,259,259,0,-1424,38.24872414719312,296,471,471,471,0,0,0,0,175,-59.12162162162162,100.0,100.0,0.0,88.73423227490214,88.73423227490214,0.0,Previsions
333,0,2019-01-21,120841,VELOUTE FRUIX PANACHES 125X8 AFH,0,0,1,VELOUTE,0,Villecomtal(FR),0085,0024 FR TOULOUSE (DC),3723,2299,2040,2040,0,259,259,0,-1424,38.24872414719312,200,353,353,353,0,0,0,0,153,-76.5,100.0,100.0,0.0,88.73423227490214,88.73423227490214,0.0,Previsions
334,0,2019-01-21,120841,VELOUTE FRUIX PANACHES 125X8 AFH,0,0,1,VELOUTE,0,Villecomtal(FR),0083,0024 FR CHAPONNAY (DC),3723,2299,2040,2040,0,259,259,0,-1424,38.24872414719312,1004,142,142,142,0,0,0,0,-862,85.85657370517929,100.0,100.0,0.0,88.73423227490214,88.73423227490214,0.0,Previsions
335,0,2019-01-21,120841,VELOUTE FRUIX PANACHES 125X8 AFH,0,0,1,VELOUTE,0,Villecomtal(FR),0079,0024 FR PARIS SUD (DC),3723,2299,2040,2040,0,259,259,0,-1424,38.24872414719312,439,117,117,117,0,0,0,0,-322,73.34851936218679,100.0,100.0,0.0,88.73423227490214,88.73423227490214,0.0,Previsions
336,0,2019-01-21,120841,VELOUTE FRUIX PANACHES 125X8 AFH,0,0,1,VELOUTE,0,Villecomtal(FR),0078,0024 FR PARIS NORD (DC),3723,2299,2040,2040,0,259,259,0,-1424,38.24872414719312,1071,306,306,306,0,0,0,0,-765,71.42857142857143,100.0,100.0,0.0,88.73423227490214,88.73423227490214,0.0,Previsions
337,0,2019-01-21,121321,ACTIMEL MULTI 3x(8x100g) FR,0,0,0,ACTIMEL,1,Rotselaar(BE),0084,0024 FR AIX (DC),1555,1812,1416,1413,3,399,396,0,257,-16.527331189710612,167,133,133,133,0,0,0,0,-34,20.35928143712575,100.0,100.0,0.0,78.1456953642384,77.98013245033113,0.16556291390728006,Expe usine
338,0,2019-01-21,121321,ACTIMEL MULTI 3x(8x100g) FR,0,0,0,ACTIMEL,1,Rotselaar(BE),0080,0024 FR METZ (DC),1555,1812,1416,1413,3,399,396,0,257,-16.527331189710612,20,207,189,186,3,21,18,0,187,-935.0,91.30434782608695,89.85507246376811,1.4492753623188435,78.1456953642384,77.98013245033113,0.16556291390728006,Expe usine
339,0,2019-01-21,121321,ACTIMEL MULTI 3x(8x100g) FR,0,0,0,ACTIMEL,1,Rotselaar(BE),0081,0024 FR TOURS (DC),1555,1812,1416,1413,3,399,396,0,257,-16.527331189710612,200,168,168,168,0,0,0,0,-32,16.0,100.0,100.0,0.0,78.1456953642384,77.98013245033113,0.16556291390728006,Expe usine
340,0,2019-01-21,121321,ACTIMEL MULTI 3x(8x100g) FR,0,0,0,ACTIMEL,1,Rotselaar(BE),0082,0024 FR VALLET (DC),1555,1812,1416,1413,3,399,396,0,257,-16.527331189710612,130,122,122,122,0,0,0,0,-8,6.153846153846154,100.0,100.0,0.0,78.1456953642384,77.98013245033113,0.16556291390728006,Expe usine
341,0,2019-01-21,121321,ACTIMEL MULTI 3x(8x100g) FR,0,0,0,ACTIMEL,1,Rotselaar(BE),0077,0024 FR LILPARK (DC),1555,1812,1416,1413,3,399,396,0,257,-16.527331189710612,94,74,74,74,0,0,0,0,-20,21.27659574468085,100.0,100.0,0.0,78.1456953642384,77.98013245033113,0.16556291390728006,Expe usine
342,0,2019-01-21,121321,ACTIMEL MULTI 3x(8x100g) FR,0,0,0,ACTIMEL,1,Rotselaar(BE),0085,0024 FR TOULOUSE (DC),1555,1812,1416,1413,3,399,396,0,257,-16.527331189710612,277,206,18,18,0,188,188,0,-71,25.63176895306859,8.737864077669903,8.737864077669903,0.0,78.1456953642384,77.98013245033113,0.16556291390728006,Expe usine
343,0,2019-01-21,121321,ACTIMEL MULTI 3x(8x100g) FR,0,0,0,ACTIMEL,1,Rotselaar(BE),0083,0024 FR CHAPONNAY (DC),1555,1812,1416,1413,3,399,396,0,257,-16.527331189710612,277,314,314,314,0,0,0,0,37,-13.35740072202166,100.0,100.0,0.0,78.1456953642384,77.98013245033113,0.16556291390728006,Expe usine
344,0,2019-01-21,121321,ACTIMEL MULTI 3x(8x100g) FR,0,0,0,ACTIMEL,1,Rotselaar(BE),0079,0024 FR PARIS SUD (DC),1555,1812,1416,1413,3,399,396,0,257,-16.527331189710612,27,270,270,270,0,0,0,0,243,-900.0,100.0,100.0,0.0,78.1456953642384,77.98013245033113,0.16556291390728006,Expe usine
345,0,2019-01-21,121321,ACTIMEL MULTI 3x(8x100g) FR,0,0,0,ACTIMEL,1,Rotselaar(BE),0078,0024 FR PARIS NORD (DC),1555,1812,1416,1413,3,399,396,0,257,-16.527331189710612,363,318,128,128,0,190,190,0,-45,12.396694214876034,40.25157232704403,40.25157232704403,0.0,78.1456953642384,77.98013245033113,0.16556291390728006,Expe usine
346,1,2019-01-21,131291,ACTIMEL 0% NATU 3x(8x100g) FR,1,0,0,ACTIMEL,1,Rotselaar(BE),0077,0024 FR LILPARK (DC),105,388,388,257,131,131,0,0,283,-269.5238095238095,105,113,113,37,76,76,0,0,8,-7.619047619047619,100.0,32.743362831858406,67.2566371681416,100.0,66.23711340206185,33.76288659793815,Client
347,1,2019-01-21,133124,LIGHT & FREE PECH PASS 120X4 OD,1,0,0,LIGHT & FREE,0,Ferrières(FR),0083,0024 FR CHAPONNAY (DC),259,764,764,644,120,120,0,0,505,-194.98069498069498,259,159,159,39,120,120,0,0,-100,38.61003861003861,100.0,24.528301886792452,75.47169811320755,100.0,84.29319371727748,15.706806282722525,Previsions
348,1,2019-01-21,133133,LIGHT&FREE FRAIS BOIS 120X4 OD,1,0,0,LIGHT & FREE,0,Ferrières(FR),0083,0024 FR CHAPONNAY (DC),281,897,897,788,109,109,0,0,616,-219.21708185053382,281,174,174,65,109,109,0,0,-107,38.07829181494662,100.0,37.35632183908046,62.64367816091954,100.0,87.84838350055742,12.151616499442582,Previsions
349,0,2019-01-22,2118,GERVITA NATUR 100gx4,0,0,0,GERVITA,0,Ferrières(FR),0084,0024 FR AIX (DC),7301,6864,3523,3288,235,3576,3341,0,-437,5.985481440898507,1060,1014,241,10,231,1004,773,0,-46,4.339622641509434,23.767258382642996,0.9861932938856016,22.781065088757394,51.32575757575758,47.9020979020979,3.423659673659678,Qualité
350,0,2019-01-22,2118,GERVITA NATUR 100gx4,0,0,0,GERVITA,0,Ferrières(FR),0080,0024 FR METZ (DC),7301,6864,3523,3288,235,3576,3341,0,-437,5.985481440898507,276,262,262,262,0,0,0,0,-14,5.072463768115942,100.0,100.0,0.0,51.32575757575758,47.9020979020979,3.423659673659678,Qualité
351,0,2019-01-22,2118,GERVITA NATUR 100gx4,0,0,0,GERVITA,0,Ferrières(FR),0081,0024 FR TOURS (DC),7301,6864,3523,3288,235,3576,3341,0,-437,5.985481440898507,756,634,417,417,0,217,217,0,-122,16.137566137566136,65.77287066246058,65.77287066246058,0.0,51.32575757575758,47.9020979020979,3.423659673659678,Qualité
352,0,2019-01-22,2118,GERVITA NATUR 100gx4,0,0,0,GERVITA,0,Ferrières(FR),0082,0024 FR VALLET (DC),7301,6864,3523,3288,235,3576,3341,0,-437,5.985481440898507,501,366,366,366,0,0,0,0,-135,26.94610778443114,100.0,100.0,0.0,51.32575757575758,47.9020979020979,3.423659673659678,Qualité
353,0,2019-01-22,2118,GERVITA NATUR 100gx4,0,0,0,GERVITA,0,Ferrières(FR),0077,0024 FR LILPARK (DC),7301,6864,3523,3288,235,3576,3341,0,-437,5.985481440898507,523,389,389,389,0,0,0,0,-134,25.621414913957935,100.0,100.0,0.0,51.32575757575758,47.9020979020979,3.423659673659678,Qualité
354,0,2019-01-22,2118,GERVITA NATUR 100gx4,0,0,0,GERVITA,0,Ferrières(FR),0085,0024 FR TOULOUSE (DC),7301,6864,3523,3288,235,3576,3341,0,-437,5.985481440898507,820,754,754,754,0,0,0,0,-66,8.048780487804878,100.0,100.0,0.0,51.32575757575758,47.9020979020979,3.423659673659678,Qualité
355,0,2019-01-22,2118,GERVITA NATUR 100gx4,0,0,0,GERVITA,0,Ferrières(FR),0083,0024 FR CHAPONNAY (DC),7301,6864,3523,3288,235,3576,3341,0,-437,5.985481440898507,945,667,667,667,0,0,0,0,-278,29.417989417989418,100.0,100.0,0.0,51.32575757575758,47.9020979020979,3.423659673659678,Qualité
356,0,2019-01-22,2118,GERVITA NATUR 100gx4,0,0,0,GERVITA,0,Ferrières(FR),0079,0024 FR PARIS SUD (DC),7301,6864,3523,3288,235,3576,3341,0,-437,5.985481440898507,1379,1365,322,318,4,1047,1043,0,-14,1.015228426395939,23.589743589743588,23.296703296703296,0.293040293040292,51.32575757575758,47.9020979020979,3.423659673659678,Qualité
357,0,2019-01-22,2118,GERVITA NATUR 100gx4,0,0,0,GERVITA,0,Ferrières(FR),0078,0024 FR PARIS NORD (DC),7301,6864,3523,3288,235,3576,3341,0,-437,5.985481440898507,1041,1413,105,105,0,1308,1308,0,372,-35.73487031700288,7.43099787685775,7.43099787685775,0.0,51.32575757575758,47.9020979020979,3.423659673659678,Qualité
358,1,2019-01-22,83923,ACTIMEL NATU 3x(14x100g) FR,0,0,0,ACTIMEL,1,Rotselaar(BE),0078,0024 FR PARIS NORD (DC),28,1042,1011,850,161,192,31,0,1014,-3621.4285714285716,28,159,159,0,159,159,0,0,131,-467.85714285714283,100.0,0.0,100.0,97.02495201535508,81.57389635316699,15.451055662188097,Qualité
359,0,2019-01-22,83924,ACTIMEL STRA 3x(14x100g) FR,0,0,0,ACTIMEL,1,Rotselaar(BE),0080,0024 FR METZ (DC),2012,1235,738,594,144,641,497,0,-777,38.618290258449306,103,66,66,66,0,0,0,0,-37,35.922330097087375,100.0,100.0,0.0,59.75708502024292,48.097165991902834,11.659919028340084,Production
360,0,2019-01-22,83924,ACTIMEL STRA 3x(14x100g) FR,0,0,0,ACTIMEL,1,Rotselaar(BE),0081,0024 FR TOURS (DC),2012,1235,738,594,144,641,497,0,-777,38.618290258449306,91,61,61,61,0,0,0,0,-30,32.967032967032964,100.0,100.0,0.0,59.75708502024292,48.097165991902834,11.659919028340084,Production
361,0,2019-01-22,83924,ACTIMEL STRA 3x(14x100g) FR,0,0,0,ACTIMEL,1,Rotselaar(BE),0077,0024 FR LILPARK (DC),2012,1235,738,594,144,641,497,0,-777,38.618290258449306,261,448,214,204,10,244,234,0,187,-71.64750957854406,47.767857142857146,45.535714285714285,2.232142857142861,59.75708502024292,48.097165991902834,11.659919028340084,Production
362,0,2019-01-22,83924,ACTIMEL STRA 3x(14x100g) FR,0,0,0,ACTIMEL,1,Rotselaar(BE),0083,0024 FR CHAPONNAY (DC),2012,1235,738,594,144,641,497,0,-777,38.618290258449306,458,268,126,125,1,143,142,0,-190,41.48471615720524,47.01492537313433,46.64179104477612,0.37313432835821203,59.75708502024292,48.097165991902834,11.659919028340084,Production
363,0,2019-01-22,83924,ACTIMEL STRA 3x(14x100g) FR,0,0,0,ACTIMEL,1,Rotselaar(BE),0079,0024 FR PARIS SUD (DC),2012,1235,738,594,144,641,497,0,-777,38.618290258449306,285,158,37,35,2,123,121,0,-127,44.56140350877193,23.417721518987342,22.151898734177212,1.2658227848101298,59.75708502024292,48.097165991902834,11.659919028340084,Production
364,1,2019-01-22,83924,ACTIMEL STRA 3x(14x100g) FR,0,0,0,ACTIMEL,1,Rotselaar(BE),0078,0024 FR PARIS NORD (DC),2012,1235,738,594,144,641,497,0,-777,38.618290258449306,407,234,234,103,131,131,0,0,-173,42.5061425061425,100.0,44.01709401709402,55.98290598290598,59.75708502024292,48.097165991902834,11.659919028340084,Qualité
365,0,2019-01-22,83924,ACTIMEL STRA 3x(14x100g) FR,0,0,0,ACTIMEL,1,Rotselaar(BE),0078,0024 FR PARIS NORD (DC),2012,1235,738,594,144,641,497,0,-777,38.618290258449306,407,234,234,103,131,131,0,0,-173,42.5061425061425,100.0,44.01709401709402,55.98290598290598,59.75708502024292,48.097165991902834,11.659919028340084,Production
366,1,2019-01-22,131289,ACTIMEL MULTI 3x(8x100g) FR,1,0,0,ACTIMEL,1,Rotselaar(BE),0077,0024 FR LILPARK (DC),11,741,726,708,18,33,15,0,730,-6636.363636363636,11,33,18,0,18,33,15,0,22,-200.0,54.54545454545454,0.0,54.54545454545454,97.97570850202429,95.54655870445345,2.429149797570844,Probleme Copacking
367,1,2019-01-22,133126,LIGHT & FREE MYRTILLE 120X4 OD,1,0,0,LIGHT & FREE,0,Ferrières(FR),0078,0024 FR PARIS NORD (DC),93,521,521,486,35,35,0,0,428,-460.21505376344084,93,56,56,21,35,35,0,0,-37,39.784946236559136,100.0,37.5,62.5,100.0,93.28214971209214,6.717850287907865,Probleme Copacking
368,0,2019-01-22,133394,LIGHT & FREE PECH PASS 120X4,0,0,0,LIGHT & FREE,0,Ferrières(FR),0084,0024 FR AIX (DC),491,479,303,298,5,181,176,0,-12,2.443991853360489,92,71,37,37,0,34,34,0,-21,22.82608695652174,52.112676056338024,52.112676056338024,0.0,63.25678496868476,62.21294363256785,1.0438413361169125,Previsions
369,0,2019-01-22,133394,LIGHT & FREE PECH PASS 120X4,0,0,0,LIGHT & FREE,0,Ferrières(FR),0080,0024 FR METZ (DC),491,479,303,298,5,181,176,0,-12,2.443991853360489,33,15,15,15,0,0,0,0,-18,54.54545454545455,100.0,100.0,0.0,63.25678496868476,62.21294363256785,1.0438413361169125,Previsions
370,0,2019-01-22,133394,LIGHT & FREE PECH PASS 120X4,0,0,0,LIGHT & FREE,0,Ferrières(FR),0081,0024 FR TOURS (DC),491,479,303,298,5,181,176,0,-12,2.443991853360489,1,66,7,6,1,60,59,0,65,-6500.0,10.606060606060606,9.090909090909092,1.5151515151515138,63.25678496868476,62.21294363256785,1.0438413361169125,Previsions
371,0,2019-01-22,133394,LIGHT & FREE PECH PASS 120X4,0,0,0,LIGHT & FREE,0,Ferrières(FR),0082,0024 FR VALLET (DC),491,479,303,298,5,181,176,0,-12,2.443991853360489,71,54,27,26,1,28,27,0,-17,23.943661971830984,50.0,48.148148148148145,1.8518518518518547,63.25678496868476,62.21294363256785,1.0438413361169125,Previsions
372,0,2019-01-22,133394,LIGHT & FREE PECH PASS 120X4,0,0,0,LIGHT & FREE,0,Ferrières(FR),0077,0024 FR LILPARK (DC),491,479,303,298,5,181,176,0,-12,2.443991853360489,91,78,78,78,0,0,0,0,-13,14.285714285714286,100.0,100.0,0.0,63.25678496868476,62.21294363256785,1.0438413361169125,Previsions
373,0,2019-01-22,133394,LIGHT & FREE PECH PASS 120X4,0,0,0,LIGHT & FREE,0,Ferrières(FR),0085,0024 FR TOULOUSE (DC),491,479,303,298,5,181,176,0,-12,2.443991853360489,68,63,63,60,3,3,0,0,-5,7.352941176470588,100.0,95.23809523809523,4.761904761904773,63.25678496868476,62.21294363256785,1.0438413361169125,Previsions
374,0,2019-01-22,133394,LIGHT & FREE PECH PASS 120X4,0,0,0,LIGHT & FREE,0,Ferrières(FR),0083,0024 FR CHAPONNAY (DC),491,479,303,298,5,181,176,0,-12,2.443991853360489,87,79,23,23,0,56,56,0,-8,9.195402298850574,29.11392405063291,29.11392405063291,0.0,63.25678496868476,62.21294363256785,1.0438413361169125,Previsions
375,0,2019-01-22,133394,LIGHT & FREE PECH PASS 120X4,0,0,0,LIGHT & FREE,0,Ferrières(FR),0078,0024 FR PARIS NORD (DC),491,479,303,298,5,181,176,0,-12,2.443991853360489,48,53,53,53,0,0,0,0,5,-10.416666666666666,100.0,100.0,0.0,63.25678496868476,62.21294363256785,1.0438413361169125,Previsions
376,0,2019-01-22,140838,ACTIVIA BIO NATURE 125X4,0,0,0,ACTIVIA,0,Bailleul(FR),0084,0024 FR AIX (DC),327,373,251,247,4,126,122,0,46,-14.067278287461773,76,86,86,86,0,0,0,0,10,-13.157894736842104,100.0,100.0,0.0,67.29222520107238,66.21983914209115,1.0723860589812375,Previsions
377,0,2019-01-22,140838,ACTIVIA BIO NATURE 125X4,0,0,0,ACTIVIA,0,Bailleul(FR),0080,0024 FR METZ (DC),327,373,251,247,4,126,122,0,46,-14.067278287461773,39,37,18,18,0,19,19,0,-2,5.128205128205129,48.64864864864865,48.64864864864865,0.0,67.29222520107238,66.21983914209115,1.0723860589812375,Previsions
378,0,2019-01-22,140838,ACTIVIA BIO NATURE 125X4,0,0,0,ACTIVIA,0,Bailleul(FR),0081,0024 FR TOURS (DC),327,373,251,247,4,126,122,0,46,-14.067278287461773,70,70,70,70,0,0,0,0,0,0.0,100.0,100.0,0.0,67.29222520107238,66.21983914209115,1.0723860589812375,Previsions
379,0,2019-01-22,140838,ACTIVIA BIO NATURE 125X4,0,0,0,ACTIVIA,0,Bailleul(FR),0082,0024 FR VALLET (DC),327,373,251,247,4,126,122,0,46,-14.067278287461773,5,50,12,12,0,38,38,0,45,-900.0,24.0,24.0,0.0,67.29222520107238,66.21983914209115,1.0723860589812375,Previsions
380,0,2019-01-22,140838,ACTIVIA BIO NATURE 125X4,0,0,0,ACTIVIA,0,Bailleul(FR),0077,0024 FR LILPARK (DC),327,373,251,247,4,126,122,0,46,-14.067278287461773,36,63,34,30,4,33,29,0,27,-75.0,53.96825396825397,47.61904761904761,6.349206349206355,67.29222520107238,66.21983914209115,1.0723860589812375,Previsions
381,0,2019-01-22,140838,ACTIVIA BIO NATURE 125X4,0,0,0,ACTIVIA,0,Bailleul(FR),0078,0024 FR PARIS NORD (DC),327,373,251,247,4,126,122,0,46,-14.067278287461773,101,67,31,31,0,36,36,0,-34,33.663366336633665,46.26865671641791,46.26865671641791,0.0,67.29222520107238,66.21983914209115,1.0723860589812375,Previsions
382,0,2019-01-23,2118,GERVITA NATUR 100gx4,0,0,0,GERVITA,0,Ferrières(FR),0080,0024 FR METZ (DC),4463,4670,3765,2569,1196,2101,905,0,207,-4.638135783105534,548,462,325,325,0,137,137,0,-86,15.693430656934307,70.34632034632034,70.34632034632034,0.0,80.62098501070663,55.010706638115636,25.610278372590997,Qualité
383,0,2019-01-23,2118,GERVITA NATUR 100gx4,0,0,0,GERVITA,0,Ferrières(FR),0081,0024 FR TOURS (DC),4463,4670,3765,2569,1196,2101,905,0,207,-4.638135783105534,762,678,67,66,1,612,611,0,-84,11.023622047244094,9.882005899705016,9.734513274336283,0.14749262536873253,80.62098501070663,55.010706638115636,25.610278372590997,Qualité
384,0,2019-01-23,2118,GERVITA NATUR 100gx4,0,0,0,GERVITA,0,Ferrières(FR),0082,0024 FR VALLET (DC),4463,4670,3765,2569,1196,2101,905,0,207,-4.638135783105534,493,480,471,471,0,9,9,0,-13,2.636916835699797,98.125,98.125,0.0,80.62098501070663,55.010706638115636,25.610278372590997,Qualité
385,0,2019-01-23,2118,GERVITA NATUR 100gx4,0,0,0,GERVITA,0,Ferrières(FR),0077,0024 FR LILPARK (DC),4463,4670,3765,2569,1196,2101,905,0,207,-4.638135783105534,292,305,157,157,0,148,148,0,13,-4.4520547945205475,51.47540983606558,51.47540983606558,0.0,80.62098501070663,55.010706638115636,25.610278372590997,Qualité
386,0,2019-01-23,2118,GERVITA NATUR 100gx4,0,0,0,GERVITA,0,Ferrières(FR),0085,0024 FR TOULOUSE (DC),4463,4670,3765,2569,1196,2101,905,0,207,-4.638135783105534,1376,1448,1448,1448,0,0,0,0,72,-5.232558139534884,100.0,100.0,0.0,80.62098501070663,55.010706638115636,25.610278372590997,Qualité
387,0,2019-01-23,2118,GERVITA NATUR 100gx4,0,0,0,GERVITA,0,Ferrières(FR),0083,0024 FR CHAPONNAY (DC),4463,4670,3765,2569,1196,2101,905,0,207,-4.638135783105534,992,1297,1297,102,1195,1195,0,0,305,-30.745967741935484,100.0,7.864302235929068,92.13569776407093,80.62098501070663,55.010706638115636,25.610278372590997,Qualité
388,0,2019-01-23,102483,JOCKEY FROM NATURE 100X8 3%,0,0,0,JOCKEY,0,Ferrières(FR),0084,0024 FR AIX (DC),1252,2155,1743,1618,125,537,412,0,903,-72.12460063897764,208,177,125,125,0,52,52,0,-31,14.903846153846153,70.62146892655367,70.62146892655367,0.0,80.88167053364269,75.08120649651973,5.800464037122964,Previsions
389,0,2019-01-23,102483,JOCKEY FROM NATURE 100X8 3%,0,0,0,JOCKEY,0,Ferrières(FR),0080,0024 FR METZ (DC),1252,2155,1743,1618,125,537,412,0,903,-72.12460063897764,2,195,195,195,0,0,0,0,193,-9650.0,100.0,100.0,0.0,80.88167053364269,75.08120649651973,5.800464037122964,Previsions
390,0,2019-01-23,102483,JOCKEY FROM NATURE 100X8 3%,0,0,0,JOCKEY,0,Ferrières(FR),0081,0024 FR TOURS (DC),1252,2155,1743,1618,125,537,412,0,903,-72.12460063897764,278,317,317,317,0,0,0,0,39,-14.028776978417266,100.0,100.0,0.0,80.88167053364269,75.08120649651973,5.800464037122964,Previsions
391,0,2019-01-23,102483,JOCKEY FROM NATURE 100X8 3%,0,0,0,JOCKEY,0,Ferrières(FR),0082,0024 FR VALLET (DC),1252,2155,1743,1618,125,537,412,0,903,-72.12460063897764,213,236,236,236,0,0,0,0,23,-10.7981220657277,100.0,100.0,0.0,80.88167053364269,75.08120649651973,5.800464037122964,Previsions
392,0,2019-01-23,102483,JOCKEY FROM NATURE 100X8 3%,0,0,0,JOCKEY,0,Ferrières(FR),0077,0024 FR LILPARK (DC),1252,2155,1743,1618,125,537,412,0,903,-72.12460063897764,8,61,61,61,0,0,0,0,53,-662.5,100.0,100.0,0.0,80.88167053364269,75.08120649651973,5.800464037122964,Previsions
393,0,2019-01-23,102483,JOCKEY FROM NATURE 100X8 3%,0,0,0,JOCKEY,0,Ferrières(FR),0085,0024 FR TOULOUSE (DC),1252,2155,1743,1618,125,537,412,0,903,-72.12460063897764,32,309,217,217,0,92,92,0,277,-865.625,70.22653721682848,70.22653721682848,0.0,80.88167053364269,75.08120649651973,5.800464037122964,Previsions
394,0,2019-01-23,102483,JOCKEY FROM NATURE 100X8 3%,0,0,0,JOCKEY,0,Ferrières(FR),0083,0024 FR CHAPONNAY (DC),1252,2155,1743,1618,125,537,412,0,903,-72.12460063897764,24,262,262,146,116,116,0,0,238,-991.6666666666666,100.0,55.72519083969466,44.27480916030534,80.88167053364269,75.08120649651973,5.800464037122964,Previsions
395,0,2019-01-23,102483,JOCKEY FROM NATURE 100X8 3%,0,0,0,JOCKEY,0,Ferrières(FR),0079,0024 FR PARIS SUD (DC),1252,2155,1743,1618,125,537,412,0,903,-72.12460063897764,242,327,181,180,1,147,146,0,85,-35.12396694214876,55.35168195718655,55.04587155963303,0.3058103975535218,80.88167053364269,75.08120649651973,5.800464037122964,Previsions
396,0,2019-01-23,102483,JOCKEY FROM NATURE 100X8 3%,0,0,0,JOCKEY,0,Ferrières(FR),0078,0024 FR PARIS NORD (DC),1252,2155,1743,1618,125,537,412,0,903,-72.12460063897764,245,271,149,141,8,130,122,0,26,-10.612244897959183,54.981549815498155,52.02952029520295,2.9520295202952056,80.88167053364269,75.08120649651973,5.800464037122964,Previsions
397,1,2019-01-23,133134,LIGHT & FREE FRAMB GREN 120X4 OD,1,0,0,LIGHT & FREE,0,Ferrières(FR),0083,0024 FR CHAPONNAY (DC),85,217,217,167,50,50,0,0,132,-155.2941176470588,85,56,56,26,30,30,0,0,-29,34.11764705882353,100.0,46.42857142857143,53.57142857142857,100.0,76.95852534562212,23.04147465437788,Transport
398,0,2019-01-23,133394,LIGHT & FREE PECH PASS 120X4,0,0,0,LIGHT & FREE,0,Ferrières(FR),0084,0024 FR AIX (DC),202,180,101,101,0,79,79,0,-22,10.891089108910892,107,80,1,1,0,79,79,0,-27,25.233644859813083,1.25,1.25,0.0,56.111111111111114,56.111111111111114,0.0,Previsions
399,0,2019-01-23,133394,LIGHT & FREE PECH PASS 120X4,0,0,0,LIGHT & FREE,0,Ferrières(FR),0080,0024 FR METZ (DC),202,180,101,101,0,79,79,0,-22,10.891089108910892,6,52,52,52,0,0,0,0,46,-766.6666666666666,100.0,100.0,0.0,56.111111111111114,56.111111111111114,0.0,Previsions
400,0,2019-01-23,133394,LIGHT & FREE PECH PASS 120X4,0,0,0,LIGHT & FREE,0,Ferrières(FR),0078,0024 FR PARIS NORD (DC),202,180,101,101,0,79,79,0,-22,10.891089108910892,89,48,48,48,0,0,0,0,-41,46.06741573033708,100.0,100.0,0.0,56.111111111111114,56.111111111111114,0.0,Previsions
401,0,2019-01-24,2118,GERVITA NATUR 100gx4,0,0,0,GERVITA,0,Ferrières(FR),0084,0024 FR AIX (DC),11934,11511,8900,7786,1114,3725,2611,0,-423,3.544494720965309,2253,2111,1243,1243,0,868,868,0,-142,6.302707501109632,58.88204642349597,58.88204642349597,0.0,77.3173486230562,67.6396490313613,9.677699591694903,Qualité
402,0,2019-01-24,2118,GERVITA NATUR 100gx4,0,0,0,GERVITA,0,Ferrières(FR),0080,0024 FR METZ (DC),11934,11511,8900,7786,1114,3725,2611,0,-423,3.544494720965309,441,455,455,416,39,39,0,0,14,-3.1746031746031744,100.0,91.42857142857143,8.57142857142857,77.3173486230562,67.6396490313613,9.677699591694903,Qualité
403,0,2019-01-24,2118,GERVITA NATUR 100gx4,0,0,0,GERVITA,0,Ferrières(FR),0081,0024 FR TOURS (DC),11934,11511,8900,7786,1114,3725,2611,0,-423,3.544494720965309,1383,1078,944,190,754,888,134,0,-305,22.05350686912509,87.569573283859,17.625231910946194,69.9443413729128,77.3173486230562,67.6396490313613,9.677699591694903,Qualité
404,1,2019-01-24,2118,GERVITA NATUR 100gx4,0,0,0,GERVITA,0,Ferrières(FR),0081,0024 FR TOURS (DC),11934,11511,8900,7786,1114,3725,2611,0,-423,3.544494720965309,1383,1078,944,190,754,888,134,0,-305,22.05350686912509,87.569573283859,17.625231910946194,69.9443413729128,77.3173486230562,67.6396490313613,9.677699591694903,Qualité
405,0,2019-01-24,2118,GERVITA NATUR 100gx4,0,0,0,GERVITA,0,Ferrières(FR),0082,0024 FR VALLET (DC),11934,11511,8900,7786,1114,3725,2611,0,-423,3.544494720965309,484,383,383,383,0,0,0,0,-101,20.867768595041323,100.0,100.0,0.0,77.3173486230562,67.6396490313613,9.677699591694903,Qualité
406,0,2019-01-24,2118,GERVITA NATUR 100gx4,0,0,0,GERVITA,0,Ferrières(FR),0077,0024 FR LILPARK (DC),11934,11511,8900,7786,1114,3725,2611,0,-423,3.544494720965309,649,588,588,588,0,0,0,0,-61,9.399075500770415,100.0,100.0,0.0,77.3173486230562,67.6396490313613,9.677699591694903,Qualité
407,0,2019-01-24,2118,GERVITA NATUR 100gx4,0,0,0,GERVITA,0,Ferrières(FR),0085,0024 FR TOULOUSE (DC),11934,11511,8900,7786,1114,3725,2611,0,-423,3.544494720965309,1420,1303,1303,1205,98,98,0,0,-117,8.23943661971831,100.0,92.47889485801996,7.521105141980044,77.3173486230562,67.6396490313613,9.677699591694903,Qualité
408,0,2019-01-24,2118,GERVITA NATUR 100gx4,0,0,0,GERVITA,0,Ferrières(FR),0083,0024 FR CHAPONNAY (DC),11934,11511,8900,7786,1114,3725,2611,0,-423,3.544494720965309,23,1351,1175,1123,52,228,176,0,1328,-5773.913043478261,86.97261287934863,83.12361213915618,3.8490007401924515,77.3173486230562,67.6396490313613,9.677699591694903,Qualité
409,0,2019-01-24,2118,GERVITA NATUR 100gx4,0,0,0,GERVITA,0,Ferrières(FR),0079,0024 FR PARIS SUD (DC),11934,11511,8900,7786,1114,3725,2611,0,-423,3.544494720965309,1971,2167,1895,1724,171,443,272,0,196,-9.944190766108575,87.44808491001385,79.55699123211814,7.891093677895711,77.3173486230562,67.6396490313613,9.677699591694903,Qualité
410,0,2019-01-24,2118,GERVITA NATUR 100gx4,0,0,0,GERVITA,0,Ferrières(FR),0078,0024 FR PARIS NORD (DC),11934,11511,8900,7786,1114,3725,2611,0,-423,3.544494720965309,1927,2075,914,914,0,1161,1161,0,148,-7.680332122470161,44.04819277108434,44.04819277108434,0.0,77.3173486230562,67.6396490313613,9.677699591694903,Qualité
411,0,2019-01-24,32803,TAILLEFINE CHEESE NAT 0% 850GX1,0,0,0,TAILLEFINE,0,Ferrières(FR),0084,0024 FR AIX (DC),787,631,293,288,5,343,338,0,-156,19.82210927573062,116,111,12,12,0,99,99,0,-5,4.310344827586207,10.81081081081081,10.81081081081081,0.0,46.43423137876387,45.64183835182251,0.7923930269413617,Previsions
412,0,2019-01-24,32803,TAILLEFINE CHEESE NAT 0% 850GX1,0,0,0,TAILLEFINE,0,Ferrières(FR),0080,0024 FR METZ (DC),787,631,293,288,5,343,338,0,-156,19.82210927573062,33,25,11,11,0,14,14,0,-8,24.242424242424242,44.0,44.0,0.0,46.43423137876387,45.64183835182251,0.7923930269413617,Previsions
413,0,2019-01-24,32803,TAILLEFINE CHEESE NAT 0% 850GX1,0,0,0,TAILLEFINE,0,Ferrières(FR),0081,0024 FR TOURS (DC),787,631,293,288,5,343,338,0,-156,19.82210927573062,72,70,70,70,0,0,0,0,-2,2.7777777777777777,100.0,100.0,0.0,46.43423137876387,45.64183835182251,0.7923930269413617,Previsions
414,0,2019-01-24,32803,TAILLEFINE CHEESE NAT 0% 850GX1,0,0,0,TAILLEFINE,0,Ferrières(FR),0082,0024 FR VALLET (DC),787,631,293,288,5,343,338,0,-156,19.82210927573062,39,31,26,26,0,5,5,0,-8,20.512820512820515,83.87096774193549,83.87096774193549,0.0,46.43423137876387,45.64183835182251,0.7923930269413617,Previsions
415,0,2019-01-24,32803,TAILLEFINE CHEESE NAT 0% 850GX1,0,0,0,TAILLEFINE,0,Ferrières(FR),0077,0024 FR LILPARK (DC),787,631,293,288,5,343,338,0,-156,19.82210927573062,89,86,44,44,0,42,42,0,-3,3.3707865168539324,51.162790697674424,51.162790697674424,0.0,46.43423137876387,45.64183835182251,0.7923930269413617,Previsions
416,0,2019-01-24,32803,TAILLEFINE CHEESE NAT 0% 850GX1,0,0,0,TAILLEFINE,0,Ferrières(FR),0079,0024 FR PARIS SUD (DC),787,631,293,288,5,343,338,0,-156,19.82210927573062,298,249,105,100,5,149,144,0,-49,16.44295302013423,42.168674698795186,40.16064257028113,2.00803212851406,46.43423137876387,45.64183835182251,0.7923930269413617,Previsions
417,0,2019-01-24,32803,TAILLEFINE CHEESE NAT 0% 850GX1,0,0,0,TAILLEFINE,0,Ferrières(FR),0078,0024 FR PARIS NORD (DC),787,631,293,288,5,343,338,0,-156,19.82210927573062,140,59,25,25,0,34,34,0,-81,57.857142857142854,42.3728813559322,42.3728813559322,0.0,46.43423137876387,45.64183835182251,0.7923930269413617,Previsions
418,1,2019-01-24,133124,LIGHT & FREE PECH PASS 120X4 OD,1,0,0,LIGHT & FREE,0,Ferrières(FR),0081,0024 FR TOURS (DC),35,292,292,226,66,66,0,0,257,-734.2857142857143,35,97,97,40,57,57,0,0,62,-177.14285714285714,100.0,41.23711340206185,58.76288659793815,100.0,77.3972602739726,22.602739726027394,Transport
419,0,2019-01-24,134010,VELOUTE FRUIX PANACHE 125X16 OD,1,0,0,VELOUTE,0,Villecomtal(FR),0080,0024 FR METZ (DC),3698,5340,4459,4330,129,1010,881,0,1642,-44.402379664683615,410,270,270,142,128,128,0,0,-140,34.146341463414636,100.0,52.59259259259259,47.40740740740741,83.50187265917603,81.08614232209737,2.4157303370786565,Previsions
420,1,2019-01-24,134010,VELOUTE FRUIX PANACHE 125X16 OD,1,0,0,VELOUTE,0,Villecomtal(FR),0080,0024 FR METZ (DC),3698,5340,4459,4330,129,1010,881,0,1642,-44.402379664683615,410,270,270,142,128,128,0,0,-140,34.146341463414636,100.0,52.59259259259259,47.40740740740741,83.50187265917603,81.08614232209737,2.4157303370786565,Previsions
421,0,2019-01-24,134010,VELOUTE FRUIX PANACHE 125X16 OD,1,0,0,VELOUTE,0,Villecomtal(FR),0081,0024 FR TOURS (DC),3698,5340,4459,4330,129,1010,881,0,1642,-44.402379664683615,289,332,332,332,0,0,0,0,43,-14.878892733564014,100.0,100.0,0.0,83.50187265917603,81.08614232209737,2.4157303370786565,Previsions
422,0,2019-01-24,134010,VELOUTE FRUIX PANACHE 125X16 OD,1,0,0,VELOUTE,0,Villecomtal(FR),0077,0024 FR LILPARK (DC),3698,5340,4459,4330,129,1010,881,0,1642,-44.402379664683615,48,1358,972,971,1,387,386,0,1310,-2729.1666666666665,71.5758468335788,71.5022091310751,0.07363770250368873,83.50187265917603,81.08614232209737,2.4157303370786565,Previsions
423,0,2019-01-24,134010,VELOUTE FRUIX PANACHE 125X16 OD,1,0,0,VELOUTE,0,Villecomtal(FR),0083,0024 FR CHAPONNAY (DC),3698,5340,4459,4330,129,1010,881,0,1642,-44.402379664683615,491,437,416,416,0,21,21,0,-54,10.9979633401222,95.19450800915332,95.19450800915332,0.0,83.50187265917603,81.08614232209737,2.4157303370786565,Previsions
424,0,2019-01-24,134010,VELOUTE FRUIX PANACHE 125X16 OD,1,0,0,VELOUTE,0,Villecomtal(FR),0079,0024 FR PARIS SUD (DC),3698,5340,4459,4330,129,1010,881,0,1642,-44.402379664683615,2050,2943,2469,2469,0,474,474,0,893,-43.5609756097561,83.89398572884812,83.89398572884812,0.0,83.50187265917603,81.08614232209737,2.4157303370786565,Previsions
425,0,2019-01-25,2118,GERVITA NATUR 100gx4,0,0,0,GERVITA,0,Ferrières(FR),0084,0024 FR AIX (DC),8465,10744,9904,9898,6,846,840,0,2279,-26.922622563496752,1721,1956,1956,1956,0,0,0,0,235,-13.654851830331204,100.0,100.0,0.0,92.18168279970216,92.12583767684289,0.05584512285926735,Qualité
426,0,2019-01-25,2118,GERVITA NATUR 100gx4,0,0,0,GERVITA,0,Ferrières(FR),0080,0024 FR METZ (DC),8465,10744,9904,9898,6,846,840,0,2279,-26.922622563496752,440,336,336,336,0,0,0,0,-104,23.636363636363637,100.0,100.0,0.0,92.18168279970216,92.12583767684289,0.05584512285926735,Qualité
427,0,2019-01-25,2118,GERVITA NATUR 100gx4,0,0,0,GERVITA,0,Ferrières(FR),0081,0024 FR TOURS (DC),8465,10744,9904,9898,6,846,840,0,2279,-26.922622563496752,1470,1234,1234,1234,0,0,0,0,-236,16.05442176870748,100.0,100.0,0.0,92.18168279970216,92.12583767684289,0.05584512285926735,Qualité
428,0,2019-01-25,2118,GERVITA NATUR 100gx4,0,0,0,GERVITA,0,Ferrières(FR),0082,0024 FR VALLET (DC),8465,10744,9904,9898,6,846,840,0,2279,-26.922622563496752,445,382,382,382,0,0,0,0,-63,14.157303370786517,100.0,100.0,0.0,92.18168279970216,92.12583767684289,0.05584512285926735,Qualité
429,0,2019-01-25,2118,GERVITA NATUR 100gx4,0,0,0,GERVITA,0,Ferrières(FR),0077,0024 FR LILPARK (DC),8465,10744,9904,9898,6,846,840,0,2279,-26.922622563496752,383,417,417,417,0,0,0,0,34,-8.877284595300262,100.0,100.0,0.0,92.18168279970216,92.12583767684289,0.05584512285926735,Qualité
430,0,2019-01-25,2118,GERVITA NATUR 100gx4,0,0,0,GERVITA,0,Ferrières(FR),0085,0024 FR TOULOUSE (DC),8465,10744,9904,9898,6,846,840,0,2279,-26.922622563496752,999,926,926,926,0,0,0,0,-73,7.307307307307307,100.0,100.0,0.0,92.18168279970216,92.12583767684289,0.05584512285926735,Qualité
431,0,2019-01-25,2118,GERVITA NATUR 100gx4,0,0,0,GERVITA,0,Ferrières(FR),0083,0024 FR CHAPONNAY (DC),8465,10744,9904,9898,6,846,840,0,2279,-26.922622563496752,1198,1595,922,916,6,679,673,0,397,-33.13856427378965,57.805642633228835,57.4294670846395,0.37617554858933744,92.18168279970216,92.12583767684289,0.05584512285926735,Qualité
432,0,2019-01-25,2118,GERVITA NATUR 100gx4,0,0,0,GERVITA,0,Ferrières(FR),0079,0024 FR PARIS SUD (DC),8465,10744,9904,9898,6,846,840,0,2279,-26.922622563496752,137,1683,1683,1683,0,0,0,0,1546,-1128.4671532846714,100.0,100.0,0.0,92.18168279970216,92.12583767684289,0.05584512285926735,Qualité
433,0,2019-01-25,2118,GERVITA NATUR 100gx4,0,0,0,GERVITA,0,Ferrières(FR),0078,0024 FR PARIS NORD (DC),8465,10744,9904,9898,6,846,840,0,2279,-26.922622563496752,1672,2215,2048,2048,0,167,167,0,543,-32.47607655502392,92.46049661399547,92.46049661399547,0.0,92.18168279970216,92.12583767684289,0.05584512285926735,Qualité
434,0,2019-01-25,79537,LES 2 VACHES FLAN BIO 100X4,0,0,0,LES 2 VACHES,0,LeMolay(FR),0084,0024 FR AIX (DC),1389,1749,1665,1217,448,532,84,0,360,-25.91792656587473,20,296,296,0,296,296,0,0,276,-1380.0,100.0,0.0,100.0,95.19725557461408,69.58261863922242,25.61463693539166,Previsions
435,1,2019-01-25,79537,LES 2 VACHES FLAN BIO 100X4,0,0,0,LES 2 VACHES,0,LeMolay(FR),0084,0024 FR AIX (DC),1389,1749,1665,1217,448,532,84,0,360,-25.91792656587473,20,296,296,0,296,296,0,0,276,-1380.0,100.0,0.0,100.0,95.19725557461408,69.58261863922242,25.61463693539166,Previsions
436,0,2019-01-25,79537,LES 2 VACHES FLAN BIO 100X4,0,0,0,LES 2 VACHES,0,LeMolay(FR),0080,0024 FR METZ (DC),1389,1749,1665,1217,448,532,84,0,360,-25.91792656587473,11,99,22,21,1,78,77,0,88,-800.0,22.22222222222222,21.21212121212121,1.0101010101010104,95.19725557461408,69.58261863922242,25.61463693539166,Previsions
437,0,2019-01-25,79537,LES 2 VACHES FLAN BIO 100X4,0,0,0,LES 2 VACHES,0,LeMolay(FR),0081,0024 FR TOURS (DC),1389,1749,1665,1217,448,532,84,0,360,-25.91792656587473,194,74,74,74,0,0,0,0,-120,61.855670103092784,100.0,100.0,0.0,95.19725557461408,69.58261863922242,25.61463693539166,Previsions
438,0,2019-01-25,79537,LES 2 VACHES FLAN BIO 100X4,0,0,0,LES 2 VACHES,0,LeMolay(FR),0077,0024 FR LILPARK (DC),1389,1749,1665,1217,448,532,84,0,360,-25.91792656587473,103,37,30,30,0,7,7,0,-66,64.07766990291262,81.08108108108108,81.08108108108108,0.0,95.19725557461408,69.58261863922242,25.61463693539166,Previsions
439,0,2019-01-25,79537,LES 2 VACHES FLAN BIO 100X4,0,0,0,LES 2 VACHES,0,LeMolay(FR),0085,0024 FR TOULOUSE (DC),1389,1749,1665,1217,448,532,84,0,360,-25.91792656587473,266,291,291,262,29,29,0,0,25,-9.398496240601503,100.0,90.03436426116839,9.965635738831608,95.19725557461408,69.58261863922242,25.61463693539166,Previsions
440,0,2019-01-25,79537,LES 2 VACHES FLAN BIO 100X4,0,0,0,LES 2 VACHES,0,LeMolay(FR),0083,0024 FR CHAPONNAY (DC),1389,1749,1665,1217,448,532,84,0,360,-25.91792656587473,161,266,266,196,70,70,0,0,105,-65.21739130434783,100.0,73.68421052631578,26.31578947368422,95.19725557461408,69.58261863922242,25.61463693539166,Previsions
441,0,2019-01-25,79537,LES 2 VACHES FLAN BIO 100X4,0,0,0,LES 2 VACHES,0,LeMolay(FR),0079,0024 FR PARIS SUD (DC),1389,1749,1665,1217,448,532,84,0,360,-25.91792656587473,237,220,220,217,3,3,0,0,-17,7.172995780590718,100.0,98.63636363636363,1.363636363636374,95.19725557461408,69.58261863922242,25.61463693539166,Previsions
442,0,2019-01-25,79537,LES 2 VACHES FLAN BIO 100X4,0,0,0,LES 2 VACHES,0,LeMolay(FR),0078,0024 FR PARIS NORD (DC),1389,1749,1665,1217,448,532,84,0,360,-25.91792656587473,377,466,466,417,49,49,0,0,89,-23.607427055702917,100.0,89.48497854077253,10.51502145922747,95.19725557461408,69.58261863922242,25.61463693539166,Previsions
443,0,2019-01-25,130581,TAILLEFINE FRT PANACHE 125X16 OD,1,0,0,TAILLEFINE,0,Villecomtal(FR),0080,0024 FR METZ (DC),8237,3280,3280,2598,682,682,0,0,-4957,60.179677066893284,2183,1429,1429,1033,396,396,0,0,-754,34.53962437013284,100.0,72.28831350594822,27.711686494051776,100.0,79.20731707317074,20.792682926829258,Qualité
444,1,2019-01-25,130581,TAILLEFINE FRT PANACHE 125X16 OD,1,0,0,TAILLEFINE,0,Villecomtal(FR),0080,0024 FR METZ (DC),8237,3280,3280,2598,682,682,0,0,-4957,60.179677066893284,2183,1429,1429,1033,396,396,0,0,-754,34.53962437013284,100.0,72.28831350594822,27.711686494051776,100.0,79.20731707317074,20.792682926829258,Transport
445,0,2019-01-25,130581,TAILLEFINE FRT PANACHE 125X16 OD,1,0,0,TAILLEFINE,0,Villecomtal(FR),0081,0024 FR TOURS (DC),8237,3280,3280,2598,682,682,0,0,-4957,60.179677066893284,36,56,56,56,0,0,0,0,20,-55.55555555555556,100.0,100.0,0.0,100.0,79.20731707317074,20.792682926829258,Qualité
446,0,2019-01-25,130581,TAILLEFINE FRT PANACHE 125X16 OD,1,0,0,TAILLEFINE,0,Villecomtal(FR),0082,0024 FR VALLET (DC),8237,3280,3280,2598,682,682,0,0,-4957,60.179677066893284,1211,771,771,485,286,286,0,0,-440,36.33360858794385,100.0,62.905317769130995,37.094682230869005,100.0,79.20731707317074,20.792682926829258,Qualité
447,1,2019-01-25,130581,TAILLEFINE FRT PANACHE 125X16 OD,1,0,0,TAILLEFINE,0,Villecomtal(FR),0082,0024 FR VALLET (DC),8237,3280,3280,2598,682,682,0,0,-4957,60.179677066893284,1211,771,771,485,286,286,0,0,-440,36.33360858794385,100.0,62.905317769130995,37.094682230869005,100.0,79.20731707317074,20.792682926829258,Qualité
448,0,2019-01-25,130581,TAILLEFINE FRT PANACHE 125X16 OD,1,0,0,TAILLEFINE,0,Villecomtal(FR),0077,0024 FR LILPARK (DC),8237,3280,3280,2598,682,682,0,0,-4957,60.179677066893284,172,107,107,107,0,0,0,0,-65,37.7906976744186,100.0,100.0,0.0,100.0,79.20731707317074,20.792682926829258,Qualité
449,0,2019-01-25,130581,TAILLEFINE FRT PANACHE 125X16 OD,1,0,0,TAILLEFINE,0,Villecomtal(FR),0085,0024 FR TOULOUSE (DC),8237,3280,3280,2598,682,682,0,0,-4957,60.179677066893284,1048,670,670,670,0,0,0,0,-378,36.06870229007634,100.0,100.0,0.0,100.0,79.20731707317074,20.792682926829258,Qualité
450,0,2019-01-25,130581,TAILLEFINE FRT PANACHE 125X16 OD,1,0,0,TAILLEFINE,0,Villecomtal(FR),0083,0024 FR CHAPONNAY (DC),8237,3280,3280,2598,682,682,0,0,-4957,60.179677066893284,154,126,126,126,0,0,0,0,-28,18.181818181818183,100.0,100.0,0.0,100.0,79.20731707317074,20.792682926829258,Qualité
451,0,2019-01-25,130581,TAILLEFINE FRT PANACHE 125X16 OD,1,0,0,TAILLEFINE,0,Villecomtal(FR),0079,0024 FR PARIS SUD (DC),8237,3280,3280,2598,682,682,0,0,-4957,60.179677066893284,39,121,121,121,0,0,0,0,82,-210.25641025641025,100.0,100.0,0.0,100.0,79.20731707317074,20.792682926829258,Qualité
452,1,2019-01-25,131479,ACTIVIA FRT MANGO 125X4 OD,1,0,0,ACTIVIA,0,Villecomtal(FR),0080,0024 FR METZ (DC),105,2285,2285,2209,76,76,0,0,2180,-2076.190476190476,105,142,142,66,76,76,0,0,37,-35.23809523809524,100.0,46.478873239436616,53.521126760563384,100.0,96.67396061269147,3.3260393873085263,Transport
453,0,2019-01-25,134010,VELOUTE FRUIX PANACHE 125X16 OD,1,0,0,VELOUTE,0,Villecomtal(FR),0080,0024 FR METZ (DC),273,1348,1096,691,405,657,252,0,1075,-393.7728937728938,91,98,98,76,22,22,0,0,7,-7.6923076923076925,100.0,77.55102040816327,22.448979591836732,81.30563798219585,51.261127596439174,30.044510385756674,Previsions
454,0,2019-01-25,134010,VELOUTE FRUIX PANACHE 125X16 OD,1,0,0,VELOUTE,0,Villecomtal(FR),0077,0024 FR LILPARK (DC),273,1348,1096,691,405,657,252,0,1075,-393.7728937728938,86,291,124,124,0,167,167,0,205,-238.37209302325581,42.61168384879725,42.61168384879725,0.0,81.30563798219585,51.261127596439174,30.044510385756674,Previsions
455,0,2019-01-25,134010,VELOUTE FRUIX PANACHE 125X16 OD,1,0,0,VELOUTE,0,Villecomtal(FR),0083,0024 FR CHAPONNAY (DC),273,1348,1096,691,405,657,252,0,1075,-393.7728937728938,30,104,19,19,0,85,85,0,74,-246.66666666666666,18.269230769230766,18.269230769230766,0.0,81.30563798219585,51.261127596439174,30.044510385756674,Previsions
456,0,2019-01-25,134010,VELOUTE FRUIX PANACHE 125X16 OD,1,0,0,VELOUTE,0,Villecomtal(FR),0079,0024 FR PARIS SUD (DC),273,1348,1096,691,405,657,252,0,1075,-393.7728937728938,66,855,855,472,383,383,0,0,789,-1195.4545454545455,100.0,55.2046783625731,44.7953216374269,81.30563798219585,51.261127596439174,30.044510385756674,Previsions
457,1,2019-01-25,136435,ACTIVIA FRUITS MYRTILLE 125X4 OD,1,0,0,ACTIVIA,0,Villecomtal(FR),0080,0024 FR METZ (DC),115,1687,1687,1605,82,82,0,0,1572,-1366.9565217391305,115,147,147,65,82,82,0,0,32,-27.82608695652174,100.0,44.21768707482993,55.78231292517007,100.0,95.1393005334914,4.860699466508606,Transport
458,0,2019-01-25,140280,Activia chia/raspb/muesli 170g FR-copack,0,0,0,ACTIVIA,1,Roumanie(RO),0080,0024 FR METZ (DC),1481,591,194,93,101,498,397,0,-890,60.094530722484805,494,78,63,0,63,78,15,0,-416,84.21052631578948,80.76923076923077,0.0,80.76923076923077,32.82571912013537,15.736040609137056,17.08967851099831,Transport
459,0,2019-01-25,140280,Activia chia/raspb/muesli 170g FR-copack,0,0,0,ACTIVIA,1,Roumanie(RO),0082,0024 FR VALLET (DC),1481,591,194,93,101,498,397,0,-890,60.094530722484805,46,73,19,19,0,54,54,0,27,-58.69565217391305,26.027397260273972,26.027397260273972,0.0,32.82571912013537,15.736040609137056,17.08967851099831,Transport
460,0,2019-01-25,140280,Activia chia/raspb/muesli 170g FR-copack,0,0,0,ACTIVIA,1,Roumanie(RO),0077,0024 FR LILPARK (DC),1481,591,194,93,101,498,397,0,-890,60.094530722484805,593,49,32,32,0,17,17,0,-544,91.73693086003372,65.3061224489796,65.3061224489796,0.0,32.82571912013537,15.736040609137056,17.08967851099831,Transport
461,0,2019-01-25,140280,Activia chia/raspb/muesli 170g FR-copack,0,0,0,ACTIVIA,1,Roumanie(RO),0085,0024 FR TOULOUSE (DC),1481,591,194,93,101,498,397,0,-890,60.094530722484805,58,51,11,9,2,42,40,0,-7,12.068965517241379,21.568627450980394,17.647058823529413,3.9215686274509807,32.82571912013537,15.736040609137056,17.08967851099831,Transport
462,0,2019-01-25,140280,Activia chia/raspb/muesli 170g FR-copack,0,0,0,ACTIVIA,1,Roumanie(RO),0083,0024 FR CHAPONNAY (DC),1481,591,194,93,101,498,397,0,-890,60.094530722484805,133,74,24,0,24,74,50,0,-59,44.3609022556391,32.432432432432435,0.0,32.432432432432435,32.82571912013537,15.736040609137056,17.08967851099831,Transport
463,0,2019-01-25,140280,Activia chia/raspb/muesli 170g FR-copack,0,0,0,ACTIVIA,1,Roumanie(RO),0079,0024 FR PARIS SUD (DC),1481,591,194,93,101,498,397,0,-890,60.094530722484805,60,71,38,33,5,38,33,0,11,-18.333333333333332,53.52112676056338,46.478873239436616,7.04225352112676,32.82571912013537,15.736040609137056,17.08967851099831,Transport
464,0,2019-01-25,140280,Activia chia/raspb/muesli 170g FR-copack,0,0,0,ACTIVIA,1,Roumanie(RO),0078,0024 FR PARIS NORD (DC),1481,591,194,93,101,498,397,0,-890,60.094530722484805,97,195,7,0,7,195,188,0,98,-101.03092783505154,3.5897435897435894,0.0,3.5897435897435894,32.82571912013537,15.736040609137056,17.08967851099831,Transport
465,0,2019-01-26,32278,LES 2 VACHES 0% NATURE 115X4,0,0,0,LES 2 VACHES,0,LeMolay(FR),0084,0024 FR AIX (DC),128,114,52,8,44,106,62,0,-14,10.9375,4,34,34,0,34,34,0,0,30,-750.0,100.0,0.0,100.0,45.614035087719294,7.017543859649122,38.59649122807017,Qualité
466,0,2019-01-26,32278,LES 2 VACHES 0% NATURE 115X4,0,0,0,LES 2 VACHES,0,LeMolay(FR),0080,0024 FR METZ (DC),128,114,52,8,44,106,62,0,-14,10.9375,6,2,2,2,0,0,0,0,-4,66.66666666666667,100.0,100.0,0.0,45.614035087719294,7.017543859649122,38.59649122807017,Qualité
467,0,2019-01-26,32278,LES 2 VACHES 0% NATURE 115X4,0,0,0,LES 2 VACHES,0,LeMolay(FR),0082,0024 FR VALLET (DC),128,114,52,8,44,106,62,0,-14,10.9375,34,19,8,0,8,19,11,0,-15,44.11764705882353,42.10526315789473,0.0,42.10526315789473,45.614035087719294,7.017543859649122,38.59649122807017,Qualité
468,0,2019-01-26,32278,LES 2 VACHES 0% NATURE 115X4,0,0,0,LES 2 VACHES,0,LeMolay(FR),0085,0024 FR TOULOUSE (DC),128,114,52,8,44,106,62,0,-14,10.9375,21,12,1,1,0,11,11,0,-9,42.857142857142854,8.333333333333332,8.333333333333332,0.0,45.614035087719294,7.017543859649122,38.59649122807017,Qualité
469,0,2019-01-26,32278,LES 2 VACHES 0% NATURE 115X4,0,0,0,LES 2 VACHES,0,LeMolay(FR),0083,0024 FR CHAPONNAY (DC),128,114,52,8,44,106,62,0,-14,10.9375,39,30,2,0,2,30,28,0,-9,23.076923076923077,6.666666666666667,0.0,6.666666666666667,45.614035087719294,7.017543859649122,38.59649122807017,Qualité
470,0,2019-01-26,32278,LES 2 VACHES 0% NATURE 115X4,0,0,0,LES 2 VACHES,0,LeMolay(FR),0078,0024 FR PARIS NORD (DC),128,114,52,8,44,106,62,0,-14,10.9375,24,17,5,5,0,12,12,0,-7,29.166666666666668,29.411764705882355,29.411764705882355,0.0,45.614035087719294,7.017543859649122,38.59649122807017,Qualité
471,0,2019-01-26,120168,VELOUTE FRUIX PANACHE 125X16,0,0,0,VELOUTE,0,Villecomtal(FR),0084,0024 FR AIX (DC),9107,7782,7444,6885,559,897,338,0,-1325,14.549247831338532,548,515,515,515,0,0,0,0,-33,6.021897810218978,100.0,100.0,0.0,95.65664353636598,88.47340015420201,7.183243382163965,Qualité
472,0,2019-01-26,120168,VELOUTE FRUIX PANACHE 125X16,0,0,0,VELOUTE,0,Villecomtal(FR),0080,0024 FR METZ (DC),9107,7782,7444,6885,559,897,338,0,-1325,14.549247831338532,441,382,382,382,0,0,0,0,-59,13.378684807256235,100.0,100.0,0.0,95.65664353636598,88.47340015420201,7.183243382163965,Qualité
473,0,2019-01-26,120168,VELOUTE FRUIX PANACHE 125X16,0,0,0,VELOUTE,0,Villecomtal(FR),0081,0024 FR TOURS (DC),9107,7782,7444,6885,559,897,338,0,-1325,14.549247831338532,1543,1269,1269,1269,0,0,0,0,-274,17.757615035644847,100.0,100.0,0.0,95.65664353636598,88.47340015420201,7.183243382163965,Qualité
474,0,2019-01-26,120168,VELOUTE FRUIX PANACHE 125X16,0,0,0,VELOUTE,0,Villecomtal(FR),0082,0024 FR VALLET (DC),9107,7782,7444,6885,559,897,338,0,-1325,14.549247831338532,774,586,586,586,0,0,0,0,-188,24.289405684754524,100.0,100.0,0.0,95.65664353636598,88.47340015420201,7.183243382163965,Qualité
475,0,2019-01-26,120168,VELOUTE FRUIX PANACHE 125X16,0,0,0,VELOUTE,0,Villecomtal(FR),0077,0024 FR LILPARK (DC),9107,7782,7444,6885,559,897,338,0,-1325,14.549247831338532,749,904,742,183,559,721,162,0,155,-20.694259012016023,82.07964601769912,20.24336283185841,61.83628318584071,95.65664353636598,88.47340015420201,7.183243382163965,Qualité
476,0,2019-01-26,120168,VELOUTE FRUIX PANACHE 125X16,0,0,0,VELOUTE,0,Villecomtal(FR),0085,0024 FR TOULOUSE (DC),9107,7782,7444,6885,559,897,338,0,-1325,14.549247831338532,894,877,701,701,0,176,176,0,-17,1.9015659955257271,79.93158494868872,79.93158494868872,0.0,95.65664353636598,88.47340015420201,7.183243382163965,Qualité
477,0,2019-01-26,120168,VELOUTE FRUIX PANACHE 125X16,0,0,0,VELOUTE,0,Villecomtal(FR),0083,0024 FR CHAPONNAY (DC),9107,7782,7444,6885,559,897,338,0,-1325,14.549247831338532,1828,1311,1311,1311,0,0,0,0,-517,28.282275711159738,100.0,100.0,0.0,95.65664353636598,88.47340015420201,7.183243382163965,Qualité
478,0,2019-01-26,120168,VELOUTE FRUIX PANACHE 125X16,0,0,0,VELOUTE,0,Villecomtal(FR),0079,0024 FR PARIS SUD (DC),9107,7782,7444,6885,559,897,338,0,-1325,14.549247831338532,1170,974,974,974,0,0,0,0,-196,16.752136752136753,100.0,100.0,0.0,95.65664353636598,88.47340015420201,7.183243382163965,Qualité
479,0,2019-01-26,120168,VELOUTE FRUIX PANACHE 125X16,0,0,0,VELOUTE,0,Villecomtal(FR),0078,0024 FR PARIS NORD (DC),9107,7782,7444,6885,559,897,338,0,-1325,14.549247831338532,1160,964,964,964,0,0,0,0,-196,16.896551724137932,100.0,100.0,0.0,95.65664353636598,88.47340015420201,7.183243382163965,Qualité
480,1,2019-01-26,121523,TAILLEFINE FRT RASPBERRY 125X4,0,0,0,TAILLEFINE,0,Villecomtal(FR),0084,0024 FR AIX (DC),19,752,752,700,52,52,0,0,733,-3857.8947368421054,19,118,118,70,48,48,0,0,99,-521.0526315789474,100.0,59.32203389830508,40.67796610169492,100.0,93.08510638297872,6.914893617021278,Previsions
481,0,2019-01-26,127086,DANONE SKYR 140X2,0,0,0,DANONE,0,Ferrières(FR),0084,0024 FR AIX (DC),3512,2744,1485,654,831,2090,1259,0,-768,21.867881548974943,19,244,191,191,0,53,53,0,225,-1184.2105263157894,78.27868852459017,78.27868852459017,0.0,54.118075801749264,23.833819241982507,30.284256559766757,Production
482,0,2019-01-26,127086,DANONE SKYR 140X2,0,0,0,DANONE,0,Ferrières(FR),0080,0024 FR METZ (DC),3512,2744,1485,654,831,2090,1259,0,-768,21.867881548974943,109,119,119,42,77,77,0,0,10,-9.174311926605505,100.0,35.294117647058826,64.70588235294117,54.118075801749264,23.833819241982507,30.284256559766757,Production
483,0,2019-01-26,127086,DANONE SKYR 140X2,0,0,0,DANONE,0,Ferrières(FR),0081,0024 FR TOURS (DC),3512,2744,1485,654,831,2090,1259,0,-768,21.867881548974943,226,287,24,20,4,267,263,0,61,-26.991150442477878,8.362369337979095,6.968641114982578,1.3937282229965167,54.118075801749264,23.833819241982507,30.284256559766757,Production
484,0,2019-01-26,127086,DANONE SKYR 140X2,0,0,0,DANONE,0,Ferrières(FR),0082,0024 FR VALLET (DC),3512,2744,1485,654,831,2090,1259,0,-768,21.867881548974943,309,354,354,0,354,354,0,0,45,-14.563106796116505,100.0,0.0,100.0,54.118075801749264,23.833819241982507,30.284256559766757,Production
485,1,2019-01-26,127086,DANONE SKYR 140X2,0,0,0,DANONE,0,Ferrières(FR),0082,0024 FR VALLET (DC),3512,2744,1485,654,831,2090,1259,0,-768,21.867881548974943,309,354,354,0,354,354,0,0,45,-14.563106796116505,100.0,0.0,100.0,54.118075801749264,23.833819241982507,30.284256559766757,Production
486,0,2019-01-26,127086,DANONE SKYR 140X2,0,0,0,DANONE,0,Ferrières(FR),0077,0024 FR LILPARK (DC),3512,2744,1485,654,831,2090,1259,0,-768,21.867881548974943,328,252,252,60,192,192,0,0,-76,23.170731707317074,100.0,23.809523809523807,76.19047619047619,54.118075801749264,23.833819241982507,30.284256559766757,Production
487,0,2019-01-26,127086,DANONE SKYR 140X2,0,0,0,DANONE,0,Ferrières(FR),0085,0024 FR TOULOUSE (DC),3512,2744,1485,654,831,2090,1259,0,-768,21.867881548974943,324,266,224,39,185,227,42,0,-58,17.901234567901234,84.21052631578947,14.661654135338345,69.54887218045113,54.118075801749264,23.833819241982507,30.284256559766757,Production
488,1,2019-01-26,127086,DANONE SKYR 140X2,0,0,0,DANONE,0,Ferrières(FR),0085,0024 FR TOULOUSE (DC),3512,2744,1485,654,831,2090,1259,0,-768,21.867881548974943,324,266,224,39,185,227,42,0,-58,17.901234567901234,84.21052631578947,14.661654135338345,69.54887218045113,54.118075801749264,23.833819241982507,30.284256559766757,Production
489,0,2019-01-26,127086,DANONE SKYR 140X2,0,0,0,DANONE,0,Ferrières(FR),0083,0024 FR CHAPONNAY (DC),3512,2744,1485,654,831,2090,1259,0,-768,21.867881548974943,364,345,148,146,2,199,197,0,-19,5.21978021978022,42.89855072463768,42.31884057971014,0.5797101449275388,54.118075801749264,23.833819241982507,30.284256559766757,Production
490,0,2019-01-26,127086,DANONE SKYR 140X2,0,0,0,DANONE,0,Ferrières(FR),0079,0024 FR PARIS SUD (DC),3512,2744,1485,654,831,2090,1259,0,-768,21.867881548974943,344,389,156,156,0,233,233,0,45,-13.081395348837209,40.102827763496144,40.102827763496144,0.0,54.118075801749264,23.833819241982507,30.284256559766757,Production
491,0,2019-01-26,127086,DANONE SKYR 140X2,0,0,0,DANONE,0,Ferrières(FR),0078,0024 FR PARIS NORD (DC),3512,2744,1485,654,831,2090,1259,0,-768,21.867881548974943,428,488,17,0,17,488,471,0,60,-14.018691588785046,3.483606557377049,0.0,3.483606557377049,54.118075801749264,23.833819241982507,30.284256559766757,Production
492,1,2019-01-26,127086,DANONE SKYR 140X2,0,0,0,DANONE,0,Ferrières(FR),0078,0024 FR PARIS NORD (DC),3512,2744,1485,654,831,2090,1259,0,-768,21.867881548974943,428,488,17,0,17,488,471,0,60,-14.018691588785046,3.483606557377049,0.0,3.483606557377049,54.118075801749264,23.833819241982507,30.284256559766757,Production
493,0,2019-01-26,134010,VELOUTE FRUIX PANACHE 125X16 OD,1,0,0,VELOUTE,0,Villecomtal(FR),0080,0024 FR METZ (DC),264,1092,566,358,208,734,526,0,828,-313.6363636363636,89,256,256,54,202,202,0,0,167,-187.64044943820224,100.0,21.09375,78.90625,51.83150183150184,32.78388278388278,19.047619047619058,Previsions
494,0,2019-01-26,134010,VELOUTE FRUIX PANACHE 125X16 OD,1,0,0,VELOUTE,0,Villecomtal(FR),0077,0024 FR LILPARK (DC),264,1092,566,358,208,734,526,0,828,-313.6363636363636,86,163,163,163,0,0,0,0,77,-89.53488372093024,100.0,100.0,0.0,51.83150183150184,32.78388278388278,19.047619047619058,Previsions
495,0,2019-01-26,134010,VELOUTE FRUIX PANACHE 125X16 OD,1,0,0,VELOUTE,0,Villecomtal(FR),0083,0024 FR CHAPONNAY (DC),264,1092,566,358,208,734,526,0,828,-313.6363636363636,30,45,17,17,0,28,28,0,15,-50.0,37.77777777777778,37.77777777777778,0.0,51.83150183150184,32.78388278388278,19.047619047619058,Previsions
496,0,2019-01-26,134010,VELOUTE FRUIX PANACHE 125X16 OD,1,0,0,VELOUTE,0,Villecomtal(FR),0079,0024 FR PARIS SUD (DC),264,1092,566,358,208,734,526,0,828,-313.6363636363636,59,628,130,124,6,504,498,0,569,-964.4067796610169,20.70063694267516,19.745222929936308,0.9554140127388528,51.83150183150184,32.78388278388278,19.047619047619058,Previsions
497,0,2019-01-26,140280,Activia chia/raspb/muesli 170g FR-copack,0,0,0,ACTIVIA,1,Roumanie(RO),0084,0024 FR AIX (DC),465,747,747,114,633,633,0,0,282,-60.645161290322584,68,116,116,0,116,116,0,0,48,-70.58823529411765,100.0,0.0,100.0,100.0,15.261044176706829,84.73895582329317,Transport
498,0,2019-01-26,140280,Activia chia/raspb/muesli 170g FR-copack,0,0,0,ACTIVIA,1,Roumanie(RO),0080,0024 FR METZ (DC),465,747,747,114,633,633,0,0,282,-60.645161290322584,41,46,46,0,46,46,0,0,5,-12.195121951219512,100.0,0.0,100.0,100.0,15.261044176706829,84.73895582329317,Transport
499,0,2019-01-26,140280,Activia chia/raspb/muesli 170g FR-copack,0,0,0,ACTIVIA,1,Roumanie(RO),0081,0024 FR TOURS (DC),465,747,747,114,633,633,0,0,282,-60.645161290322584,72,113,113,0,113,113,0,0,41,-56.94444444444444,100.0,0.0,100.0,100.0,15.261044176706829,84.73895582329317,Transport
500,0,2019-01-26,140280,Activia chia/raspb/muesli 170g FR-copack,0,0,0,ACTIVIA,1,Roumanie(RO),0082,0024 FR VALLET (DC),465,747,747,114,633,633,0,0,282,-60.645161290322584,66,51,51,0,51,51,0,0,-15,22.727272727272727,100.0,0.0,100.0,100.0,15.261044176706829,84.73895582329317,Transport
501,0,2019-01-26,140280,Activia chia/raspb/muesli 170g FR-copack,0,0,0,ACTIVIA,1,Roumanie(RO),0077,0024 FR LILPARK (DC),465,747,747,114,633,633,0,0,282,-60.645161290322584,35,86,86,0,86,86,0,0,51,-145.71428571428572,100.0,0.0,100.0,100.0,15.261044176706829,84.73895582329317,Transport
502,0,2019-01-26,140280,Activia chia/raspb/muesli 170g FR-copack,0,0,0,ACTIVIA,1,Roumanie(RO),0085,0024 FR TOULOUSE (DC),465,747,747,114,633,633,0,0,282,-60.645161290322584,7,81,81,0,81,81,0,0,74,-1057.142857142857,100.0,0.0,100.0,100.0,15.261044176706829,84.73895582329317,Transport
503,0,2019-01-26,140280,Activia chia/raspb/muesli 170g FR-copack,0,0,0,ACTIVIA,1,Roumanie(RO),0083,0024 FR CHAPONNAY (DC),465,747,747,114,633,633,0,0,282,-60.645161290322584,61,114,114,114,0,0,0,0,53,-86.88524590163935,100.0,100.0,0.0,100.0,15.261044176706829,84.73895582329317,Transport
504,0,2019-01-26,140280,Activia chia/raspb/muesli 170g FR-copack,0,0,0,ACTIVIA,1,Roumanie(RO),0079,0024 FR PARIS SUD (DC),465,747,747,114,633,633,0,0,282,-60.645161290322584,57,67,67,0,67,67,0,0,10,-17.54385964912281,100.0,0.0,100.0,100.0,15.261044176706829,84.73895582329317,Transport
505,0,2019-01-26,140280,Activia chia/raspb/muesli 170g FR-copack,0,0,0,ACTIVIA,1,Roumanie(RO),0078,0024 FR PARIS NORD (DC),465,747,747,114,633,633,0,0,282,-60.645161290322584,58,73,73,0,73,73,0,0,15,-25.862068965517242,100.0,0.0,100.0,100.0,15.261044176706829,84.73895582329317,Transport
506,1,2019-01-26,142609,ACTIMEL NATURE 4x(8+4x100g) FR,1,1,0,ACTIMEL,1,Rotselaar(BE),0079,0024 FR PARIS SUD (DC),625,1528,1528,1528,0,0,0,0,903,-144.48,625,357,357,357,0,0,0,0,-268,42.88,100.0,100.0,0.0,100.0,100.0,0.0,Production
507,0,2019-01-26,142615,ACTIMEL STRAWBERRY 4x(8+4x100g) FR,1,1,0,ACTIMEL,1,Rotselaar(BE),0084,0024 FR AIX (DC),3397,1923,1747,1264,483,659,176,0,-1474,43.39122755372387,315,114,114,108,6,6,0,0,-201,63.80952380952381,100.0,94.73684210526315,5.26315789473685,90.84763390535622,65.730629225169,25.11700468018722,Production
508,0,2019-01-26,142615,ACTIMEL STRAWBERRY 4x(8+4x100g) FR,1,1,0,ACTIMEL,1,Rotselaar(BE),0080,0024 FR METZ (DC),3397,1923,1747,1264,483,659,176,0,-1474,43.39122755372387,251,116,116,116,0,0,0,0,-135,53.78486055776892,100.0,100.0,0.0,90.84763390535622,65.730629225169,25.11700468018722,Production
509,0,2019-01-26,142615,ACTIMEL STRAWBERRY 4x(8+4x100g) FR,1,1,0,ACTIMEL,1,Rotselaar(BE),0081,0024 FR TOURS (DC),3397,1923,1747,1264,483,659,176,0,-1474,43.39122755372387,206,177,121,121,0,56,56,0,-29,14.077669902912621,68.36158192090396,68.36158192090396,0.0,90.84763390535622,65.730629225169,25.11700468018722,Production
510,0,2019-01-26,142615,ACTIMEL STRAWBERRY 4x(8+4x100g) FR,1,1,0,ACTIMEL,1,Rotselaar(BE),0077,0024 FR LILPARK (DC),3397,1923,1747,1264,483,659,176,0,-1474,43.39122755372387,763,477,477,0,477,477,0,0,-286,37.48361730013106,100.0,0.0,100.0,90.84763390535622,65.730629225169,25.11700468018722,Production
511,1,2019-01-26,142615,ACTIMEL STRAWBERRY 4x(8+4x100g) FR,1,1,0,ACTIMEL,1,Rotselaar(BE),0077,0024 FR LILPARK (DC),3397,1923,1747,1264,483,659,176,0,-1474,43.39122755372387,763,477,477,0,477,477,0,0,-286,37.48361730013106,100.0,0.0,100.0,90.84763390535622,65.730629225169,25.11700468018722,Production
512,0,2019-01-26,142615,ACTIMEL STRAWBERRY 4x(8+4x100g) FR,1,1,0,ACTIMEL,1,Rotselaar(BE),0085,0024 FR TOULOUSE (DC),3397,1923,1747,1264,483,659,176,0,-1474,43.39122755372387,166,113,113,113,0,0,0,0,-53,31.927710843373493,100.0,100.0,0.0,90.84763390535622,65.730629225169,25.11700468018722,Production
513,0,2019-01-26,142615,ACTIMEL STRAWBERRY 4x(8+4x100g) FR,1,1,0,ACTIMEL,1,Rotselaar(BE),0083,0024 FR CHAPONNAY (DC),3397,1923,1747,1264,483,659,176,0,-1474,43.39122755372387,302,104,104,104,0,0,0,0,-198,65.56291390728477,100.0,100.0,0.0,90.84763390535622,65.730629225169,25.11700468018722,Production
514,0,2019-01-26,142615,ACTIMEL STRAWBERRY 4x(8+4x100g) FR,1,1,0,ACTIMEL,1,Rotselaar(BE),0079,0024 FR PARIS SUD (DC),3397,1923,1747,1264,483,659,176,0,-1474,43.39122755372387,74,505,385,385,0,120,120,0,431,-582.4324324324324,76.23762376237624,76.23762376237624,0.0,90.84763390535622,65.730629225169,25.11700468018722,Production
515,0,2019-01-26,142615,ACTIMEL STRAWBERRY 4x(8+4x100g) FR,1,1,0,ACTIMEL,1,Rotselaar(BE),0078,0024 FR PARIS NORD (DC),3397,1923,1747,1264,483,659,176,0,-1474,43.39122755372387,557,317,317,317,0,0,0,0,-240,43.08797127468582,100.0,100.0,0.0,90.84763390535622,65.730629225169,25.11700468018722,Production
516,0,2019-01-28,32278,LES 2 VACHES 0% NATURE 115X4,0,0,0,LES 2 VACHES,0,LeMolay(FR),0080,0024 FR METZ (DC),256,350,181,178,3,172,169,0,94,-36.71875,4,26,26,26,0,0,0,0,22,-550.0,100.0,100.0,0.0,51.714285714285715,50.857142857142854,0.8571428571428612,Previsions
517,0,2019-01-28,32278,LES 2 VACHES 0% NATURE 115X4,0,0,0,LES 2 VACHES,0,LeMolay(FR),0081,0024 FR TOURS (DC),256,350,181,178,3,172,169,0,94,-36.71875,35,26,3,0,3,26,23,0,-9,25.714285714285715,11.538461538461538,0.0,11.538461538461538,51.714285714285715,50.857142857142854,0.8571428571428612,Previsions
518,0,2019-01-28,32278,LES 2 VACHES 0% NATURE 115X4,0,0,0,LES 2 VACHES,0,LeMolay(FR),0079,0024 FR PARIS SUD (DC),256,350,181,178,3,172,169,0,94,-36.71875,178,264,151,151,0,113,113,0,86,-48.31460674157304,57.1969696969697,57.1969696969697,0.0,51.714285714285715,50.857142857142854,0.8571428571428612,Previsions
519,0,2019-01-28,32278,LES 2 VACHES 0% NATURE 115X4,0,0,0,LES 2 VACHES,0,LeMolay(FR),0078,0024 FR PARIS NORD (DC),256,350,181,178,3,172,169,0,94,-36.71875,39,34,1,1,0,33,33,0,-5,12.820512820512821,2.941176470588235,2.941176470588235,0.0,51.714285714285715,50.857142857142854,0.8571428571428612,Previsions
520,0,2019-01-28,79537,LES 2 VACHES FLAN BIO 100X4,0,0,0,LES 2 VACHES,0,LeMolay(FR),0084,0024 FR AIX (DC),1110,1669,1669,1669,0,0,0,0,559,-50.36036036036036,104,519,519,519,0,0,0,0,415,-399.03846153846155,100.0,100.0,0.0,100.0,100.0,0.0,Previsions
521,0,2019-01-28,79537,LES 2 VACHES FLAN BIO 100X4,0,0,0,LES 2 VACHES,0,LeMolay(FR),0080,0024 FR METZ (DC),1110,1669,1669,1669,0,0,0,0,559,-50.36036036036036,146,211,211,211,0,0,0,0,65,-44.52054794520548,100.0,100.0,0.0,100.0,100.0,0.0,Previsions
522,0,2019-01-28,79537,LES 2 VACHES FLAN BIO 100X4,0,0,0,LES 2 VACHES,0,LeMolay(FR),0081,0024 FR TOURS (DC),1110,1669,1669,1669,0,0,0,0,559,-50.36036036036036,192,151,151,151,0,0,0,0,-41,21.354166666666668,100.0,100.0,0.0,100.0,100.0,0.0,Previsions
523,0,2019-01-28,79537,LES 2 VACHES FLAN BIO 100X4,0,0,0,LES 2 VACHES,0,LeMolay(FR),0082,0024 FR VALLET (DC),1110,1669,1669,1669,0,0,0,0,559,-50.36036036036036,78,134,134,134,0,0,0,0,56,-71.7948717948718,100.0,100.0,0.0,100.0,100.0,0.0,Previsions
524,0,2019-01-28,79537,LES 2 VACHES FLAN BIO 100X4,0,0,0,LES 2 VACHES,0,LeMolay(FR),0077,0024 FR LILPARK (DC),1110,1669,1669,1669,0,0,0,0,559,-50.36036036036036,73,70,70,70,0,0,0,0,-3,4.109589041095891,100.0,100.0,0.0,100.0,100.0,0.0,Previsions
525,0,2019-01-28,79537,LES 2 VACHES FLAN BIO 100X4,0,0,0,LES 2 VACHES,0,LeMolay(FR),0085,0024 FR TOULOUSE (DC),1110,1669,1669,1669,0,0,0,0,559,-50.36036036036036,16,166,166,166,0,0,0,0,150,-937.5,100.0,100.0,0.0,100.0,100.0,0.0,Previsions
526,0,2019-01-28,79537,LES 2 VACHES FLAN BIO 100X4,0,0,0,LES 2 VACHES,0,LeMolay(FR),0083,0024 FR CHAPONNAY (DC),1110,1669,1669,1669,0,0,0,0,559,-50.36036036036036,282,245,245,245,0,0,0,0,-37,13.120567375886525,100.0,100.0,0.0,100.0,100.0,0.0,Previsions
527,0,2019-01-28,79537,LES 2 VACHES FLAN BIO 100X4,0,0,0,LES 2 VACHES,0,LeMolay(FR),0079,0024 FR PARIS SUD (DC),1110,1669,1669,1669,0,0,0,0,559,-50.36036036036036,219,173,173,173,0,0,0,0,-46,21.004566210045663,100.0,100.0,0.0,100.0,100.0,0.0,Previsions
528,0,2019-01-28,123658,TAILLEFINE PLAISIRS CHOCO 100X4,0,0,0,TAILLEFINE,0,LeMolay(FR),0084,0024 FR AIX (DC),256,321,258,141,117,180,63,0,65,-25.390625,37,49,49,24,25,25,0,0,12,-32.432432432432435,100.0,48.97959183673469,51.02040816326531,80.37383177570094,43.925233644859816,36.44859813084112,Previsions
529,0,2019-01-28,123658,TAILLEFINE PLAISIRS CHOCO 100X4,0,0,0,TAILLEFINE,0,LeMolay(FR),0080,0024 FR METZ (DC),256,321,258,141,117,180,63,0,65,-25.390625,40,49,36,36,0,13,13,0,9,-22.5,73.46938775510205,73.46938775510205,0.0,80.37383177570094,43.925233644859816,36.44859813084112,Previsions
530,0,2019-01-28,123658,TAILLEFINE PLAISIRS CHOCO 100X4,0,0,0,TAILLEFINE,0,LeMolay(FR),0081,0024 FR TOURS (DC),256,321,258,141,117,180,63,0,65,-25.390625,13,24,6,6,0,18,18,0,11,-84.61538461538461,25.0,25.0,0.0,80.37383177570094,43.925233644859816,36.44859813084112,Previsions
531,0,2019-01-28,123658,TAILLEFINE PLAISIRS CHOCO 100X4,0,0,0,TAILLEFINE,0,LeMolay(FR),0082,0024 FR VALLET (DC),256,321,258,141,117,180,63,0,65,-25.390625,18,31,15,15,0,16,16,0,13,-72.22222222222223,48.38709677419355,48.38709677419355,0.0,80.37383177570094,43.925233644859816,36.44859813084112,Previsions
532,0,2019-01-28,123658,TAILLEFINE PLAISIRS CHOCO 100X4,0,0,0,TAILLEFINE,0,LeMolay(FR),0085,0024 FR TOULOUSE (DC),256,321,258,141,117,180,63,0,65,-25.390625,30,35,19,19,0,16,16,0,5,-16.666666666666668,54.285714285714285,54.285714285714285,0.0,80.37383177570094,43.925233644859816,36.44859813084112,Previsions
533,0,2019-01-28,123658,TAILLEFINE PLAISIRS CHOCO 100X4,0,0,0,TAILLEFINE,0,LeMolay(FR),0083,0024 FR CHAPONNAY (DC),256,321,258,141,117,180,63,0,65,-25.390625,49,41,41,29,12,12,0,0,-8,16.3265306122449,100.0,70.73170731707317,29.268292682926827,80.37383177570094,43.925233644859816,36.44859813084112,Previsions
534,0,2019-01-28,123658,TAILLEFINE PLAISIRS CHOCO 100X4,0,0,0,TAILLEFINE,0,LeMolay(FR),0079,0024 FR PARIS SUD (DC),256,321,258,141,117,180,63,0,65,-25.390625,39,48,48,12,36,36,0,0,9,-23.076923076923077,100.0,25.0,75.0,80.37383177570094,43.925233644859816,36.44859813084112,Previsions
535,0,2019-01-28,123658,TAILLEFINE PLAISIRS CHOCO 100X4,0,0,0,TAILLEFINE,0,LeMolay(FR),0078,0024 FR PARIS NORD (DC),256,321,258,141,117,180,63,0,65,-25.390625,30,44,44,0,44,44,0,0,14,-46.666666666666664,100.0,0.0,100.0,80.37383177570094,43.925233644859816,36.44859813084112,Previsions
536,0,2019-01-28,130581,TAILLEFINE FRT PANACHE 125X16 OD,1,0,0,TAILLEFINE,0,Villecomtal(FR),0084,0024 FR AIX (DC),3059,2317,2062,2027,35,290,255,0,-742,24.25629290617849,1204,689,687,671,16,18,2,0,-515,42.77408637873754,99.70972423802613,97.38751814223512,2.322206095791003,88.9943892965041,87.48381527837721,1.5105740181268885,Qualité
537,0,2019-01-28,130581,TAILLEFINE FRT PANACHE 125X16 OD,1,0,0,TAILLEFINE,0,Villecomtal(FR),0080,0024 FR METZ (DC),3059,2317,2062,2027,35,290,255,0,-742,24.25629290617849,604,395,142,142,0,253,253,0,-209,34.602649006622514,35.949367088607595,35.949367088607595,0.0,88.9943892965041,87.48381527837721,1.5105740181268885,Qualité
538,0,2019-01-28,130581,TAILLEFINE FRT PANACHE 125X16 OD,1,0,0,TAILLEFINE,0,Villecomtal(FR),0081,0024 FR TOURS (DC),3059,2317,2062,2027,35,290,255,0,-742,24.25629290617849,879,532,532,532,0,0,0,0,-347,39.47667804323095,100.0,100.0,0.0,88.9943892965041,87.48381527837721,1.5105740181268885,Qualité
539,0,2019-01-28,130581,TAILLEFINE FRT PANACHE 125X16 OD,1,0,0,TAILLEFINE,0,Villecomtal(FR),0082,0024 FR VALLET (DC),3059,2317,2062,2027,35,290,255,0,-742,24.25629290617849,50,431,431,412,19,19,0,0,381,-762.0,100.0,95.59164733178655,4.408352668213453,88.9943892965041,87.48381527837721,1.5105740181268885,Qualité
540,0,2019-01-28,130581,TAILLEFINE FRT PANACHE 125X16 OD,1,0,0,TAILLEFINE,0,Villecomtal(FR),0085,0024 FR TOULOUSE (DC),3059,2317,2062,2027,35,290,255,0,-742,24.25629290617849,14,25,25,25,0,0,0,0,11,-78.57142857142857,100.0,100.0,0.0,88.9943892965041,87.48381527837721,1.5105740181268885,Qualité
541,0,2019-01-28,130581,TAILLEFINE FRT PANACHE 125X16 OD,1,0,0,TAILLEFINE,0,Villecomtal(FR),0083,0024 FR CHAPONNAY (DC),3059,2317,2062,2027,35,290,255,0,-742,24.25629290617849,184,153,153,153,0,0,0,0,-31,16.847826086956523,100.0,100.0,0.0,88.9943892965041,87.48381527837721,1.5105740181268885,Qualité
542,0,2019-01-28,130581,TAILLEFINE FRT PANACHE 125X16 OD,1,0,0,TAILLEFINE,0,Villecomtal(FR),0079,0024 FR PARIS SUD (DC),3059,2317,2062,2027,35,290,255,0,-742,24.25629290617849,124,92,92,92,0,0,0,0,-32,25.806451612903224,100.0,100.0,0.0,88.9943892965041,87.48381527837721,1.5105740181268885,Qualité
543,1,2019-01-28,131479,ACTIVIA FRT MANGO 125X4 OD,1,0,0,ACTIVIA,0,Villecomtal(FR),0082,0024 FR VALLET (DC),146,960,918,865,53,95,42,0,814,-557.5342465753424,78,123,95,95,0,28,28,0,45,-57.69230769230769,77.23577235772358,77.23577235772358,0.0,95.625,90.10416666666666,5.520833333333343,Expe usine
544,1,2019-01-28,131479,ACTIVIA FRT MANGO 125X4 OD,1,0,0,ACTIVIA,0,Villecomtal(FR),0079,0024 FR PARIS SUD (DC),146,960,918,865,53,95,42,0,814,-557.5342465753424,68,109,95,47,48,62,14,0,41,-60.294117647058826,87.1559633027523,43.11926605504588,44.03669724770642,95.625,90.10416666666666,5.520833333333343,Previsions
545,0,2019-01-28,133904,DANONE BIO NATURE SUCRE 125X4,0,0,0,DANONE,0,Bailleul(FR),0084,0024 FR AIX (DC),701,1075,804,800,4,275,271,0,374,-53.352353780313834,80,18,18,18,0,0,0,0,-62,77.5,100.0,100.0,0.0,74.79069767441861,74.4186046511628,0.3720930232558146,Previsions
546,0,2019-01-28,133904,DANONE BIO NATURE SUCRE 125X4,0,0,0,DANONE,0,Bailleul(FR),0080,0024 FR METZ (DC),701,1075,804,800,4,275,271,0,374,-53.352353780313834,33,59,59,59,0,0,0,0,26,-78.78787878787878,100.0,100.0,0.0,74.79069767441861,74.4186046511628,0.3720930232558146,Previsions
547,0,2019-01-28,133904,DANONE BIO NATURE SUCRE 125X4,0,0,0,DANONE,0,Bailleul(FR),0081,0024 FR TOURS (DC),701,1075,804,800,4,275,271,0,374,-53.352353780313834,224,170,170,170,0,0,0,0,-54,24.107142857142858,100.0,100.0,0.0,74.79069767441861,74.4186046511628,0.3720930232558146,Previsions
548,0,2019-01-28,133904,DANONE BIO NATURE SUCRE 125X4,0,0,0,DANONE,0,Bailleul(FR),0082,0024 FR VALLET (DC),701,1075,804,800,4,275,271,0,374,-53.352353780313834,65,80,80,80,0,0,0,0,15,-23.076923076923077,100.0,100.0,0.0,74.79069767441861,74.4186046511628,0.3720930232558146,Previsions
549,0,2019-01-28,133904,DANONE BIO NATURE SUCRE 125X4,0,0,0,DANONE,0,Bailleul(FR),0077,0024 FR LILPARK (DC),701,1075,804,800,4,275,271,0,374,-53.352353780313834,52,65,65,65,0,0,0,0,13,-25.0,100.0,100.0,0.0,74.79069767441861,74.4186046511628,0.3720930232558146,Previsions
550,0,2019-01-28,133904,DANONE BIO NATURE SUCRE 125X4,0,0,0,DANONE,0,Bailleul(FR),0085,0024 FR TOULOUSE (DC),701,1075,804,800,4,275,271,0,374,-53.352353780313834,7,33,33,33,0,0,0,0,26,-371.42857142857144,100.0,100.0,0.0,74.79069767441861,74.4186046511628,0.3720930232558146,Previsions
551,0,2019-01-28,133904,DANONE BIO NATURE SUCRE 125X4,0,0,0,DANONE,0,Bailleul(FR),0083,0024 FR CHAPONNAY (DC),701,1075,804,800,4,275,271,0,374,-53.352353780313834,79,140,140,140,0,0,0,0,61,-77.21518987341773,100.0,100.0,0.0,74.79069767441861,74.4186046511628,0.3720930232558146,Previsions
552,0,2019-01-28,133904,DANONE BIO NATURE SUCRE 125X4,0,0,0,DANONE,0,Bailleul(FR),0079,0024 FR PARIS SUD (DC),701,1075,804,800,4,275,271,0,374,-53.352353780313834,26,19,19,19,0,0,0,0,-7,26.923076923076923,100.0,100.0,0.0,74.79069767441861,74.4186046511628,0.3720930232558146,Previsions
553,0,2019-01-28,133904,DANONE BIO NATURE SUCRE 125X4,0,0,0,DANONE,0,Bailleul(FR),0078,0024 FR PARIS NORD (DC),701,1075,804,800,4,275,271,0,374,-53.352353780313834,135,491,220,216,4,275,271,0,356,-263.7037037037037,44.806517311608964,43.9918533604888,0.814663951120167,74.79069767441861,74.4186046511628,0.3720930232558146,Previsions
554,0,2019-01-29,79537,LES 2 VACHES FLAN BIO 100X4,0,0,0,LES 2 VACHES,0,LeMolay(FR),0084,0024 FR AIX (DC),766,1720,1278,1278,0,442,442,0,954,-124.54308093994779,23,238,238,238,0,0,0,0,215,-934.7826086956521,100.0,100.0,0.0,74.30232558139535,74.30232558139535,0.0,Previsions
555,0,2019-01-29,79537,LES 2 VACHES FLAN BIO 100X4,0,0,0,LES 2 VACHES,0,LeMolay(FR),0080,0024 FR METZ (DC),766,1720,1278,1278,0,442,442,0,954,-124.54308093994779,86,79,79,79,0,0,0,0,-7,8.13953488372093,100.0,100.0,0.0,74.30232558139535,74.30232558139535,0.0,Previsions
556,0,2019-01-29,79537,LES 2 VACHES FLAN BIO 100X4,0,0,0,LES 2 VACHES,0,LeMolay(FR),0081,0024 FR TOURS (DC),766,1720,1278,1278,0,442,442,0,954,-124.54308093994779,13,106,106,106,0,0,0,0,93,-715.3846153846154,100.0,100.0,0.0,74.30232558139535,74.30232558139535,0.0,Previsions
557,0,2019-01-29,79537,LES 2 VACHES FLAN BIO 100X4,0,0,0,LES 2 VACHES,0,LeMolay(FR),0082,0024 FR VALLET (DC),766,1720,1278,1278,0,442,442,0,954,-124.54308093994779,128,185,185,185,0,0,0,0,57,-44.53125,100.0,100.0,0.0,74.30232558139535,74.30232558139535,0.0,Previsions
558,0,2019-01-29,79537,LES 2 VACHES FLAN BIO 100X4,0,0,0,LES 2 VACHES,0,LeMolay(FR),0077,0024 FR LILPARK (DC),766,1720,1278,1278,0,442,442,0,954,-124.54308093994779,40,51,51,51,0,0,0,0,11,-27.5,100.0,100.0,0.0,74.30232558139535,74.30232558139535,0.0,Previsions
559,0,2019-01-29,79537,LES 2 VACHES FLAN BIO 100X4,0,0,0,LES 2 VACHES,0,LeMolay(FR),0085,0024 FR TOULOUSE (DC),766,1720,1278,1278,0,442,442,0,954,-124.54308093994779,85,141,141,141,0,0,0,0,56,-65.88235294117646,100.0,100.0,0.0,74.30232558139535,74.30232558139535,0.0,Previsions
560,0,2019-01-29,79537,LES 2 VACHES FLAN BIO 100X4,0,0,0,LES 2 VACHES,0,LeMolay(FR),0083,0024 FR CHAPONNAY (DC),766,1720,1278,1278,0,442,442,0,954,-124.54308093994779,12,145,145,145,0,0,0,0,133,-1108.3333333333333,100.0,100.0,0.0,74.30232558139535,74.30232558139535,0.0,Previsions
561,0,2019-01-29,79537,LES 2 VACHES FLAN BIO 100X4,0,0,0,LES 2 VACHES,0,LeMolay(FR),0079,0024 FR PARIS SUD (DC),766,1720,1278,1278,0,442,442,0,954,-124.54308093994779,134,117,117,117,0,0,0,0,-17,12.686567164179104,100.0,100.0,0.0,74.30232558139535,74.30232558139535,0.0,Previsions
562,0,2019-01-29,79537,LES 2 VACHES FLAN BIO 100X4,0,0,0,LES 2 VACHES,0,LeMolay(FR),0078,0024 FR PARIS NORD (DC),766,1720,1278,1278,0,442,442,0,954,-124.54308093994779,245,658,216,216,0,442,442,0,413,-168.57142857142858,32.82674772036474,32.82674772036474,0.0,74.30232558139535,74.30232558139535,0.0,Previsions
563,0,2019-01-29,121524,TAILLEFINE FRT MUR MYRT 125X4,0,0,0,TAILLEFINE,0,Villecomtal(FR),0084,0024 FR AIX (DC),188,251,235,235,0,16,16,0,63,-33.51063829787234,5,63,63,63,0,0,0,0,58,-1160.0,100.0,100.0,0.0,93.62549800796812,93.62549800796812,0.0,Qualité
564,0,2019-01-29,121524,TAILLEFINE FRT MUR MYRT 125X4,0,0,0,TAILLEFINE,0,Villecomtal(FR),0080,0024 FR METZ (DC),188,251,235,235,0,16,16,0,63,-33.51063829787234,32,30,14,14,0,16,16,0,-2,6.25,46.666666666666664,46.666666666666664,0.0,93.62549800796812,93.62549800796812,0.0,Qualité
565,0,2019-01-29,121524,TAILLEFINE FRT MUR MYRT 125X4,0,0,0,TAILLEFINE,0,Villecomtal(FR),0077,0024 FR LILPARK (DC),188,251,235,235,0,16,16,0,63,-33.51063829787234,63,51,51,51,0,0,0,0,-12,19.047619047619047,100.0,100.0,0.0,93.62549800796812,93.62549800796812,0.0,Qualité
566,0,2019-01-29,121524,TAILLEFINE FRT MUR MYRT 125X4,0,0,0,TAILLEFINE,0,Villecomtal(FR),0083,0024 FR CHAPONNAY (DC),188,251,235,235,0,16,16,0,63,-33.51063829787234,51,75,75,75,0,0,0,0,24,-47.05882352941177,100.0,100.0,0.0,93.62549800796812,93.62549800796812,0.0,Qualité
567,0,2019-01-29,121524,TAILLEFINE FRT MUR MYRT 125X4,0,0,0,TAILLEFINE,0,Villecomtal(FR),0078,0024 FR PARIS NORD (DC),188,251,235,235,0,16,16,0,63,-33.51063829787234,37,32,32,32,0,0,0,0,-5,13.513513513513514,100.0,100.0,0.0,93.62549800796812,93.62549800796812,0.0,Qualité
568,1,2019-01-29,131290,ACTIMEL RASP-BLUE 3x(8x100g) FR OD,1,0,0,ACTIMEL,1,Rotselaar(BE),0083,0024 FR CHAPONNAY (DC),155,373,373,295,78,78,0,0,218,-140.6451612903226,155,186,186,152,34,34,0,0,31,-20.0,100.0,81.72043010752688,18.27956989247312,100.0,79.08847184986595,20.911528150134046,Production
569,0,2019-01-29,134010,VELOUTE FRUIX PANACHE 125X16 OD,1,0,0,VELOUTE,0,Villecomtal(FR),0080,0024 FR METZ (DC),2998,1829,774,774,0,1055,1055,0,-1169,38.99266177451634,88,324,324,324,0,0,0,0,236,-268.1818181818182,100.0,100.0,0.0,42.318206670311646,42.318206670311646,0.0,Previsions
570,0,2019-01-29,134010,VELOUTE FRUIX PANACHE 125X16 OD,1,0,0,VELOUTE,0,Villecomtal(FR),0077,0024 FR LILPARK (DC),2998,1829,774,774,0,1055,1055,0,-1169,38.99266177451634,289,60,60,60,0,0,0,0,-229,79.23875432525952,100.0,100.0,0.0,42.318206670311646,42.318206670311646,0.0,Previsions
571,0,2019-01-29,134010,VELOUTE FRUIX PANACHE 125X16 OD,1,0,0,VELOUTE,0,Villecomtal(FR),0083,0024 FR CHAPONNAY (DC),2998,1829,774,774,0,1055,1055,0,-1169,38.99266177451634,535,128,128,128,0,0,0,0,-407,76.07476635514018,100.0,100.0,0.0,42.318206670311646,42.318206670311646,0.0,Previsions
572,0,2019-01-29,134010,VELOUTE FRUIX PANACHE 125X16 OD,1,0,0,VELOUTE,0,Villecomtal(FR),0079,0024 FR PARIS SUD (DC),2998,1829,774,774,0,1055,1055,0,-1169,38.99266177451634,2086,1317,262,262,0,1055,1055,0,-769,36.86481303930968,19.893697798025816,19.893697798025816,0.0,42.318206670311646,42.318206670311646,0.0,Previsions
573,0,2019-01-29,135066,ACTIVIA SAV VANILLE 125X12 OD,1,0,0,ACTIVIA,0,Bailleul(FR),0082,0024 FR VALLET (DC),2,132,25,21,4,111,107,0,130,-6500.0,2,19,9,8,1,11,10,0,17,-850.0,47.368421052631575,42.10526315789473,5.2631578947368425,18.939393939393938,15.909090909090908,3.0303030303030294,Client
574,0,2019-01-29,135066,ACTIVIA SAV VANILLE 125X12 OD,1,0,0,ACTIVIA,0,Bailleul(FR),0078,0024 FR PARIS NORD (DC),2,132,25,21,4,111,107,0,130,-6500.0,0,77,12,10,2,67,65,1,77,10000.0,15.584415584415584,12.987012987012985,2.597402597402599,18.939393939393938,15.909090909090908,3.0303030303030294,Client
575,0,2019-01-29,135358,TAILLEFINE YELLOW FRUIT 125X8 D,0,0,0,TAILLEFINE,0,Villecomtal(FR),0080,0024 FR METZ (DC),302,405,115,112,3,293,290,0,103,-34.10596026490066,155,180,72,69,3,111,108,0,25,-16.129032258064516,40.0,38.333333333333336,1.6666666666666643,28.39506172839506,27.65432098765432,0.7407407407407405,Previsions
576,0,2019-01-29,135358,TAILLEFINE YELLOW FRUIT 125X8 D,0,0,0,TAILLEFINE,0,Villecomtal(FR),0083,0024 FR CHAPONNAY (DC),302,405,115,112,3,293,290,0,103,-34.10596026490066,147,225,43,43,0,182,182,0,78,-53.06122448979592,19.11111111111111,19.11111111111111,0.0,28.39506172839506,27.65432098765432,0.7407407407407405,Previsions
577,0,2019-01-29,140278,Activia almond/muesli/chia 170g FR-copac,0,0,0,ACTIVIA,1,Roumanie(RO),0084,0024 FR AIX (DC),391,482,387,244,143,238,95,0,91,-23.273657289002557,8,80,80,80,0,0,0,0,72,-900.0,100.0,100.0,0.0,80.29045643153528,50.62240663900415,29.66804979253113,Transport
578,0,2019-01-29,140278,Activia almond/muesli/chia 170g FR-copac,0,0,0,ACTIVIA,1,Roumanie(RO),0080,0024 FR METZ (DC),391,482,387,244,143,238,95,0,91,-23.273657289002557,24,26,26,26,0,0,0,0,2,-8.333333333333334,100.0,100.0,0.0,80.29045643153528,50.62240663900415,29.66804979253113,Transport
579,0,2019-01-29,140278,Activia almond/muesli/chia 170g FR-copac,0,0,0,ACTIVIA,1,Roumanie(RO),0082,0024 FR VALLET (DC),391,482,387,244,143,238,95,0,91,-23.273657289002557,4,41,41,41,0,0,0,0,37,-925.0,100.0,100.0,0.0,80.29045643153528,50.62240663900415,29.66804979253113,Transport
580,0,2019-01-29,140278,Activia almond/muesli/chia 170g FR-copac,0,0,0,ACTIVIA,1,Roumanie(RO),0077,0024 FR LILPARK (DC),391,482,387,244,143,238,95,0,91,-23.273657289002557,139,72,69,0,69,72,3,0,-67,48.201438848920866,95.83333333333334,0.0,95.83333333333334,80.29045643153528,50.62240663900415,29.66804979253113,Transport
581,0,2019-01-29,140278,Activia almond/muesli/chia 170g FR-copac,0,0,0,ACTIVIA,1,Roumanie(RO),0085,0024 FR TOULOUSE (DC),391,482,387,244,143,238,95,0,91,-23.273657289002557,44,22,22,22,0,0,0,0,-22,50.0,100.0,100.0,0.0,80.29045643153528,50.62240663900415,29.66804979253113,Transport
582,0,2019-01-29,140278,Activia almond/muesli/chia 170g FR-copac,0,0,0,ACTIVIA,1,Roumanie(RO),0083,0024 FR CHAPONNAY (DC),391,482,387,244,143,238,95,0,91,-23.273657289002557,31,74,74,74,0,0,0,0,43,-138.70967741935485,100.0,100.0,0.0,80.29045643153528,50.62240663900415,29.66804979253113,Transport
583,0,2019-01-29,140278,Activia almond/muesli/chia 170g FR-copac,0,0,0,ACTIVIA,1,Roumanie(RO),0079,0024 FR PARIS SUD (DC),391,482,387,244,143,238,95,0,91,-23.273657289002557,79,72,72,0,72,72,0,0,-7,8.860759493670885,100.0,0.0,100.0,80.29045643153528,50.62240663900415,29.66804979253113,Transport
584,0,2019-01-29,140278,Activia almond/muesli/chia 170g FR-copac,0,0,0,ACTIVIA,1,Roumanie(RO),0078,0024 FR PARIS NORD (DC),391,482,387,244,143,238,95,0,91,-23.273657289002557,62,95,3,1,2,94,92,0,33,-53.225806451612904,3.1578947368421053,1.0526315789473684,2.105263157894737,80.29045643153528,50.62240663900415,29.66804979253113,Transport
585,0,2019-01-30,79537,LES 2 VACHES FLAN BIO 100X4,0,0,0,LES 2 VACHES,0,LeMolay(FR),0084,0024 FR AIX (DC),2292,2503,1770,1744,26,759,733,0,211,-9.205933682373473,136,334,334,334,0,0,0,0,198,-145.58823529411765,100.0,100.0,0.0,70.71514182980424,69.6763883339992,1.0387534958050395,Previsions
586,0,2019-01-30,79537,LES 2 VACHES FLAN BIO 100X4,0,0,0,LES 2 VACHES,0,LeMolay(FR),0080,0024 FR METZ (DC),2292,2503,1770,1744,26,759,733,0,211,-9.205933682373473,158,105,105,105,0,0,0,0,-53,33.54430379746835,100.0,100.0,0.0,70.71514182980424,69.6763883339992,1.0387534958050395,Previsions
587,0,2019-01-30,79537,LES 2 VACHES FLAN BIO 100X4,0,0,0,LES 2 VACHES,0,LeMolay(FR),0081,0024 FR TOURS (DC),2292,2503,1770,1744,26,759,733,0,211,-9.205933682373473,328,168,168,168,0,0,0,0,-160,48.78048780487805,100.0,100.0,0.0,70.71514182980424,69.6763883339992,1.0387534958050395,Previsions
588,0,2019-01-30,79537,LES 2 VACHES FLAN BIO 100X4,0,0,0,LES 2 VACHES,0,LeMolay(FR),0082,0024 FR VALLET (DC),2292,2503,1770,1744,26,759,733,0,211,-9.205933682373473,223,158,85,85,0,73,73,0,-65,29.14798206278027,53.79746835443038,53.79746835443038,0.0,70.71514182980424,69.6763883339992,1.0387534958050395,Previsions
589,0,2019-01-30,79537,LES 2 VACHES FLAN BIO 100X4,0,0,0,LES 2 VACHES,0,LeMolay(FR),0077,0024 FR LILPARK (DC),2292,2503,1770,1744,26,759,733,0,211,-9.205933682373473,85,25,51,25,26,0,-26,0,-60,70.58823529411765,204.0,100.0,104.0,70.71514182980424,69.6763883339992,1.0387534958050395,Previsions
590,0,2019-01-30,79537,LES 2 VACHES FLAN BIO 100X4,0,0,0,LES 2 VACHES,0,LeMolay(FR),0085,0024 FR TOULOUSE (DC),2292,2503,1770,1744,26,759,733,0,211,-9.205933682373473,210,214,214,214,0,0,0,0,4,-1.9047619047619047,100.0,100.0,0.0,70.71514182980424,69.6763883339992,1.0387534958050395,Previsions
591,0,2019-01-30,79537,LES 2 VACHES FLAN BIO 100X4,0,0,0,LES 2 VACHES,0,LeMolay(FR),0083,0024 FR CHAPONNAY (DC),2292,2503,1770,1744,26,759,733,0,211,-9.205933682373473,476,544,544,544,0,0,0,0,68,-14.285714285714286,100.0,100.0,0.0,70.71514182980424,69.6763883339992,1.0387534958050395,Previsions
592,0,2019-01-30,79537,LES 2 VACHES FLAN BIO 100X4,0,0,0,LES 2 VACHES,0,LeMolay(FR),0079,0024 FR PARIS SUD (DC),2292,2503,1770,1744,26,759,733,0,211,-9.205933682373473,163,109,53,53,0,56,56,0,-54,33.12883435582822,48.62385321100918,48.62385321100918,0.0,70.71514182980424,69.6763883339992,1.0387534958050395,Previsions
593,0,2019-01-30,79537,LES 2 VACHES FLAN BIO 100X4,0,0,0,LES 2 VACHES,0,LeMolay(FR),0078,0024 FR PARIS NORD (DC),2292,2503,1770,1744,26,759,733,0,211,-9.205933682373473,513,846,216,216,0,630,630,0,333,-64.91228070175438,25.53191489361702,25.53191489361702,0.0,70.71514182980424,69.6763883339992,1.0387534958050395,Previsions
594,0,2019-01-30,115511,LES 2 VACHES PEAR 115X4,0,0,0,LES 2 VACHES,0,LeMolay(FR),0084,0024 FR AIX (DC),605,1353,624,606,18,747,729,0,748,-123.63636363636364,30,39,39,39,0,0,0,0,9,-30.0,100.0,100.0,0.0,46.11973392461197,44.789356984478935,1.3303769401330356,Previsions
595,0,2019-01-30,115511,LES 2 VACHES PEAR 115X4,0,0,0,LES 2 VACHES,0,LeMolay(FR),0080,0024 FR METZ (DC),605,1353,624,606,18,747,729,0,748,-123.63636363636364,45,53,53,53,0,0,0,0,8,-17.77777777777778,100.0,100.0,0.0,46.11973392461197,44.789356984478935,1.3303769401330356,Previsions
596,0,2019-01-30,115511,LES 2 VACHES PEAR 115X4,0,0,0,LES 2 VACHES,0,LeMolay(FR),0081,0024 FR TOURS (DC),605,1353,624,606,18,747,729,0,748,-123.63636363636364,201,156,156,156,0,0,0,0,-45,22.388059701492537,100.0,100.0,0.0,46.11973392461197,44.789356984478935,1.3303769401330356,Previsions
597,0,2019-01-30,115511,LES 2 VACHES PEAR 115X4,0,0,0,LES 2 VACHES,0,LeMolay(FR),0082,0024 FR VALLET (DC),605,1353,624,606,18,747,729,0,748,-123.63636363636364,61,66,66,66,0,0,0,0,5,-8.19672131147541,100.0,100.0,0.0,46.11973392461197,44.789356984478935,1.3303769401330356,Previsions
598,0,2019-01-30,115511,LES 2 VACHES PEAR 115X4,0,0,0,LES 2 VACHES,0,LeMolay(FR),0077,0024 FR LILPARK (DC),605,1353,624,606,18,747,729,0,748,-123.63636363636364,17,6,21,6,15,0,-15,0,-11,64.70588235294117,350.0,100.0,250.0,46.11973392461197,44.789356984478935,1.3303769401330356,Previsions
599,0,2019-01-30,115511,LES 2 VACHES PEAR 115X4,0,0,0,LES 2 VACHES,0,LeMolay(FR),0085,0024 FR TOULOUSE (DC),605,1353,624,606,18,747,729,0,748,-123.63636363636364,79,65,65,65,0,0,0,0,-14,17.72151898734177,100.0,100.0,0.0,46.11973392461197,44.789356984478935,1.3303769401330356,Previsions
600,0,2019-01-30,115511,LES 2 VACHES PEAR 115X4,0,0,0,LES 2 VACHES,0,LeMolay(FR),0083,0024 FR CHAPONNAY (DC),605,1353,624,606,18,747,729,0,748,-123.63636363636364,86,71,71,71,0,0,0,0,-15,17.441860465116278,100.0,100.0,0.0,46.11973392461197,44.789356984478935,1.3303769401330356,Previsions
601,0,2019-01-30,115511,LES 2 VACHES PEAR 115X4,0,0,0,LES 2 VACHES,0,LeMolay(FR),0079,0024 FR PARIS SUD (DC),605,1353,624,606,18,747,729,0,748,-123.63636363636364,53,37,37,37,0,0,0,0,-16,30.18867924528302,100.0,100.0,0.0,46.11973392461197,44.789356984478935,1.3303769401330356,Previsions
602,0,2019-01-30,115511,LES 2 VACHES PEAR 115X4,0,0,0,LES 2 VACHES,0,LeMolay(FR),0078,0024 FR PARIS NORD (DC),605,1353,624,606,18,747,729,0,748,-123.63636363636364,33,860,116,113,3,747,744,0,827,-2506.060606060606,13.488372093023257,13.13953488372093,0.3488372093023262,46.11973392461197,44.789356984478935,1.3303769401330356,Previsions
603,0,2019-01-30,133904,DANONE BIO NATURE SUCRE 125X4,0,0,0,DANONE,0,Bailleul(FR),0084,0024 FR AIX (DC),1125,1548,955,950,5,598,593,0,423,-37.6,49,38,38,38,0,0,0,0,-11,22.448979591836736,100.0,100.0,0.0,61.69250645994831,61.36950904392765,0.32299741602066234,Previsions
604,0,2019-01-30,133904,DANONE BIO NATURE SUCRE 125X4,0,0,0,DANONE,0,Bailleul(FR),0080,0024 FR METZ (DC),1125,1548,955,950,5,598,593,0,423,-37.6,90,91,91,91,0,0,0,0,1,-1.1111111111111112,100.0,100.0,0.0,61.69250645994831,61.36950904392765,0.32299741602066234,Previsions
605,0,2019-01-30,133904,DANONE BIO NATURE SUCRE 125X4,0,0,0,DANONE,0,Bailleul(FR),0081,0024 FR TOURS (DC),1125,1548,955,950,5,598,593,0,423,-37.6,215,149,149,149,0,0,0,0,-66,30.697674418604652,100.0,100.0,0.0,61.69250645994831,61.36950904392765,0.32299741602066234,Previsions
606,0,2019-01-30,133904,DANONE BIO NATURE SUCRE 125X4,0,0,0,DANONE,0,Bailleul(FR),0082,0024 FR VALLET (DC),1125,1548,955,950,5,598,593,0,423,-37.6,114,249,249,249,0,0,0,0,135,-118.42105263157895,100.0,100.0,0.0,61.69250645994831,61.36950904392765,0.32299741602066234,Previsions
607,0,2019-01-30,133904,DANONE BIO NATURE SUCRE 125X4,0,0,0,DANONE,0,Bailleul(FR),0077,0024 FR LILPARK (DC),1125,1548,955,950,5,598,593,0,423,-37.6,69,18,18,18,0,0,0,0,-51,73.91304347826087,100.0,100.0,0.0,61.69250645994831,61.36950904392765,0.32299741602066234,Previsions
608,0,2019-01-30,133904,DANONE BIO NATURE SUCRE 125X4,0,0,0,DANONE,0,Bailleul(FR),0085,0024 FR TOULOUSE (DC),1125,1548,955,950,5,598,593,0,423,-37.6,50,280,280,280,0,0,0,0,230,-460.0,100.0,100.0,0.0,61.69250645994831,61.36950904392765,0.32299741602066234,Previsions
609,0,2019-01-30,133904,DANONE BIO NATURE SUCRE 125X4,0,0,0,DANONE,0,Bailleul(FR),0083,0024 FR CHAPONNAY (DC),1125,1548,955,950,5,598,593,0,423,-37.6,261,199,85,84,1,115,114,0,-62,23.754789272030653,42.71356783919598,42.211055276381906,0.5025125628140756,61.69250645994831,61.36950904392765,0.32299741602066234,Previsions
610,0,2019-01-30,133904,DANONE BIO NATURE SUCRE 125X4,0,0,0,DANONE,0,Bailleul(FR),0079,0024 FR PARIS SUD (DC),1125,1548,955,950,5,598,593,0,423,-37.6,82,41,41,41,0,0,0,0,-41,50.0,100.0,100.0,0.0,61.69250645994831,61.36950904392765,0.32299741602066234,Previsions
611,0,2019-01-30,133904,DANONE BIO NATURE SUCRE 125X4,0,0,0,DANONE,0,Bailleul(FR),0078,0024 FR PARIS NORD (DC),1125,1548,955,950,5,598,593,0,423,-37.6,195,483,4,0,4,483,479,0,288,-147.69230769230768,0.8281573498964804,0.0,0.8281573498964804,61.69250645994831,61.36950904392765,0.32299741602066234,Previsions
612,0,2019-01-30,134010,VELOUTE FRUIX PANACHE 125X16 OD,1,0,0,VELOUTE,0,Villecomtal(FR),0080,0024 FR METZ (DC),1547,1178,921,537,384,641,257,0,-369,23.85261797026503,23,125,125,125,0,0,0,0,102,-443.4782608695652,100.0,100.0,0.0,78.18336162988115,45.58573853989814,32.59762308998301,Previsions
613,0,2019-01-30,134010,VELOUTE FRUIX PANACHE 125X16 OD,1,0,0,VELOUTE,0,Villecomtal(FR),0077,0024 FR LILPARK (DC),1547,1178,921,537,384,641,257,0,-369,23.85261797026503,314,176,176,176,0,0,0,0,-138,43.94904458598726,100.0,100.0,0.0,78.18336162988115,45.58573853989814,32.59762308998301,Previsions
614,0,2019-01-30,134010,VELOUTE FRUIX PANACHE 125X16 OD,1,0,0,VELOUTE,0,Villecomtal(FR),0083,0024 FR CHAPONNAY (DC),1547,1178,921,537,384,641,257,0,-369,23.85261797026503,81,44,44,44,0,0,0,0,-37,45.67901234567901,100.0,100.0,0.0,78.18336162988115,45.58573853989814,32.59762308998301,Previsions
615,0,2019-01-30,134010,VELOUTE FRUIX PANACHE 125X16 OD,1,0,0,VELOUTE,0,Villecomtal(FR),0079,0024 FR PARIS SUD (DC),1547,1178,921,537,384,641,257,0,-369,23.85261797026503,1129,833,576,192,384,641,257,0,-296,26.217891939769707,69.14765906362545,23.04921968787515,46.0984393757503,78.18336162988115,45.58573853989814,32.59762308998301,Previsions
616,0,2019-01-30,140280,Activia chia/raspb/muesli 170g FR-copack,0,0,0,ACTIVIA,1,Roumanie(RO),0084,0024 FR AIX (DC),1114,978,978,601,377,377,0,0,-136,12.208258527827649,185,162,162,162,0,0,0,0,-23,12.432432432432432,100.0,100.0,0.0,100.0,61.451942740286306,38.548057259713694,Transport
617,0,2019-01-30,140280,Activia chia/raspb/muesli 170g FR-copack,0,0,0,ACTIVIA,1,Roumanie(RO),0080,0024 FR METZ (DC),1114,978,978,601,377,377,0,0,-136,12.208258527827649,162,149,149,17,132,132,0,0,-13,8.024691358024691,100.0,11.409395973154362,88.59060402684564,100.0,61.451942740286306,38.548057259713694,Transport
618,0,2019-01-30,140280,Activia chia/raspb/muesli 170g FR-copack,0,0,0,ACTIVIA,1,Roumanie(RO),0081,0024 FR TOURS (DC),1114,978,978,601,377,377,0,0,-136,12.208258527827649,173,125,125,0,125,125,0,0,-48,27.745664739884393,100.0,0.0,100.0,100.0,61.451942740286306,38.548057259713694,Transport
619,0,2019-01-30,140280,Activia chia/raspb/muesli 170g FR-copack,0,0,0,ACTIVIA,1,Roumanie(RO),0082,0024 FR VALLET (DC),1114,978,978,601,377,377,0,0,-136,12.208258527827649,128,120,120,0,120,120,0,0,-8,6.25,100.0,0.0,100.0,100.0,61.451942740286306,38.548057259713694,Transport
620,0,2019-01-30,140280,Activia chia/raspb/muesli 170g FR-copack,0,0,0,ACTIVIA,1,Roumanie(RO),0077,0024 FR LILPARK (DC),1114,978,978,601,377,377,0,0,-136,12.208258527827649,121,6,6,6,0,0,0,0,-115,95.04132231404958,100.0,100.0,0.0,100.0,61.451942740286306,38.548057259713694,Transport
621,0,2019-01-30,140280,Activia chia/raspb/muesli 170g FR-copack,0,0,0,ACTIVIA,1,Roumanie(RO),0085,0024 FR TOULOUSE (DC),1114,978,978,601,377,377,0,0,-136,12.208258527827649,12,139,139,139,0,0,0,0,127,-1058.3333333333333,100.0,100.0,0.0,100.0,61.451942740286306,38.548057259713694,Transport
622,0,2019-01-30,140280,Activia chia/raspb/muesli 170g FR-copack,0,0,0,ACTIVIA,1,Roumanie(RO),0079,0024 FR PARIS SUD (DC),1114,978,978,601,377,377,0,0,-136,12.208258527827649,125,105,105,105,0,0,0,0,-20,16.0,100.0,100.0,0.0,100.0,61.451942740286306,38.548057259713694,Transport
623,0,2019-01-30,140280,Activia chia/raspb/muesli 170g FR-copack,0,0,0,ACTIVIA,1,Roumanie(RO),0078,0024 FR PARIS NORD (DC),1114,978,978,601,377,377,0,0,-136,12.208258527827649,208,172,172,172,0,0,0,0,-36,17.307692307692307,100.0,100.0,0.0,100.0,61.451942740286306,38.548057259713694,Transport
624,0,2019-01-31,32803,TAILLEFINE CHEESE NAT 0% 850GX1,0,0,0,TAILLEFINE,0,Ferrières(FR),0084,0024 FR AIX (DC),947,1121,894,812,82,309,227,0,174,-18.373812038014783,101,124,124,124,0,0,0,0,23,-22.77227722772277,100.0,100.0,0.0,79.75022301516503,72.43532560214095,7.3148974130240845,Previsions
625,0,2019-01-31,32803,TAILLEFINE CHEESE NAT 0% 850GX1,0,0,0,TAILLEFINE,0,Ferrières(FR),0080,0024 FR METZ (DC),947,1121,894,812,82,309,227,0,174,-18.373812038014783,27,32,32,32,0,0,0,0,5,-18.51851851851852,100.0,100.0,0.0,79.75022301516503,72.43532560214095,7.3148974130240845,Previsions
626,0,2019-01-31,32803,TAILLEFINE CHEESE NAT 0% 850GX1,0,0,0,TAILLEFINE,0,Ferrières(FR),0081,0024 FR TOURS (DC),947,1121,894,812,82,309,227,0,174,-18.373812038014783,68,70,70,70,0,0,0,0,2,-2.9411764705882355,100.0,100.0,0.0,79.75022301516503,72.43532560214095,7.3148974130240845,Previsions
627,0,2019-01-31,32803,TAILLEFINE CHEESE NAT 0% 850GX1,0,0,0,TAILLEFINE,0,Ferrières(FR),0082,0024 FR VALLET (DC),947,1121,894,812,82,309,227,0,174,-18.373812038014783,37,49,49,49,0,0,0,0,12,-32.432432432432435,100.0,100.0,0.0,79.75022301516503,72.43532560214095,7.3148974130240845,Previsions
628,0,2019-01-31,32803,TAILLEFINE CHEESE NAT 0% 850GX1,0,0,0,TAILLEFINE,0,Ferrières(FR),0077,0024 FR LILPARK (DC),947,1121,894,812,82,309,227,0,174,-18.373812038014783,85,100,100,100,0,0,0,0,15,-17.647058823529413,100.0,100.0,0.0,79.75022301516503,72.43532560214095,7.3148974130240845,Previsions
629,0,2019-01-31,32803,TAILLEFINE CHEESE NAT 0% 850GX1,0,0,0,TAILLEFINE,0,Ferrières(FR),0085,0024 FR TOULOUSE (DC),947,1121,894,812,82,309,227,0,174,-18.373812038014783,96,132,48,48,0,84,84,0,36,-37.5,36.36363636363637,36.36363636363637,0.0,79.75022301516503,72.43532560214095,7.3148974130240845,Previsions
630,0,2019-01-31,32803,TAILLEFINE CHEESE NAT 0% 850GX1,0,0,0,TAILLEFINE,0,Ferrières(FR),0083,0024 FR CHAPONNAY (DC),947,1121,894,812,82,309,227,0,174,-18.373812038014783,108,140,140,84,56,56,0,0,32,-29.62962962962963,100.0,60.0,40.0,79.75022301516503,72.43532560214095,7.3148974130240845,Previsions
631,0,2019-01-31,32803,TAILLEFINE CHEESE NAT 0% 850GX1,0,0,0,TAILLEFINE,0,Ferrières(FR),0079,0024 FR PARIS SUD (DC),947,1121,894,812,82,309,227,0,174,-18.373812038014783,279,281,138,138,0,143,143,0,2,-0.7168458781362007,49.11032028469751,49.11032028469751,0.0,79.75022301516503,72.43532560214095,7.3148974130240845,Previsions
632,0,2019-01-31,32803,TAILLEFINE CHEESE NAT 0% 850GX1,0,0,0,TAILLEFINE,0,Ferrières(FR),0078,0024 FR PARIS NORD (DC),947,1121,894,812,82,309,227,0,174,-18.373812038014783,146,193,193,167,26,26,0,0,47,-32.19178082191781,100.0,86.52849740932642,13.47150259067358,79.75022301516503,72.43532560214095,7.3148974130240845,Previsions
633,0,2019-01-31,102481,ACTIVIA CHEESE VANILLA 120X4,0,0,0,ACTIVIA,0,Ferrières(FR),0084,0024 FR AIX (DC),482,573,436,432,4,141,137,0,91,-18.87966804979253,45,26,21,21,0,5,5,0,-19,42.22222222222222,80.76923076923077,80.76923076923077,0.0,76.09075043630017,75.39267015706807,0.6980802792321015,Previsions
634,0,2019-01-31,102481,ACTIVIA CHEESE VANILLA 120X4,0,0,0,ACTIVIA,0,Ferrières(FR),0080,0024 FR METZ (DC),482,573,436,432,4,141,137,0,91,-18.87966804979253,49,39,39,39,0,0,0,0,-10,20.408163265306122,100.0,100.0,0.0,76.09075043630017,75.39267015706807,0.6980802792321015,Previsions
635,0,2019-01-31,102481,ACTIVIA CHEESE VANILLA 120X4,0,0,0,ACTIVIA,0,Ferrières(FR),0081,0024 FR TOURS (DC),482,573,436,432,4,141,137,0,91,-18.87966804979253,84,72,55,55,0,17,17,0,-12,14.285714285714286,76.38888888888889,76.38888888888889,0.0,76.09075043630017,75.39267015706807,0.6980802792321015,Previsions
636,0,2019-01-31,102481,ACTIVIA CHEESE VANILLA 120X4,0,0,0,ACTIVIA,0,Ferrières(FR),0082,0024 FR VALLET (DC),482,573,436,432,4,141,137,0,91,-18.87966804979253,41,38,38,38,0,0,0,0,-3,7.317073170731708,100.0,100.0,0.0,76.09075043630017,75.39267015706807,0.6980802792321015,Previsions
637,0,2019-01-31,102481,ACTIVIA CHEESE VANILLA 120X4,0,0,0,ACTIVIA,0,Ferrières(FR),0085,0024 FR TOULOUSE (DC),482,573,436,432,4,141,137,0,91,-18.87966804979253,104,110,110,110,0,0,0,0,6,-5.769230769230769,100.0,100.0,0.0,76.09075043630017,75.39267015706807,0.6980802792321015,Previsions
638,0,2019-01-31,102481,ACTIVIA CHEESE VANILLA 120X4,0,0,0,ACTIVIA,0,Ferrières(FR),0083,0024 FR CHAPONNAY (DC),482,573,436,432,4,141,137,0,91,-18.87966804979253,56,64,60,60,0,4,4,0,8,-14.285714285714286,93.75,93.75,0.0,76.09075043630017,75.39267015706807,0.6980802792321015,Previsions
639,0,2019-01-31,102481,ACTIVIA CHEESE VANILLA 120X4,0,0,0,ACTIVIA,0,Ferrières(FR),0079,0024 FR PARIS SUD (DC),482,573,436,432,4,141,137,0,91,-18.87966804979253,17,153,42,38,4,115,111,0,136,-800.0,27.450980392156865,24.836601307189543,2.6143790849673216,76.09075043630017,75.39267015706807,0.6980802792321015,Previsions
640,0,2019-01-31,102481,ACTIVIA CHEESE VANILLA 120X4,0,0,0,ACTIVIA,0,Ferrières(FR),0078,0024 FR PARIS NORD (DC),482,573,436,432,4,141,137,0,91,-18.87966804979253,86,71,71,71,0,0,0,0,-15,17.441860465116278,100.0,100.0,0.0,76.09075043630017,75.39267015706807,0.6980802792321015,Previsions
641,0,2019-01-31,140278,Activia almond/muesli/chia 170g FR-copac,0,0,0,ACTIVIA,1,Roumanie(RO),0084,0024 FR AIX (DC),274,474,299,296,3,178,175,0,200,-72.99270072992701,51,78,78,78,0,0,0,0,27,-52.94117647058823,100.0,100.0,0.0,63.0801687763713,62.447257383966246,0.632911392405056,Transport
642,0,2019-01-31,140278,Activia almond/muesli/chia 170g FR-copac,0,0,0,ACTIVIA,1,Roumanie(RO),0080,0024 FR METZ (DC),274,474,299,296,3,178,175,0,200,-72.99270072992701,23,40,40,40,0,0,0,0,17,-73.91304347826087,100.0,100.0,0.0,63.0801687763713,62.447257383966246,0.632911392405056,Transport
643,0,2019-01-31,140278,Activia almond/muesli/chia 170g FR-copac,0,0,0,ACTIVIA,1,Roumanie(RO),0081,0024 FR TOURS (DC),274,474,299,296,3,178,175,0,200,-72.99270072992701,12,108,35,32,3,76,73,0,96,-800.0,32.407407407407405,29.629629629629626,2.7777777777777786,63.0801687763713,62.447257383966246,0.632911392405056,Transport
644,0,2019-01-31,140278,Activia almond/muesli/chia 170g FR-copac,0,0,0,ACTIVIA,1,Roumanie(RO),0082,0024 FR VALLET (DC),274,474,299,296,3,178,175,0,200,-72.99270072992701,5,36,36,36,0,0,0,0,31,-620.0,100.0,100.0,0.0,63.0801687763713,62.447257383966246,0.632911392405056,Transport
645,0,2019-01-31,140278,Activia almond/muesli/chia 170g FR-copac,0,0,0,ACTIVIA,1,Roumanie(RO),0077,0024 FR LILPARK (DC),274,474,299,296,3,178,175,0,200,-72.99270072992701,74,105,10,10,0,95,95,0,31,-41.891891891891895,9.523809523809524,9.523809523809524,0.0,63.0801687763713,62.447257383966246,0.632911392405056,Transport
646,0,2019-01-31,140278,Activia almond/muesli/chia 170g FR-copac,0,0,0,ACTIVIA,1,Roumanie(RO),0085,0024 FR TOULOUSE (DC),274,474,299,296,3,178,175,0,200,-72.99270072992701,75,45,45,45,0,0,0,0,-30,40.0,100.0,100.0,0.0,63.0801687763713,62.447257383966246,0.632911392405056,Transport
647,0,2019-01-31,140278,Activia almond/muesli/chia 170g FR-copac,0,0,0,ACTIVIA,1,Roumanie(RO),0083,0024 FR CHAPONNAY (DC),274,474,299,296,3,178,175,0,200,-72.99270072992701,34,62,55,55,0,7,7,0,28,-82.3529411764706,88.70967741935483,88.70967741935483,0.0,63.0801687763713,62.447257383966246,0.632911392405056,Transport
648,0,2019-01-31,140280,Activia chia/raspb/muesli 170g FR-copack,0,0,0,ACTIVIA,1,Roumanie(RO),0084,0024 FR AIX (DC),914,1235,1100,1078,22,157,135,0,321,-35.12035010940919,91,170,48,46,2,124,122,0,79,-86.81318681318682,28.235294117647058,27.058823529411764,1.1764705882352935,89.06882591093117,87.28744939271255,1.7813765182186216,Transport
649,0,2019-01-31,140280,Activia chia/raspb/muesli 170g FR-copack,0,0,0,ACTIVIA,1,Roumanie(RO),0080,0024 FR METZ (DC),914,1235,1100,1078,22,157,135,0,321,-35.12035010940919,161,101,101,85,16,16,0,0,-60,37.267080745341616,100.0,84.15841584158416,15.841584158415841,89.06882591093117,87.28744939271255,1.7813765182186216,Transport
650,0,2019-01-31,140280,Activia chia/raspb/muesli 170g FR-copack,0,0,0,ACTIVIA,1,Roumanie(RO),0081,0024 FR TOURS (DC),914,1235,1100,1078,22,157,135,0,321,-35.12035010940919,182,183,183,179,4,4,0,0,1,-0.5494505494505495,100.0,97.81420765027322,2.185792349726782,89.06882591093117,87.28744939271255,1.7813765182186216,Transport
651,0,2019-01-31,140280,Activia chia/raspb/muesli 170g FR-copack,0,0,0,ACTIVIA,1,Roumanie(RO),0082,0024 FR VALLET (DC),914,1235,1100,1078,22,157,135,0,321,-35.12035010940919,14,135,135,135,0,0,0,0,121,-864.2857142857143,100.0,100.0,0.0,89.06882591093117,87.28744939271255,1.7813765182186216,Transport
652,0,2019-01-31,140280,Activia chia/raspb/muesli 170g FR-copack,0,0,0,ACTIVIA,1,Roumanie(RO),0077,0024 FR LILPARK (DC),914,1235,1100,1078,22,157,135,0,321,-35.12035010940919,104,131,131,131,0,0,0,0,27,-25.96153846153846,100.0,100.0,0.0,89.06882591093117,87.28744939271255,1.7813765182186216,Transport
653,0,2019-01-31,140280,Activia chia/raspb/muesli 170g FR-copack,0,0,0,ACTIVIA,1,Roumanie(RO),0085,0024 FR TOULOUSE (DC),914,1235,1100,1078,22,157,135,0,321,-35.12035010940919,75,80,80,80,0,0,0,0,5,-6.666666666666667,100.0,100.0,0.0,89.06882591093117,87.28744939271255,1.7813765182186216,Transport
654,0,2019-01-31,140280,Activia chia/raspb/muesli 170g FR-copack,0,0,0,ACTIVIA,1,Roumanie(RO),0083,0024 FR CHAPONNAY (DC),914,1235,1100,1078,22,157,135,0,321,-35.12035010940919,107,139,126,126,0,13,13,0,32,-29.906542056074766,90.64748201438849,90.64748201438849,0.0,89.06882591093117,87.28744939271255,1.7813765182186216,Transport
655,0,2019-01-31,140280,Activia chia/raspb/muesli 170g FR-copack,0,0,0,ACTIVIA,1,Roumanie(RO),0079,0024 FR PARIS SUD (DC),914,1235,1100,1078,22,157,135,0,321,-35.12035010940919,106,131,131,131,0,0,0,0,25,-23.58490566037736,100.0,100.0,0.0,89.06882591093117,87.28744939271255,1.7813765182186216,Transport
656,0,2019-01-31,140280,Activia chia/raspb/muesli 170g FR-copack,0,0,0,ACTIVIA,1,Roumanie(RO),0078,0024 FR PARIS NORD (DC),914,1235,1100,1078,22,157,135,0,321,-35.12035010940919,74,165,165,165,0,0,0,0,91,-122.97297297297297,100.0,100.0,0.0,89.06882591093117,87.28744939271255,1.7813765182186216,Transport
657,0,2019-01-31,142615,ACTIMEL STRAWBERRY 4x(8+4x100g) FR,1,1,0,ACTIMEL,1,Rotselaar(BE),0084,0024 FR AIX (DC),605,1147,1039,806,233,341,108,0,542,-89.58677685950413,79,91,91,28,63,63,0,0,12,-15.189873417721518,100.0,30.76923076923077,69.23076923076923,90.58413251961639,70.27027027027027,20.313862249346116,Production
658,0,2019-01-31,142615,ACTIMEL STRAWBERRY 4x(8+4x100g) FR,1,1,0,ACTIMEL,1,Rotselaar(BE),0080,0024 FR METZ (DC),605,1147,1039,806,233,341,108,0,542,-89.58677685950413,31,32,32,28,4,4,0,0,1,-3.225806451612903,100.0,87.5,12.5,90.58413251961639,70.27027027027027,20.313862249346116,Production
659,0,2019-01-31,142615,ACTIMEL STRAWBERRY 4x(8+4x100g) FR,1,1,0,ACTIMEL,1,Rotselaar(BE),0081,0024 FR TOURS (DC),605,1147,1039,806,233,341,108,0,542,-89.58677685950413,74,103,84,84,0,19,19,0,29,-39.189189189189186,81.55339805825243,81.55339805825243,0.0,90.58413251961639,70.27027027027027,20.313862249346116,Production
660,0,2019-01-31,142615,ACTIMEL STRAWBERRY 4x(8+4x100g) FR,1,1,0,ACTIMEL,1,Rotselaar(BE),0077,0024 FR LILPARK (DC),605,1147,1039,806,233,341,108,0,542,-89.58677685950413,26,304,304,302,2,2,0,0,278,-1069.2307692307693,100.0,99.3421052631579,0.6578947368420955,90.58413251961639,70.27027027027027,20.313862249346116,Production
661,0,2019-01-31,142615,ACTIMEL STRAWBERRY 4x(8+4x100g) FR,1,1,0,ACTIMEL,1,Rotselaar(BE),0085,0024 FR TOULOUSE (DC),605,1147,1039,806,233,341,108,0,542,-89.58677685950413,43,49,49,0,49,49,0,0,6,-13.953488372093023,100.0,0.0,100.0,90.58413251961639,70.27027027027027,20.313862249346116,Production
662,1,2019-01-31,142615,ACTIMEL STRAWBERRY 4x(8+4x100g) FR,1,1,0,ACTIMEL,1,Rotselaar(BE),0085,0024 FR TOULOUSE (DC),605,1147,1039,806,233,341,108,0,542,-89.58677685950413,43,49,49,0,49,49,0,0,6,-13.953488372093023,100.0,0.0,100.0,90.58413251961639,70.27027027027027,20.313862249346116,Production
663,0,2019-01-31,142615,ACTIMEL STRAWBERRY 4x(8+4x100g) FR,1,1,0,ACTIMEL,1,Rotselaar(BE),0083,0024 FR CHAPONNAY (DC),605,1147,1039,806,233,341,108,0,542,-89.58677685950413,11,120,120,15,105,105,0,0,109,-990.9090909090909,100.0,12.5,87.5,90.58413251961639,70.27027027027027,20.313862249346116,Production
664,0,2019-01-31,142615,ACTIMEL STRAWBERRY 4x(8+4x100g) FR,1,1,0,ACTIMEL,1,Rotselaar(BE),0079,0024 FR PARIS SUD (DC),605,1147,1039,806,233,341,108,0,542,-89.58677685950413,232,371,282,282,0,89,89,0,139,-59.91379310344828,76.01078167115904,76.01078167115904,0.0,90.58413251961639,70.27027027027027,20.313862249346116,Production
665,0,2019-01-31,142615,ACTIMEL STRAWBERRY 4x(8+4x100g) FR,1,1,0,ACTIMEL,1,Rotselaar(BE),0078,0024 FR PARIS NORD (DC),605,1147,1039,806,233,341,108,0,542,-89.58677685950413,66,77,77,67,10,10,0,0,11,-16.666666666666668,100.0,87.01298701298701,12.987012987012989,90.58413251961639,70.27027027027027,20.313862249346116,Production
666,0,2019-02-01,79537,LES 2 VACHES FLAN BIO 100X4,0,0,0,LES 2 VACHES,0,LeMolay(FR),0084,0024 FR AIX (DC),1077,945,945,847,98,98,0,0,-132,12.256267409470752,181,184,184,184,0,0,0,0,3,-1.6574585635359116,100.0,100.0,0.0,100.0,89.62962962962962,10.370370370370381,Previsions
667,0,2019-02-01,79537,LES 2 VACHES FLAN BIO 100X4,0,0,0,LES 2 VACHES,0,LeMolay(FR),0080,0024 FR METZ (DC),1077,945,945,847,98,98,0,0,-132,12.256267409470752,145,66,66,50,16,16,0,0,-79,54.48275862068966,100.0,75.75757575757575,24.24242424242425,100.0,89.62962962962962,10.370370370370381,Previsions
668,0,2019-02-01,79537,LES 2 VACHES FLAN BIO 100X4,0,0,0,LES 2 VACHES,0,LeMolay(FR),0081,0024 FR TOURS (DC),1077,945,945,847,98,98,0,0,-132,12.256267409470752,182,78,78,53,25,25,0,0,-104,57.142857142857146,100.0,67.94871794871796,32.051282051282044,100.0,89.62962962962962,10.370370370370381,Previsions
669,0,2019-02-01,79537,LES 2 VACHES FLAN BIO 100X4,0,0,0,LES 2 VACHES,0,LeMolay(FR),0082,0024 FR VALLET (DC),1077,945,945,847,98,98,0,0,-132,12.256267409470752,124,132,132,121,11,11,0,0,8,-6.451612903225806,100.0,91.66666666666666,8.333333333333343,100.0,89.62962962962962,10.370370370370381,Previsions
670,0,2019-02-01,79537,LES 2 VACHES FLAN BIO 100X4,0,0,0,LES 2 VACHES,0,LeMolay(FR),0077,0024 FR LILPARK (DC),1077,945,945,847,98,98,0,0,-132,12.256267409470752,103,53,53,53,0,0,0,0,-50,48.54368932038835,100.0,100.0,0.0,100.0,89.62962962962962,10.370370370370381,Previsions
671,0,2019-02-01,79537,LES 2 VACHES FLAN BIO 100X4,0,0,0,LES 2 VACHES,0,LeMolay(FR),0085,0024 FR TOULOUSE (DC),1077,945,945,847,98,98,0,0,-132,12.256267409470752,149,144,144,144,0,0,0,0,-5,3.3557046979865772,100.0,100.0,0.0,100.0,89.62962962962962,10.370370370370381,Previsions
672,0,2019-02-01,79537,LES 2 VACHES FLAN BIO 100X4,0,0,0,LES 2 VACHES,0,LeMolay(FR),0083,0024 FR CHAPONNAY (DC),1077,945,945,847,98,98,0,0,-132,12.256267409470752,18,167,167,167,0,0,0,0,149,-827.7777777777778,100.0,100.0,0.0,100.0,89.62962962962962,10.370370370370381,Previsions
673,0,2019-02-01,79537,LES 2 VACHES FLAN BIO 100X4,0,0,0,LES 2 VACHES,0,LeMolay(FR),0079,0024 FR PARIS SUD (DC),1077,945,945,847,98,98,0,0,-132,12.256267409470752,175,121,121,75,46,46,0,0,-54,30.857142857142858,100.0,61.98347107438017,38.01652892561983,100.0,89.62962962962962,10.370370370370381,Previsions
674,0,2019-02-01,102497,ACTIVIA CHEESE STRAWBERRY 120X4,0,0,0,ACTIVIA,0,Ferrières(FR),0084,0024 FR AIX (DC),1366,1310,695,632,63,678,615,0,-56,4.099560761346998,177,158,106,81,25,77,52,0,-19,10.734463276836157,67.08860759493672,51.26582278481012,15.822784810126599,53.05343511450382,48.2442748091603,4.809160305343518,Previsions
675,0,2019-02-01,102497,ACTIVIA CHEESE STRAWBERRY 120X4,0,0,0,ACTIVIA,0,Ferrières(FR),0080,0024 FR METZ (DC),1366,1310,695,632,63,678,615,0,-56,4.099560761346998,111,107,80,80,0,27,27,0,-4,3.6036036036036037,74.76635514018692,74.76635514018692,0.0,53.05343511450382,48.2442748091603,4.809160305343518,Previsions
676,0,2019-02-01,102497,ACTIVIA CHEESE STRAWBERRY 120X4,0,0,0,ACTIVIA,0,Ferrières(FR),0081,0024 FR TOURS (DC),1366,1310,695,632,63,678,615,0,-56,4.099560761346998,144,113,78,76,2,37,35,0,-31,21.52777777777778,69.02654867256636,67.2566371681416,1.769911504424769,53.05343511450382,48.2442748091603,4.809160305343518,Previsions
677,0,2019-02-01,102497,ACTIVIA CHEESE STRAWBERRY 120X4,0,0,0,ACTIVIA,0,Ferrières(FR),0082,0024 FR VALLET (DC),1366,1310,695,632,63,678,615,0,-56,4.099560761346998,142,133,22,13,9,120,111,0,-9,6.338028169014085,16.541353383458645,9.774436090225564,6.766917293233082,53.05343511450382,48.2442748091603,4.809160305343518,Previsions
678,0,2019-02-01,102497,ACTIVIA CHEESE STRAWBERRY 120X4,0,0,0,ACTIVIA,0,Ferrières(FR),0077,0024 FR LILPARK (DC),1366,1310,695,632,63,678,615,0,-56,4.099560761346998,19,101,68,68,0,33,33,0,82,-431.57894736842104,67.32673267326733,67.32673267326733,0.0,53.05343511450382,48.2442748091603,4.809160305343518,Previsions
679,0,2019-02-01,102497,ACTIVIA CHEESE STRAWBERRY 120X4,0,0,0,ACTIVIA,0,Ferrières(FR),0085,0024 FR TOULOUSE (DC),1366,1310,695,632,63,678,615,0,-56,4.099560761346998,150,136,27,24,3,112,109,0,-14,9.333333333333334,19.852941176470587,17.647058823529413,2.205882352941174,53.05343511450382,48.2442748091603,4.809160305343518,Previsions
680,0,2019-02-01,102497,ACTIVIA CHEESE STRAWBERRY 120X4,0,0,0,ACTIVIA,0,Ferrières(FR),0083,0024 FR CHAPONNAY (DC),1366,1310,695,632,63,678,615,0,-56,4.099560761346998,171,141,22,17,5,124,119,0,-30,17.54385964912281,15.602836879432624,12.056737588652481,3.546099290780143,53.05343511450382,48.2442748091603,4.809160305343518,Previsions
681,0,2019-02-01,102497,ACTIVIA CHEESE STRAWBERRY 120X4,0,0,0,ACTIVIA,0,Ferrières(FR),0079,0024 FR PARIS SUD (DC),1366,1310,695,632,63,678,615,0,-56,4.099560761346998,309,301,172,153,19,148,129,0,-8,2.588996763754045,57.14285714285714,50.83056478405316,6.31229235880398,53.05343511450382,48.2442748091603,4.809160305343518,Previsions
682,0,2019-02-01,102497,ACTIVIA CHEESE STRAWBERRY 120X4,0,0,0,ACTIVIA,0,Ferrières(FR),0078,0024 FR PARIS NORD (DC),1366,1310,695,632,63,678,615,0,-56,4.099560761346998,143,120,120,120,0,0,0,0,-23,16.083916083916083,100.0,100.0,0.0,53.05343511450382,48.2442748091603,4.809160305343518,Previsions
683,0,2019-02-01,111730,LES 2 VACHES FOND CAFE 125X4,0,0,0,LES 2 VACHES,0,LeMolay(FR),0084,0024 FR AIX (DC),77,256,92,78,14,178,164,0,179,-232.46753246753246,5,44,7,3,4,41,37,0,39,-780.0,15.909090909090908,6.8181818181818175,9.09090909090909,35.9375,30.46875,5.46875,A Creuser
684,0,2019-02-01,111730,LES 2 VACHES FOND CAFE 125X4,0,0,0,LES 2 VACHES,0,LeMolay(FR),0080,0024 FR METZ (DC),77,256,92,78,14,178,164,0,179,-232.46753246753246,11,14,12,12,0,2,2,0,3,-27.272727272727273,85.71428571428571,85.71428571428571,0.0,35.9375,30.46875,5.46875,A Creuser
685,0,2019-02-01,111730,LES 2 VACHES FOND CAFE 125X4,0,0,0,LES 2 VACHES,0,LeMolay(FR),0081,0024 FR TOURS (DC),77,256,92,78,14,178,164,0,179,-232.46753246753246,2,30,30,22,8,8,0,0,28,-1400.0,100.0,73.33333333333333,26.66666666666667,35.9375,30.46875,5.46875,A Creuser
686,0,2019-02-01,111730,LES 2 VACHES FOND CAFE 125X4,0,0,0,LES 2 VACHES,0,LeMolay(FR),0082,0024 FR VALLET (DC),77,256,92,78,14,178,164,0,179,-232.46753246753246,1,20,2,1,1,19,18,0,19,-1900.0,10.0,5.0,5.0,35.9375,30.46875,5.46875,A Creuser
687,0,2019-02-01,111730,LES 2 VACHES FOND CAFE 125X4,0,0,0,LES 2 VACHES,0,LeMolay(FR),0077,0024 FR LILPARK (DC),77,256,92,78,14,178,164,0,179,-232.46753246753246,20,15,15,15,0,0,0,0,-5,25.0,100.0,100.0,0.0,35.9375,30.46875,5.46875,A Creuser
688,0,2019-02-01,111730,LES 2 VACHES FOND CAFE 125X4,0,0,0,LES 2 VACHES,0,LeMolay(FR),0085,0024 FR TOULOUSE (DC),77,256,92,78,14,178,164,0,179,-232.46753246753246,22,25,1,1,0,24,24,0,3,-13.636363636363637,4.0,4.0,0.0,35.9375,30.46875,5.46875,A Creuser
689,0,2019-02-01,111730,LES 2 VACHES FOND CAFE 125X4,0,0,0,LES 2 VACHES,0,LeMolay(FR),0083,0024 FR CHAPONNAY (DC),77,256,92,78,14,178,164,0,179,-232.46753246753246,9,56,10,10,0,46,46,0,47,-522.2222222222222,17.857142857142858,17.857142857142858,0.0,35.9375,30.46875,5.46875,A Creuser
690,0,2019-02-01,111730,LES 2 VACHES FOND CAFE 125X4,0,0,0,LES 2 VACHES,0,LeMolay(FR),0079,0024 FR PARIS SUD (DC),77,256,92,78,14,178,164,0,179,-232.46753246753246,1,42,8,7,1,35,34,0,41,-4100.0,19.047619047619047,16.666666666666664,2.380952380952383,35.9375,30.46875,5.46875,A Creuser
691,0,2019-02-01,111730,LES 2 VACHES FOND CAFE 125X4,0,0,0,LES 2 VACHES,0,LeMolay(FR),0078,0024 FR PARIS NORD (DC),77,256,92,78,14,178,164,0,179,-232.46753246753246,6,10,7,7,0,3,3,0,4,-66.66666666666667,70.0,70.0,0.0,35.9375,30.46875,5.46875,A Creuser
692,1,2019-02-02,83924,ACTIMEL STRA 3x(14x100g) FR,0,0,0,ACTIMEL,1,Rotselaar(BE),0085,0024 FR TOULOUSE (DC),291,4191,4174,4163,11,28,17,0,3900,-1340.2061855670104,291,189,173,170,3,19,16,0,-102,35.05154639175258,91.53439153439153,89.94708994708994,1.5873015873015959,99.59436888570747,99.33190169410642,0.26246719160104703,Client
693,1,2019-02-02,113943,ACTIVIA NATURE 125X16 OD,1,0,0,ACTIVIA,0,Bailleul(FR),0083,0024 FR CHAPONNAY (DC),1270,9272,9247,9247,0,25,25,0,8002,-630.0787401574803,1270,2358,2333,2333,0,25,25,0,1088,-85.66929133858268,98.93977947413062,98.93977947413062,0.0,99.73037100949094,99.73037100949094,0.0,Client
694,0,2019-02-02,122061,VELOUTE FRUIX JAUNES 125X8 OD,1,0,0,VELOUTE,0,Villecomtal(FR),0084,0024 FR AIX (DC),1093,1483,1344,1344,0,139,139,0,390,-35.68161024702653,37,54,54,54,0,0,0,0,17,-45.945945945945944,100.0,100.0,0.0,90.62710721510452,90.62710721510452,0.0,Previsions
695,0,2019-02-02,122061,VELOUTE FRUIX JAUNES 125X8 OD,1,0,0,VELOUTE,0,Villecomtal(FR),0080,0024 FR METZ (DC),1093,1483,1344,1344,0,139,139,0,390,-35.68161024702653,1,75,75,75,0,0,0,0,74,-7400.0,100.0,100.0,0.0,90.62710721510452,90.62710721510452,0.0,Previsions
696,0,2019-02-02,122061,VELOUTE FRUIX JAUNES 125X8 OD,1,0,0,VELOUTE,0,Villecomtal(FR),0081,0024 FR TOURS (DC),1093,1483,1344,1344,0,139,139,0,390,-35.68161024702653,46,141,141,141,0,0,0,0,95,-206.52173913043478,100.0,100.0,0.0,90.62710721510452,90.62710721510452,0.0,Previsions
697,0,2019-02-02,122061,VELOUTE FRUIX JAUNES 125X8 OD,1,0,0,VELOUTE,0,Villecomtal(FR),0082,0024 FR VALLET (DC),1093,1483,1344,1344,0,139,139,0,390,-35.68161024702653,30,75,75,75,0,0,0,0,45,-150.0,100.0,100.0,0.0,90.62710721510452,90.62710721510452,0.0,Previsions
698,0,2019-02-02,122061,VELOUTE FRUIX JAUNES 125X8 OD,1,0,0,VELOUTE,0,Villecomtal(FR),0077,0024 FR LILPARK (DC),1093,1483,1344,1344,0,139,139,0,390,-35.68161024702653,106,277,138,138,0,139,139,0,171,-161.32075471698113,49.81949458483754,49.81949458483754,0.0,90.62710721510452,90.62710721510452,0.0,Previsions
699,1,2019-02-02,122061,VELOUTE FRUIX JAUNES 125X8 OD,1,0,0,VELOUTE,0,Villecomtal(FR),0077,0024 FR LILPARK (DC),1093,1483,1344,1344,0,139,139,0,390,-35.68161024702653,106,277,138,138,0,139,139,0,171,-161.32075471698113,49.81949458483754,49.81949458483754,0.0,90.62710721510452,90.62710721510452,0.0,Previsions
700,0,2019-02-02,122061,VELOUTE FRUIX JAUNES 125X8 OD,1,0,0,VELOUTE,0,Villecomtal(FR),0085,0024 FR TOULOUSE (DC),1093,1483,1344,1344,0,139,139,0,390,-35.68161024702653,441,313,313,313,0,0,0,0,-128,29.024943310657598,100.0,100.0,0.0,90.62710721510452,90.62710721510452,0.0,Previsions
701,0,2019-02-02,122061,VELOUTE FRUIX JAUNES 125X8 OD,1,0,0,VELOUTE,0,Villecomtal(FR),0083,0024 FR CHAPONNAY (DC),1093,1483,1344,1344,0,139,139,0,390,-35.68161024702653,261,255,255,255,0,0,0,0,-6,2.2988505747126435,100.0,100.0,0.0,90.62710721510452,90.62710721510452,0.0,Previsions
702,0,2019-02-02,122061,VELOUTE FRUIX JAUNES 125X8 OD,1,0,0,VELOUTE,0,Villecomtal(FR),0079,0024 FR PARIS SUD (DC),1093,1483,1344,1344,0,139,139,0,390,-35.68161024702653,41,250,250,250,0,0,0,0,209,-509.7560975609756,100.0,100.0,0.0,90.62710721510452,90.62710721510452,0.0,Previsions
703,0,2019-02-02,122061,VELOUTE FRUIX JAUNES 125X8 OD,1,0,0,VELOUTE,0,Villecomtal(FR),0078,0024 FR PARIS NORD (DC),1093,1483,1344,1344,0,139,139,0,390,-35.68161024702653,24,43,43,43,0,0,0,0,19,-79.16666666666667,100.0,100.0,0.0,90.62710721510452,90.62710721510452,0.0,Previsions
704,0,2019-02-02,131288,ACTIMEL STRA-NATU 3x(8x100g) FR,1,0,0,ACTIMEL,1,Rotselaar(BE),0084,0024 FR AIX (DC),101,254,164,108,56,146,90,0,153,-151.4851485148515,1,28,3,3,0,25,25,0,27,-2700.0,10.714285714285714,10.714285714285714,0.0,64.56692913385827,42.51968503937008,22.047244094488185,Previsions
705,0,2019-02-02,131288,ACTIMEL STRA-NATU 3x(8x100g) FR,1,0,0,ACTIMEL,1,Rotselaar(BE),0082,0024 FR VALLET (DC),101,254,164,108,56,146,90,0,153,-151.4851485148515,14,16,16,16,0,0,0,0,2,-14.285714285714286,100.0,100.0,0.0,64.56692913385827,42.51968503937008,22.047244094488185,Previsions
706,0,2019-02-02,131288,ACTIMEL STRA-NATU 3x(8x100g) FR,1,0,0,ACTIMEL,1,Rotselaar(BE),0083,0024 FR CHAPONNAY (DC),101,254,164,108,56,146,90,0,153,-151.4851485148515,22,29,29,29,0,0,0,0,7,-31.818181818181817,100.0,100.0,0.0,64.56692913385827,42.51968503937008,22.047244094488185,Previsions
707,0,2019-02-02,131288,ACTIMEL STRA-NATU 3x(8x100g) FR,1,0,0,ACTIMEL,1,Rotselaar(BE),0079,0024 FR PARIS SUD (DC),101,254,164,108,56,146,90,0,153,-151.4851485148515,30,84,57,8,49,76,27,0,54,-180.0,67.85714285714286,9.523809523809524,58.333333333333336,64.56692913385827,42.51968503937008,22.047244094488185,Previsions
708,0,2019-02-02,131288,ACTIMEL STRA-NATU 3x(8x100g) FR,1,0,0,ACTIMEL,1,Rotselaar(BE),0078,0024 FR PARIS NORD (DC),101,254,164,108,56,146,90,0,153,-151.4851485148515,34,97,59,52,7,45,38,0,63,-185.2941176470588,60.824742268041234,53.608247422680414,7.21649484536082,64.56692913385827,42.51968503937008,22.047244094488185,Previsions
709,0,2019-02-04,83925,ACTIMEL 0% NATU 3x(14x100g) FR,0,0,0,ACTIMEL,1,Rotselaar(BE),0084,0024 FR AIX (DC),1096,667,580,576,4,91,87,0,-429,39.14233576642336,148,90,89,87,2,3,1,0,-58,39.189189189189186,98.88888888888889,96.66666666666667,2.2222222222222143,86.95652173913044,86.3568215892054,0.5997001499250416,Client
710,0,2019-02-04,83925,ACTIMEL 0% NATU 3x(14x100g) FR,0,0,0,ACTIMEL,1,Rotselaar(BE),0081,0024 FR TOURS (DC),1096,667,580,576,4,91,87,0,-429,39.14233576642336,6,19,19,19,0,0,0,0,13,-216.66666666666666,100.0,100.0,0.0,86.95652173913044,86.3568215892054,0.5997001499250416,Client
711,0,2019-02-04,83925,ACTIMEL 0% NATU 3x(14x100g) FR,0,0,0,ACTIMEL,1,Rotselaar(BE),0082,0024 FR VALLET (DC),1096,667,580,576,4,91,87,0,-429,39.14233576642336,6,40,40,40,0,0,0,0,34,-566.6666666666666,100.0,100.0,0.0,86.95652173913044,86.3568215892054,0.5997001499250416,Client
712,0,2019-02-04,83925,ACTIMEL 0% NATU 3x(14x100g) FR,0,0,0,ACTIMEL,1,Rotselaar(BE),0085,0024 FR TOULOUSE (DC),1096,667,580,576,4,91,87,0,-429,39.14233576642336,18,32,14,12,2,20,18,0,14,-77.77777777777777,43.75,37.5,6.25,86.95652173913044,86.3568215892054,0.5997001499250416,Client
713,0,2019-02-04,83925,ACTIMEL 0% NATU 3x(14x100g) FR,0,0,0,ACTIMEL,1,Rotselaar(BE),0083,0024 FR CHAPONNAY (DC),1096,667,580,576,4,91,87,0,-429,39.14233576642336,184,104,36,36,0,68,68,0,-80,43.47826086956522,34.61538461538461,34.61538461538461,0.0,86.95652173913044,86.3568215892054,0.5997001499250416,Client
714,1,2019-02-04,83925,ACTIMEL 0% NATU 3x(14x100g) FR,0,0,0,ACTIMEL,1,Rotselaar(BE),0083,0024 FR CHAPONNAY (DC),1096,667,580,576,4,91,87,0,-429,39.14233576642336,184,104,36,36,0,68,68,0,-80,43.47826086956522,34.61538461538461,34.61538461538461,0.0,86.95652173913044,86.3568215892054,0.5997001499250416,Client
715,0,2019-02-04,83925,ACTIMEL 0% NATU 3x(14x100g) FR,0,0,0,ACTIMEL,1,Rotselaar(BE),0079,0024 FR PARIS SUD (DC),1096,667,580,576,4,91,87,0,-429,39.14233576642336,234,188,188,188,0,0,0,0,-46,19.65811965811966,100.0,100.0,0.0,86.95652173913044,86.3568215892054,0.5997001499250416,Client
716,0,2019-02-04,83925,ACTIMEL 0% NATU 3x(14x100g) FR,0,0,0,ACTIMEL,1,Rotselaar(BE),0078,0024 FR PARIS NORD (DC),1096,667,580,576,4,91,87,0,-429,39.14233576642336,316,194,194,194,0,0,0,0,-122,38.607594936708864,100.0,100.0,0.0,86.95652173913044,86.3568215892054,0.5997001499250416,Client
717,0,2019-02-04,113943,ACTIVIA NATURE 125X16 OD,1,0,0,ACTIVIA,0,Bailleul(FR),0084,0024 FR AIX (DC),1591,4535,4450,4255,195,280,85,0,2944,-185.04085480829667,340,551,550,550,0,1,1,0,211,-62.05882352941177,99.8185117967332,99.8185117967332,0.0,98.12568908489526,93.8257993384785,4.299889746416753,Client
718,0,2019-02-04,113943,ACTIVIA NATURE 125X16 OD,1,0,0,ACTIVIA,0,Bailleul(FR),0080,0024 FR METZ (DC),1591,4535,4450,4255,195,280,85,0,2944,-185.04085480829667,52,99,99,99,0,0,0,0,47,-90.38461538461539,100.0,100.0,0.0,98.12568908489526,93.8257993384785,4.299889746416753,Client
719,0,2019-02-04,113943,ACTIVIA NATURE 125X16 OD,1,0,0,ACTIVIA,0,Bailleul(FR),0081,0024 FR TOURS (DC),1591,4535,4450,4255,195,280,85,0,2944,-185.04085480829667,66,301,301,257,44,44,0,0,235,-356.06060606060606,100.0,85.38205980066445,14.61794019933555,98.12568908489526,93.8257993384785,4.299889746416753,Client
720,0,2019-02-04,113943,ACTIVIA NATURE 125X16 OD,1,0,0,ACTIVIA,0,Bailleul(FR),0082,0024 FR VALLET (DC),1591,4535,4450,4255,195,280,85,0,2944,-185.04085480829667,93,232,232,232,0,0,0,0,139,-149.46236559139786,100.0,100.0,0.0,98.12568908489526,93.8257993384785,4.299889746416753,Client
721,0,2019-02-04,113943,ACTIVIA NATURE 125X16 OD,1,0,0,ACTIVIA,0,Bailleul(FR),0077,0024 FR LILPARK (DC),1591,4535,4450,4255,195,280,85,0,2944,-185.04085480829667,212,541,541,541,0,0,0,0,329,-155.18867924528303,100.0,100.0,0.0,98.12568908489526,93.8257993384785,4.299889746416753,Client
722,0,2019-02-04,113943,ACTIVIA NATURE 125X16 OD,1,0,0,ACTIVIA,0,Bailleul(FR),0085,0024 FR TOULOUSE (DC),1591,4535,4450,4255,195,280,85,0,2944,-185.04085480829667,53,196,182,147,35,49,14,0,143,-269.811320754717,92.85714285714286,75.0,17.85714285714286,98.12568908489526,93.8257993384785,4.299889746416753,Client
723,1,2019-02-04,113943,ACTIVIA NATURE 125X16 OD,1,0,0,ACTIVIA,0,Bailleul(FR),0085,0024 FR TOULOUSE (DC),1591,4535,4450,4255,195,280,85,0,2944,-185.04085480829667,53,196,182,147,35,49,14,0,143,-269.811320754717,92.85714285714286,75.0,17.85714285714286,98.12568908489526,93.8257993384785,4.299889746416753,Client
724,0,2019-02-04,113943,ACTIVIA NATURE 125X16 OD,1,0,0,ACTIVIA,0,Bailleul(FR),0083,0024 FR CHAPONNAY (DC),1591,4535,4450,4255,195,280,85,0,2944,-185.04085480829667,575,958,906,906,0,52,52,0,383,-66.6086956521739,94.57202505219206,94.57202505219206,0.0,98.12568908489526,93.8257993384785,4.299889746416753,Client
725,0,2019-02-04,113943,ACTIVIA NATURE 125X16 OD,1,0,0,ACTIVIA,0,Bailleul(FR),0079,0024 FR PARIS SUD (DC),1591,4535,4450,4255,195,280,85,0,2944,-185.04085480829667,43,837,837,837,0,0,0,0,794,-1846.5116279069769,100.0,100.0,0.0,98.12568908489526,93.8257993384785,4.299889746416753,Client
726,0,2019-02-04,113943,ACTIVIA NATURE 125X16 OD,1,0,0,ACTIVIA,0,Bailleul(FR),0078,0024 FR PARIS NORD (DC),1591,4535,4450,4255,195,280,85,0,2944,-185.04085480829667,52,820,802,686,116,134,18,0,768,-1476.923076923077,97.80487804878048,83.65853658536585,14.146341463414629,98.12568908489526,93.8257993384785,4.299889746416753,Client
727,1,2019-02-04,113943,ACTIVIA NATURE 125X16 OD,1,0,0,ACTIVIA,0,Bailleul(FR),0078,0024 FR PARIS NORD (DC),1591,4535,4450,4255,195,280,85,0,2944,-185.04085480829667,52,820,802,686,116,134,18,0,768,-1476.923076923077,97.80487804878048,83.65853658536585,14.146341463414629,98.12568908489526,93.8257993384785,4.299889746416753,Client
728,0,2019-02-04,142579,DANONE FERM NAT 125X12+4,1,1,0,DANONE,0,Bailleul(FR),0084,0024 FR AIX (DC),935,586,586,436,150,150,0,0,-349,37.32620320855615,40,22,22,22,0,0,0,0,-18,45.0,100.0,100.0,0.0,100.0,74.40273037542661,25.597269624573386,A Creuser
729,0,2019-02-04,142579,DANONE FERM NAT 125X12+4,1,1,0,DANONE,0,Bailleul(FR),0080,0024 FR METZ (DC),935,586,586,436,150,150,0,0,-349,37.32620320855615,39,20,20,10,10,10,0,0,-19,48.717948717948715,100.0,50.0,50.0,100.0,74.40273037542661,25.597269624573386,A Creuser
730,0,2019-02-04,142579,DANONE FERM NAT 125X12+4,1,1,0,DANONE,0,Bailleul(FR),0081,0024 FR TOURS (DC),935,586,586,436,150,150,0,0,-349,37.32620320855615,124,67,67,35,32,32,0,0,-57,45.96774193548387,100.0,52.23880597014925,47.76119402985075,100.0,74.40273037542661,25.597269624573386,A Creuser
731,0,2019-02-04,142579,DANONE FERM NAT 125X12+4,1,1,0,DANONE,0,Bailleul(FR),0077,0024 FR LILPARK (DC),935,586,586,436,150,150,0,0,-349,37.32620320855615,15,84,84,84,0,0,0,0,69,-460.0,100.0,100.0,0.0,100.0,74.40273037542661,25.597269624573386,A Creuser
732,0,2019-02-04,142579,DANONE FERM NAT 125X12+4,1,1,0,DANONE,0,Bailleul(FR),0085,0024 FR TOULOUSE (DC),935,586,586,436,150,150,0,0,-349,37.32620320855615,69,37,37,37,0,0,0,0,-32,46.3768115942029,100.0,100.0,0.0,100.0,74.40273037542661,25.597269624573386,A Creuser
733,0,2019-02-04,142579,DANONE FERM NAT 125X12+4,1,1,0,DANONE,0,Bailleul(FR),0083,0024 FR CHAPONNAY (DC),935,586,586,436,150,150,0,0,-349,37.32620320855615,151,80,80,80,0,0,0,0,-71,47.019867549668874,100.0,100.0,0.0,100.0,74.40273037542661,25.597269624573386,A Creuser
734,0,2019-02-04,142579,DANONE FERM NAT 125X12+4,1,1,0,DANONE,0,Bailleul(FR),0079,0024 FR PARIS SUD (DC),935,586,586,436,150,150,0,0,-349,37.32620320855615,233,130,130,130,0,0,0,0,-103,44.20600858369099,100.0,100.0,0.0,100.0,74.40273037542661,25.597269624573386,A Creuser
735,0,2019-02-04,142579,DANONE FERM NAT 125X12+4,1,1,0,DANONE,0,Bailleul(FR),0078,0024 FR PARIS NORD (DC),935,586,586,436,150,150,0,0,-349,37.32620320855615,264,146,146,38,108,108,0,0,-118,44.696969696969695,100.0,26.027397260273972,73.97260273972603,100.0,74.40273037542661,25.597269624573386,A Creuser
736,1,2019-02-05,113631,GERVITA NATURE 100X8 OPL,0,0,0,GERVITA,0,Ferrières(FR),0081,0024 FR TOURS (DC),142,1375,1375,1296,79,79,0,0,1233,-868.3098591549295,142,113,113,34,79,79,0,0,-29,20.422535211267604,100.0,30.08849557522124,69.91150442477876,100.0,94.25454545454545,5.74545454545455,Transport
737,0,2019-02-05,133904,DANONE BIO NATURE SUCRE 125X4,0,0,0,DANONE,0,Bailleul(FR),0084,0024 FR AIX (DC),732,625,613,450,163,175,12,0,-107,14.617486338797814,80,18,18,18,0,0,0,0,-62,77.5,100.0,100.0,0.0,98.08,72.0,26.08,Previsions
738,0,2019-02-05,133904,DANONE BIO NATURE SUCRE 125X4,0,0,0,DANONE,0,Bailleul(FR),0080,0024 FR METZ (DC),732,625,613,450,163,175,12,0,-107,14.617486338797814,30,14,14,14,0,0,0,0,-16,53.333333333333336,100.0,100.0,0.0,98.08,72.0,26.08,Previsions
739,0,2019-02-05,133904,DANONE BIO NATURE SUCRE 125X4,0,0,0,DANONE,0,Bailleul(FR),0081,0024 FR TOURS (DC),732,625,613,450,163,175,12,0,-107,14.617486338797814,87,16,16,16,0,0,0,0,-71,81.60919540229885,100.0,100.0,0.0,98.08,72.0,26.08,Previsions
740,0,2019-02-05,133904,DANONE BIO NATURE SUCRE 125X4,0,0,0,DANONE,0,Bailleul(FR),0082,0024 FR VALLET (DC),732,625,613,450,163,175,12,0,-107,14.617486338797814,32,16,16,16,0,0,0,0,-16,50.0,100.0,100.0,0.0,98.08,72.0,26.08,Previsions
741,0,2019-02-05,133904,DANONE BIO NATURE SUCRE 125X4,0,0,0,DANONE,0,Bailleul(FR),0077,0024 FR LILPARK (DC),732,625,613,450,163,175,12,0,-107,14.617486338797814,65,33,33,33,0,0,0,0,-32,49.23076923076923,100.0,100.0,0.0,98.08,72.0,26.08,Previsions
742,0,2019-02-05,133904,DANONE BIO NATURE SUCRE 125X4,0,0,0,DANONE,0,Bailleul(FR),0085,0024 FR TOULOUSE (DC),732,625,613,450,163,175,12,0,-107,14.617486338797814,88,160,160,160,0,0,0,0,72,-81.81818181818181,100.0,100.0,0.0,98.08,72.0,26.08,Previsions
743,0,2019-02-05,133904,DANONE BIO NATURE SUCRE 125X4,0,0,0,DANONE,0,Bailleul(FR),0083,0024 FR CHAPONNAY (DC),732,625,613,450,163,175,12,0,-107,14.617486338797814,58,37,37,37,0,0,0,0,-21,36.206896551724135,100.0,100.0,0.0,98.08,72.0,26.08,Previsions
744,0,2019-02-05,133904,DANONE BIO NATURE SUCRE 125X4,0,0,0,DANONE,0,Bailleul(FR),0079,0024 FR PARIS SUD (DC),732,625,613,450,163,175,12,0,-107,14.617486338797814,52,31,31,31,0,0,0,0,-21,40.38461538461539,100.0,100.0,0.0,98.08,72.0,26.08,Previsions
745,0,2019-02-05,133904,DANONE BIO NATURE SUCRE 125X4,0,0,0,DANONE,0,Bailleul(FR),0078,0024 FR PARIS NORD (DC),732,625,613,450,163,175,12,0,-107,14.617486338797814,240,300,288,125,163,175,12,0,60,-25.0,96.0,41.66666666666667,54.33333333333333,98.08,72.0,26.08,Previsions
746,0,2019-02-05,135066,ACTIVIA SAV VANILLE 125X12 OD,1,0,0,ACTIVIA,0,Bailleul(FR),0084,0024 FR AIX (DC),542,728,239,183,56,545,489,0,186,-34.31734317343174,77,100,39,39,0,61,61,0,23,-29.87012987012987,39.0,39.0,0.0,32.82967032967033,25.137362637362635,7.692307692307693,Client
747,0,2019-02-05,135066,ACTIVIA SAV VANILLE 125X12 OD,1,0,0,ACTIVIA,0,Bailleul(FR),0081,0024 FR TOURS (DC),542,728,239,183,56,545,489,0,186,-34.31734317343174,0,21,11,3,8,18,10,1,21,10000.0,52.38095238095239,14.285714285714285,38.0952380952381,32.82967032967033,25.137362637362635,7.692307692307693,Client
748,0,2019-02-05,135066,ACTIVIA SAV VANILLE 125X12 OD,1,0,0,ACTIVIA,0,Bailleul(FR),0082,0024 FR VALLET (DC),542,728,239,183,56,545,489,0,186,-34.31734317343174,44,93,16,15,1,78,77,0,49,-111.36363636363636,17.20430107526882,16.129032258064516,1.0752688172043037,32.82967032967033,25.137362637362635,7.692307692307693,Client
749,0,2019-02-05,135066,ACTIVIA SAV VANILLE 125X12 OD,1,0,0,ACTIVIA,0,Bailleul(FR),0077,0024 FR LILPARK (DC),542,728,239,183,56,545,489,0,186,-34.31734317343174,24,29,29,29,0,0,0,0,5,-20.833333333333332,100.0,100.0,0.0,32.82967032967033,25.137362637362635,7.692307692307693,Client
750,0,2019-02-05,135066,ACTIVIA SAV VANILLE 125X12 OD,1,0,0,ACTIVIA,0,Bailleul(FR),0085,0024 FR TOULOUSE (DC),542,728,239,183,56,545,489,0,186,-34.31734317343174,120,74,74,32,42,42,0,0,-46,38.333333333333336,100.0,43.24324324324324,56.75675675675676,32.82967032967033,25.137362637362635,7.692307692307693,Client
751,0,2019-02-05,135066,ACTIVIA SAV VANILLE 125X12 OD,1,0,0,ACTIVIA,0,Bailleul(FR),0083,0024 FR CHAPONNAY (DC),542,728,239,183,56,545,489,0,186,-34.31734317343174,145,201,58,54,4,147,143,0,56,-38.62068965517241,28.855721393034827,26.865671641791046,1.990049751243781,32.82967032967033,25.137362637362635,7.692307692307693,Client
752,0,2019-02-05,135066,ACTIVIA SAV VANILLE 125X12 OD,1,0,0,ACTIVIA,0,Bailleul(FR),0079,0024 FR PARIS SUD (DC),542,728,239,183,56,545,489,0,186,-34.31734317343174,5,69,8,8,0,61,61,0,64,-1280.0,11.594202898550725,11.594202898550725,0.0,32.82967032967033,25.137362637362635,7.692307692307693,Client
753,0,2019-02-05,135066,ACTIVIA SAV VANILLE 125X12 OD,1,0,0,ACTIVIA,0,Bailleul(FR),0078,0024 FR PARIS NORD (DC),542,728,239,183,56,545,489,0,186,-34.31734317343174,127,141,4,3,1,138,137,0,14,-11.023622047244094,2.8368794326241136,2.127659574468085,0.7092198581560285,32.82967032967033,25.137362637362635,7.692307692307693,Client
754,0,2019-02-06,32787,TAILLEF CHEESE PEACH 120GX4,0,0,0,TAILLEFINE,0,Ferrières(FR),0084,0024 FR AIX (DC),286,301,230,228,2,73,71,0,15,-5.244755244755245,107,79,79,79,0,0,0,0,-28,26.16822429906542,100.0,100.0,0.0,76.41196013289037,75.74750830564784,0.6644518272425302,Qualité
755,0,2019-02-06,32787,TAILLEF CHEESE PEACH 120GX4,0,0,0,TAILLEFINE,0,Ferrières(FR),0082,0024 FR VALLET (DC),286,301,230,228,2,73,71,0,15,-5.244755244755245,80,63,63,63,0,0,0,0,-17,21.25,100.0,100.0,0.0,76.41196013289037,75.74750830564784,0.6644518272425302,Qualité
756,0,2019-02-06,32787,TAILLEF CHEESE PEACH 120GX4,0,0,0,TAILLEFINE,0,Ferrières(FR),0077,0024 FR LILPARK (DC),286,301,230,228,2,73,71,0,15,-5.244755244755245,37,47,47,47,0,0,0,0,10,-27.027027027027028,100.0,100.0,0.0,76.41196013289037,75.74750830564784,0.6644518272425302,Qualité
757,0,2019-02-06,32787,TAILLEF CHEESE PEACH 120GX4,0,0,0,TAILLEFINE,0,Ferrières(FR),0085,0024 FR TOULOUSE (DC),286,301,230,228,2,73,71,0,15,-5.244755244755245,8,76,5,3,2,73,71,0,68,-850.0,6.578947368421052,3.9473684210526314,2.631578947368421,76.41196013289037,75.74750830564784,0.6644518272425302,Qualité
758,0,2019-02-06,32787,TAILLEF CHEESE PEACH 120GX4,0,0,0,TAILLEFINE,0,Ferrières(FR),0078,0024 FR PARIS NORD (DC),286,301,230,228,2,73,71,0,15,-5.244755244755245,54,36,36,36,0,0,0,0,-18,33.333333333333336,100.0,100.0,0.0,76.41196013289037,75.74750830564784,0.6644518272425302,Qualité
759,0,2019-02-06,47029,PETITE DANETTE VANILLA 70X6,0,0,0,DANETTE,0,LeMolay(FR),0084,0024 FR AIX (DC),514,601,601,601,0,0,0,0,87,-16.926070038910506,86,101,101,101,0,0,0,0,15,-17.441860465116278,100.0,100.0,0.0,100.0,100.0,0.0,Previsions
760,0,2019-02-06,47029,PETITE DANETTE VANILLA 70X6,0,0,0,DANETTE,0,LeMolay(FR),0080,0024 FR METZ (DC),514,601,601,601,0,0,0,0,87,-16.926070038910506,160,141,141,141,0,0,0,0,-19,11.875,100.0,100.0,0.0,100.0,100.0,0.0,Previsions
761,0,2019-02-06,47029,PETITE DANETTE VANILLA 70X6,0,0,0,DANETTE,0,LeMolay(FR),0081,0024 FR TOURS (DC),514,601,601,601,0,0,0,0,87,-16.926070038910506,38,63,63,63,0,0,0,0,25,-65.78947368421052,100.0,100.0,0.0,100.0,100.0,0.0,Previsions
762,0,2019-02-06,47029,PETITE DANETTE VANILLA 70X6,0,0,0,DANETTE,0,LeMolay(FR),0082,0024 FR VALLET (DC),514,601,601,601,0,0,0,0,87,-16.926070038910506,76,58,58,58,0,0,0,0,-18,23.68421052631579,100.0,100.0,0.0,100.0,100.0,0.0,Previsions
763,0,2019-02-06,47029,PETITE DANETTE VANILLA 70X6,0,0,0,DANETTE,0,LeMolay(FR),0085,0024 FR TOULOUSE (DC),514,601,601,601,0,0,0,0,87,-16.926070038910506,52,59,59,59,0,0,0,0,7,-13.461538461538462,100.0,100.0,0.0,100.0,100.0,0.0,Previsions
764,0,2019-02-06,47029,PETITE DANETTE VANILLA 70X6,0,0,0,DANETTE,0,LeMolay(FR),0083,0024 FR CHAPONNAY (DC),514,601,601,601,0,0,0,0,87,-16.926070038910506,52,59,59,59,0,0,0,0,7,-13.461538461538462,100.0,100.0,0.0,100.0,100.0,0.0,Previsions
765,0,2019-02-06,47029,PETITE DANETTE VANILLA 70X6,0,0,0,DANETTE,0,LeMolay(FR),0079,0024 FR PARIS SUD (DC),514,601,601,601,0,0,0,0,87,-16.926070038910506,1,69,69,69,0,0,0,0,68,-6800.0,100.0,100.0,0.0,100.0,100.0,0.0,Previsions
766,0,2019-02-06,47029,PETITE DANETTE VANILLA 70X6,0,0,0,DANETTE,0,LeMolay(FR),0078,0024 FR PARIS NORD (DC),514,601,601,601,0,0,0,0,87,-16.926070038910506,49,51,51,51,0,0,0,0,2,-4.081632653061225,100.0,100.0,0.0,100.0,100.0,0.0,Previsions
767,0,2019-02-06,83923,ACTIMEL NATU 3x(14x100g) FR,0,0,0,ACTIMEL,1,Rotselaar(BE),0084,0024 FR AIX (DC),903,526,465,415,50,111,61,0,-377,41.74972314507198,63,38,34,33,1,5,4,0,-25,39.682539682539684,89.47368421052632,86.8421052631579,2.6315789473684106,88.40304182509506,78.89733840304183,9.50570342205323,Previsions
768,0,2019-02-06,83923,ACTIMEL NATU 3x(14x100g) FR,0,0,0,ACTIMEL,1,Rotselaar(BE),0081,0024 FR TOURS (DC),903,526,465,415,50,111,61,0,-377,41.74972314507198,0,2,2,2,0,0,0,1,2,10000.0,100.0,100.0,0.0,88.40304182509506,78.89733840304183,9.50570342205323,Previsions
769,0,2019-02-06,83923,ACTIMEL NATU 3x(14x100g) FR,0,0,0,ACTIMEL,1,Rotselaar(BE),0082,0024 FR VALLET (DC),903,526,465,415,50,111,61,0,-377,41.74972314507198,25,15,15,0,15,15,0,0,-10,40.0,100.0,0.0,100.0,88.40304182509506,78.89733840304183,9.50570342205323,Previsions
770,0,2019-02-06,83923,ACTIMEL NATU 3x(14x100g) FR,0,0,0,ACTIMEL,1,Rotselaar(BE),0077,0024 FR LILPARK (DC),903,526,465,415,50,111,61,0,-377,41.74972314507198,37,23,23,23,0,0,0,0,-14,37.83783783783784,100.0,100.0,0.0,88.40304182509506,78.89733840304183,9.50570342205323,Previsions
771,0,2019-02-06,83923,ACTIMEL NATU 3x(14x100g) FR,0,0,0,ACTIMEL,1,Rotselaar(BE),0083,0024 FR CHAPONNAY (DC),903,526,465,415,50,111,61,0,-377,41.74972314507198,180,105,48,48,0,57,57,0,-75,41.666666666666664,45.714285714285715,45.714285714285715,0.0,88.40304182509506,78.89733840304183,9.50570342205323,Previsions
772,0,2019-02-06,83923,ACTIMEL NATU 3x(14x100g) FR,0,0,0,ACTIMEL,1,Rotselaar(BE),0079,0024 FR PARIS SUD (DC),903,526,465,415,50,111,61,0,-377,41.74972314507198,79,44,44,44,0,0,0,0,-35,44.30379746835443,100.0,100.0,0.0,88.40304182509506,78.89733840304183,9.50570342205323,Previsions
773,0,2019-02-06,83923,ACTIMEL NATU 3x(14x100g) FR,0,0,0,ACTIMEL,1,Rotselaar(BE),0078,0024 FR PARIS NORD (DC),903,526,465,415,50,111,61,0,-377,41.74972314507198,519,299,299,265,34,34,0,0,-220,42.38921001926782,100.0,88.62876254180601,11.371237458193988,88.40304182509506,78.89733840304183,9.50570342205323,Previsions
774,0,2019-02-06,83924,ACTIMEL STRA 3x(14x100g) FR,0,0,0,ACTIMEL,1,Rotselaar(BE),0084,0024 FR AIX (DC),1472,874,829,767,62,107,45,0,-598,40.625,53,32,2,2,0,30,30,0,-21,39.62264150943396,6.25,6.25,0.0,94.8512585812357,87.75743707093821,7.093821510297488,Previsions
775,0,2019-02-06,83924,ACTIMEL STRA 3x(14x100g) FR,0,0,0,ACTIMEL,1,Rotselaar(BE),0081,0024 FR TOURS (DC),1472,874,829,767,62,107,45,0,-598,40.625,0,16,16,16,0,0,0,1,16,10000.0,100.0,100.0,0.0,94.8512585812357,87.75743707093821,7.093821510297488,Previsions
776,0,2019-02-06,83924,ACTIMEL STRA 3x(14x100g) FR,0,0,0,ACTIMEL,1,Rotselaar(BE),0082,0024 FR VALLET (DC),1472,874,829,767,62,107,45,0,-598,40.625,47,29,29,0,29,29,0,0,-18,38.297872340425535,100.0,0.0,100.0,94.8512585812357,87.75743707093821,7.093821510297488,Previsions
777,0,2019-02-06,83924,ACTIMEL STRA 3x(14x100g) FR,0,0,0,ACTIMEL,1,Rotselaar(BE),0077,0024 FR LILPARK (DC),1472,874,829,767,62,107,45,0,-598,40.625,56,35,35,35,0,0,0,0,-21,37.5,100.0,100.0,0.0,94.8512585812357,87.75743707093821,7.093821510297488,Previsions
778,0,2019-02-06,83924,ACTIMEL STRA 3x(14x100g) FR,0,0,0,ACTIMEL,1,Rotselaar(BE),0085,0024 FR TOULOUSE (DC),1472,874,829,767,62,107,45,0,-598,40.625,92,57,57,57,0,0,0,0,-35,38.04347826086956,100.0,100.0,0.0,94.8512585812357,87.75743707093821,7.093821510297488,Previsions
779,0,2019-02-06,83924,ACTIMEL STRA 3x(14x100g) FR,0,0,0,ACTIMEL,1,Rotselaar(BE),0083,0024 FR CHAPONNAY (DC),1472,874,829,767,62,107,45,0,-598,40.625,296,171,171,171,0,0,0,0,-125,42.229729729729726,100.0,100.0,0.0,94.8512585812357,87.75743707093821,7.093821510297488,Previsions
780,0,2019-02-06,83924,ACTIMEL STRA 3x(14x100g) FR,0,0,0,ACTIMEL,1,Rotselaar(BE),0078,0024 FR PARIS NORD (DC),1472,874,829,767,62,107,45,0,-598,40.625,928,534,519,486,33,48,15,0,-394,42.456896551724135,97.19101123595506,91.01123595505618,6.17977528089888,94.8512585812357,87.75743707093821,7.093821510297488,Previsions
781,0,2019-02-06,120841,VELOUTE FRUIX PANACHES 125X8 AFH,0,0,1,VELOUTE,0,Villecomtal(FR),0084,0024 FR AIX (DC),1678,1928,1789,1789,0,139,139,0,250,-14.898688915375446,184,252,252,252,0,0,0,0,68,-36.95652173913044,100.0,100.0,0.0,92.79045643153528,92.79045643153528,0.0,Previsions
782,0,2019-02-06,120841,VELOUTE FRUIX PANACHES 125X8 AFH,0,0,1,VELOUTE,0,Villecomtal(FR),0080,0024 FR METZ (DC),1678,1928,1789,1789,0,139,139,0,250,-14.898688915375446,153,157,157,157,0,0,0,0,4,-2.6143790849673203,100.0,100.0,0.0,92.79045643153528,92.79045643153528,0.0,Previsions
783,0,2019-02-06,120841,VELOUTE FRUIX PANACHES 125X8 AFH,0,0,1,VELOUTE,0,Villecomtal(FR),0081,0024 FR TOURS (DC),1678,1928,1789,1789,0,139,139,0,250,-14.898688915375446,210,108,108,108,0,0,0,0,-102,48.57142857142857,100.0,100.0,0.0,92.79045643153528,92.79045643153528,0.0,Previsions
784,0,2019-02-06,120841,VELOUTE FRUIX PANACHES 125X8 AFH,0,0,1,VELOUTE,0,Villecomtal(FR),0082,0024 FR VALLET (DC),1678,1928,1789,1789,0,139,139,0,250,-14.898688915375446,143,90,90,90,0,0,0,0,-53,37.06293706293706,100.0,100.0,0.0,92.79045643153528,92.79045643153528,0.0,Previsions
785,0,2019-02-06,120841,VELOUTE FRUIX PANACHES 125X8 AFH,0,0,1,VELOUTE,0,Villecomtal(FR),0077,0024 FR LILPARK (DC),1678,1928,1789,1789,0,139,139,0,250,-14.898688915375446,162,178,178,178,0,0,0,0,16,-9.876543209876543,100.0,100.0,0.0,92.79045643153528,92.79045643153528,0.0,Previsions
786,0,2019-02-06,120841,VELOUTE FRUIX PANACHES 125X8 AFH,0,0,1,VELOUTE,0,Villecomtal(FR),0085,0024 FR TOULOUSE (DC),1678,1928,1789,1789,0,139,139,0,250,-14.898688915375446,314,90,90,90,0,0,0,0,-224,71.3375796178344,100.0,100.0,0.0,92.79045643153528,92.79045643153528,0.0,Previsions
787,0,2019-02-06,120841,VELOUTE FRUIX PANACHES 125X8 AFH,0,0,1,VELOUTE,0,Villecomtal(FR),0083,0024 FR CHAPONNAY (DC),1678,1928,1789,1789,0,139,139,0,250,-14.898688915375446,364,153,153,153,0,0,0,0,-211,57.967032967032964,100.0,100.0,0.0,92.79045643153528,92.79045643153528,0.0,Previsions
788,0,2019-02-06,120841,VELOUTE FRUIX PANACHES 125X8 AFH,0,0,1,VELOUTE,0,Villecomtal(FR),0079,0024 FR PARIS SUD (DC),1678,1928,1789,1789,0,139,139,0,250,-14.898688915375446,123,144,144,144,0,0,0,0,21,-17.073170731707318,100.0,100.0,0.0,92.79045643153528,92.79045643153528,0.0,Previsions
789,0,2019-02-06,120841,VELOUTE FRUIX PANACHES 125X8 AFH,0,0,1,VELOUTE,0,Villecomtal(FR),0078,0024 FR PARIS NORD (DC),1678,1928,1789,1789,0,139,139,0,250,-14.898688915375446,25,756,617,617,0,139,139,0,731,-2924.0,81.61375661375662,81.61375661375662,0.0,92.79045643153528,92.79045643153528,0.0,Previsions
790,0,2019-02-06,140278,Activia almond/muesli/chia 170g FR-copac,0,0,0,ACTIVIA,1,Roumanie(RO),0084,0024 FR AIX (DC),220,285,225,208,17,77,60,0,65,-29.545454545454547,50,84,84,84,0,0,0,0,34,-68.0,100.0,100.0,0.0,78.94736842105263,72.98245614035088,5.964912280701753,Schéma
791,0,2019-02-06,140278,Activia almond/muesli/chia 170g FR-copac,0,0,0,ACTIVIA,1,Roumanie(RO),0081,0024 FR TOURS (DC),220,285,225,208,17,77,60,0,65,-29.545454545454547,25,33,10,9,1,24,23,0,8,-32.0,30.303030303030305,27.27272727272727,3.0303030303030347,78.94736842105263,72.98245614035088,5.964912280701753,Schéma
792,0,2019-02-06,140278,Activia almond/muesli/chia 170g FR-copac,0,0,0,ACTIVIA,1,Roumanie(RO),0082,0024 FR VALLET (DC),220,285,225,208,17,77,60,0,65,-29.545454545454547,43,43,43,43,0,0,0,0,0,0.0,100.0,100.0,0.0,78.94736842105263,72.98245614035088,5.964912280701753,Schéma
793,0,2019-02-06,140278,Activia almond/muesli/chia 170g FR-copac,0,0,0,ACTIVIA,1,Roumanie(RO),0077,0024 FR LILPARK (DC),220,285,225,208,17,77,60,0,65,-29.545454545454547,15,29,13,0,13,29,16,0,14,-93.33333333333333,44.827586206896555,0.0,44.827586206896555,78.94736842105263,72.98245614035088,5.964912280701753,Schéma
794,0,2019-02-06,140278,Activia almond/muesli/chia 170g FR-copac,0,0,0,ACTIVIA,1,Roumanie(RO),0085,0024 FR TOULOUSE (DC),220,285,225,208,17,77,60,0,65,-29.545454545454547,44,44,44,44,0,0,0,0,0,0.0,100.0,100.0,0.0,78.94736842105263,72.98245614035088,5.964912280701753,Schéma
795,0,2019-02-06,140278,Activia almond/muesli/chia 170g FR-copac,0,0,0,ACTIVIA,1,Roumanie(RO),0083,0024 FR CHAPONNAY (DC),220,285,225,208,17,77,60,0,65,-29.545454545454547,43,52,31,28,3,24,21,0,9,-20.930232558139537,59.61538461538461,53.84615384615385,5.7692307692307665,78.94736842105263,72.98245614035088,5.964912280701753,Schéma
796,0,2019-02-06,140280,Activia chia/raspb/muesli 170g FR-copack,0,0,0,ACTIVIA,1,Roumanie(RO),0084,0024 FR AIX (DC),394,591,564,535,29,56,27,0,197,-50.0,83,129,129,129,0,0,0,0,46,-55.42168674698795,100.0,100.0,0.0,95.43147208121827,90.52453468697124,4.906937394247038,Schéma
797,0,2019-02-06,140280,Activia chia/raspb/muesli 170g FR-copack,0,0,0,ACTIVIA,1,Roumanie(RO),0080,0024 FR METZ (DC),394,591,564,535,29,56,27,0,197,-50.0,90,88,61,32,29,56,27,0,-2,2.2222222222222223,69.31818181818183,36.36363636363637,32.95454545454546,95.43147208121827,90.52453468697124,4.906937394247038,Schéma
798,0,2019-02-06,140280,Activia chia/raspb/muesli 170g FR-copack,0,0,0,ACTIVIA,1,Roumanie(RO),0082,0024 FR VALLET (DC),394,591,564,535,29,56,27,0,197,-50.0,65,85,85,85,0,0,0,0,20,-30.76923076923077,100.0,100.0,0.0,95.43147208121827,90.52453468697124,4.906937394247038,Schéma
799,0,2019-02-06,140280,Activia chia/raspb/muesli 170g FR-copack,0,0,0,ACTIVIA,1,Roumanie(RO),0077,0024 FR LILPARK (DC),394,591,564,535,29,56,27,0,197,-50.0,21,25,25,25,0,0,0,0,4,-19.047619047619047,100.0,100.0,0.0,95.43147208121827,90.52453468697124,4.906937394247038,Schéma
800,0,2019-02-06,140280,Activia chia/raspb/muesli 170g FR-copack,0,0,0,ACTIVIA,1,Roumanie(RO),0085,0024 FR TOULOUSE (DC),394,591,564,535,29,56,27,0,197,-50.0,8,97,97,97,0,0,0,0,89,-1112.5,100.0,100.0,0.0,95.43147208121827,90.52453468697124,4.906937394247038,Schéma
801,0,2019-02-06,140280,Activia chia/raspb/muesli 170g FR-copack,0,0,0,ACTIVIA,1,Roumanie(RO),0083,0024 FR CHAPONNAY (DC),394,591,564,535,29,56,27,0,197,-50.0,67,102,102,102,0,0,0,0,35,-52.23880597014925,100.0,100.0,0.0,95.43147208121827,90.52453468697124,4.906937394247038,Schéma
802,0,2019-02-06,140280,Activia chia/raspb/muesli 170g FR-copack,0,0,0,ACTIVIA,1,Roumanie(RO),0079,0024 FR PARIS SUD (DC),394,591,564,535,29,56,27,0,197,-50.0,60,65,65,65,0,0,0,0,5,-8.333333333333334,100.0,100.0,0.0,95.43147208121827,90.52453468697124,4.906937394247038,Schéma
803,0,2019-02-07,50662,JOCKEY FROM NATURE 3% KG,0,0,0,JOCKEY,0,Ferrières(FR),0084,0024 FR AIX (DC),2651,3023,3022,2894,128,129,1,0,372,-14.032440588457186,278,247,247,247,0,0,0,0,-31,11.151079136690647,100.0,100.0,0.0,99.96692027786966,95.7327158451869,4.234204432682759,Transport
804,0,2019-02-07,50662,JOCKEY FROM NATURE 3% KG,0,0,0,JOCKEY,0,Ferrières(FR),0080,0024 FR METZ (DC),2651,3023,3022,2894,128,129,1,0,372,-14.032440588457186,239,255,255,255,0,0,0,0,16,-6.694560669456067,100.0,100.0,0.0,99.96692027786966,95.7327158451869,4.234204432682759,Transport
805,0,2019-02-07,50662,JOCKEY FROM NATURE 3% KG,0,0,0,JOCKEY,0,Ferrières(FR),0081,0024 FR TOURS (DC),2651,3023,3022,2894,128,129,1,0,372,-14.032440588457186,447,443,442,314,128,129,1,0,-4,0.8948545861297539,99.77426636568849,70.8803611738149,28.893905191873586,99.96692027786966,95.7327158451869,4.234204432682759,Transport
806,0,2019-02-07,50662,JOCKEY FROM NATURE 3% KG,0,0,0,JOCKEY,0,Ferrières(FR),0082,0024 FR VALLET (DC),2651,3023,3022,2894,128,129,1,0,372,-14.032440588457186,309,266,266,266,0,0,0,0,-43,13.915857605177994,100.0,100.0,0.0,99.96692027786966,95.7327158451869,4.234204432682759,Transport
807,0,2019-02-07,50662,JOCKEY FROM NATURE 3% KG,0,0,0,JOCKEY,0,Ferrières(FR),0077,0024 FR LILPARK (DC),2651,3023,3022,2894,128,129,1,0,372,-14.032440588457186,241,236,236,236,0,0,0,0,-5,2.074688796680498,100.0,100.0,0.0,99.96692027786966,95.7327158451869,4.234204432682759,Transport
808,0,2019-02-07,50662,JOCKEY FROM NATURE 3% KG,0,0,0,JOCKEY,0,Ferrières(FR),0085,0024 FR TOULOUSE (DC),2651,3023,3022,2894,128,129,1,0,372,-14.032440588457186,391,381,381,381,0,0,0,0,-10,2.557544757033248,100.0,100.0,0.0,99.96692027786966,95.7327158451869,4.234204432682759,Transport
809,0,2019-02-07,50662,JOCKEY FROM NATURE 3% KG,0,0,0,JOCKEY,0,Ferrières(FR),0083,0024 FR CHAPONNAY (DC),2651,3023,3022,2894,128,129,1,0,372,-14.032440588457186,425,408,408,408,0,0,0,0,-17,4.0,100.0,100.0,0.0,99.96692027786966,95.7327158451869,4.234204432682759,Transport
810,0,2019-02-07,50662,JOCKEY FROM NATURE 3% KG,0,0,0,JOCKEY,0,Ferrières(FR),0079,0024 FR PARIS SUD (DC),2651,3023,3022,2894,128,129,1,0,372,-14.032440588457186,4,351,351,351,0,0,0,0,347,-8675.0,100.0,100.0,0.0,99.96692027786966,95.7327158451869,4.234204432682759,Transport
811,0,2019-02-07,50662,JOCKEY FROM NATURE 3% KG,0,0,0,JOCKEY,0,Ferrières(FR),0078,0024 FR PARIS NORD (DC),2651,3023,3022,2894,128,129,1,0,372,-14.032440588457186,317,436,436,436,0,0,0,0,119,-37.53943217665615,100.0,100.0,0.0,99.96692027786966,95.7327158451869,4.234204432682759,Transport
812,0,2019-02-07,127761,DANIO 0% PECHE 150X1,0,0,0,DANIO,0,Ferrières(FR),0084,0024 FR AIX (DC),126,202,100,91,9,111,102,0,76,-60.317460317460316,39,36,14,14,0,22,22,0,-3,7.6923076923076925,38.88888888888889,38.88888888888889,0.0,49.504950495049506,45.04950495049505,4.455445544554458,Previsions
813,0,2019-02-07,127761,DANIO 0% PECHE 150X1,0,0,0,DANIO,0,Ferrières(FR),0081,0024 FR TOURS (DC),126,202,100,91,9,111,102,0,76,-60.317460317460316,3,42,22,22,0,20,20,0,39,-1300.0,52.38095238095239,52.38095238095239,0.0,49.504950495049506,45.04950495049505,4.455445544554458,Previsions
814,0,2019-02-07,127761,DANIO 0% PECHE 150X1,0,0,0,DANIO,0,Ferrières(FR),0077,0024 FR LILPARK (DC),126,202,100,91,9,111,102,0,76,-60.317460317460316,3,28,28,28,0,0,0,0,25,-833.3333333333334,100.0,100.0,0.0,49.504950495049506,45.04950495049505,4.455445544554458,Previsions
815,0,2019-02-07,127761,DANIO 0% PECHE 150X1,0,0,0,DANIO,0,Ferrières(FR),0083,0024 FR CHAPONNAY (DC),126,202,100,91,9,111,102,0,76,-60.317460317460316,28,33,12,12,0,21,21,0,5,-17.857142857142858,36.36363636363637,36.36363636363637,0.0,49.504950495049506,45.04950495049505,4.455445544554458,Previsions
816,0,2019-02-07,127761,DANIO 0% PECHE 150X1,0,0,0,DANIO,0,Ferrières(FR),0079,0024 FR PARIS SUD (DC),126,202,100,91,9,111,102,0,76,-60.317460317460316,23,34,14,14,0,20,20,0,11,-47.82608695652174,41.17647058823529,41.17647058823529,0.0,49.504950495049506,45.04950495049505,4.455445544554458,Previsions
817,0,2019-02-07,127761,DANIO 0% PECHE 150X1,0,0,0,DANIO,0,Ferrières(FR),0078,0024 FR PARIS NORD (DC),126,202,100,91,9,111,102,0,76,-60.317460317460316,30,29,10,1,9,28,19,0,-1,3.3333333333333335,34.48275862068966,3.4482758620689653,31.034482758620694,49.504950495049506,45.04950495049505,4.455445544554458,Previsions
818,0,2019-02-07,127763,DANIO 0% FRAMBOISE 150X1,0,0,0,DANIO,0,Ferrières(FR),0084,0024 FR AIX (DC),239,184,139,132,7,52,45,0,-55,23.01255230125523,29,15,15,15,0,0,0,0,-14,48.275862068965516,100.0,100.0,0.0,75.54347826086956,71.73913043478261,3.8043478260869534,Previsions
819,0,2019-02-07,127763,DANIO 0% FRAMBOISE 150X1,0,0,0,DANIO,0,Ferrières(FR),0080,0024 FR METZ (DC),239,184,139,132,7,52,45,0,-55,23.01255230125523,23,22,22,22,0,0,0,0,-1,4.3478260869565215,100.0,100.0,0.0,75.54347826086956,71.73913043478261,3.8043478260869534,Previsions
820,0,2019-02-07,127763,DANIO 0% FRAMBOISE 150X1,0,0,0,DANIO,0,Ferrières(FR),0081,0024 FR TOURS (DC),239,184,139,132,7,52,45,0,-55,23.01255230125523,37,21,21,21,0,0,0,0,-16,43.24324324324324,100.0,100.0,0.0,75.54347826086956,71.73913043478261,3.8043478260869534,Previsions
821,0,2019-02-07,127763,DANIO 0% FRAMBOISE 150X1,0,0,0,DANIO,0,Ferrières(FR),0082,0024 FR VALLET (DC),239,184,139,132,7,52,45,0,-55,23.01255230125523,28,12,12,12,0,0,0,0,-16,57.142857142857146,100.0,100.0,0.0,75.54347826086956,71.73913043478261,3.8043478260869534,Previsions
822,0,2019-02-07,127763,DANIO 0% FRAMBOISE 150X1,0,0,0,DANIO,0,Ferrières(FR),0077,0024 FR LILPARK (DC),239,184,139,132,7,52,45,0,-55,23.01255230125523,30,35,35,35,0,0,0,0,5,-16.666666666666668,100.0,100.0,0.0,75.54347826086956,71.73913043478261,3.8043478260869534,Previsions
823,0,2019-02-07,127763,DANIO 0% FRAMBOISE 150X1,0,0,0,DANIO,0,Ferrières(FR),0085,0024 FR TOULOUSE (DC),239,184,139,132,7,52,45,0,-55,23.01255230125523,29,27,10,9,1,18,17,0,-2,6.896551724137931,37.03703703703704,33.33333333333333,3.7037037037037095,75.54347826086956,71.73913043478261,3.8043478260869534,Previsions
824,0,2019-02-07,127763,DANIO 0% FRAMBOISE 150X1,0,0,0,DANIO,0,Ferrières(FR),0083,0024 FR CHAPONNAY (DC),239,184,139,132,7,52,45,0,-55,23.01255230125523,41,29,1,1,0,28,28,0,-12,29.26829268292683,3.4482758620689653,3.4482758620689653,0.0,75.54347826086956,71.73913043478261,3.8043478260869534,Previsions
825,0,2019-02-07,127763,DANIO 0% FRAMBOISE 150X1,0,0,0,DANIO,0,Ferrières(FR),0078,0024 FR PARIS NORD (DC),239,184,139,132,7,52,45,0,-55,23.01255230125523,22,23,23,17,6,6,0,0,1,-4.545454545454546,100.0,73.91304347826086,26.08695652173914,75.54347826086956,71.73913043478261,3.8043478260869534,Previsions
826,1,2019-02-07,131482,ACTIVIA FRT PINEAPPLE 125X4 OD,1,0,0,ACTIVIA,0,Villecomtal(FR),0078,0024 FR PARIS NORD (DC),351,1959,1959,1733,226,226,0,0,1608,-458.11965811965814,351,205,205,195,10,10,0,0,-146,41.59544159544159,100.0,95.1219512195122,4.878048780487802,100.0,88.46350178662583,11.536498213374173,Transport
827,0,2019-02-07,132453,ACTIVIA SAV VAN 125X12 PLUS 4,1,0,0,ACTIVIA,0,Bailleul(FR),0084,0024 FR AIX (DC),3217,2122,2122,1709,413,413,0,0,-1095,34.03792353124029,36,253,253,253,0,0,0,0,217,-602.7777777777778,100.0,100.0,0.0,100.0,80.53722902921771,19.462770970782287,Production
828,0,2019-02-07,132453,ACTIVIA SAV VAN 125X12 PLUS 4,1,0,0,ACTIVIA,0,Bailleul(FR),0080,0024 FR METZ (DC),3217,2122,2122,1709,413,413,0,0,-1095,34.03792353124029,434,263,263,263,0,0,0,0,-171,39.40092165898618,100.0,100.0,0.0,100.0,80.53722902921771,19.462770970782287,Production
829,0,2019-02-07,132453,ACTIVIA SAV VAN 125X12 PLUS 4,1,0,0,ACTIVIA,0,Bailleul(FR),0081,0024 FR TOURS (DC),3217,2122,2122,1709,413,413,0,0,-1095,34.03792353124029,713,511,511,511,0,0,0,0,-202,28.330995792426368,100.0,100.0,0.0,100.0,80.53722902921771,19.462770970782287,Production
830,0,2019-02-07,132453,ACTIVIA SAV VAN 125X12 PLUS 4,1,0,0,ACTIVIA,0,Bailleul(FR),0082,0024 FR VALLET (DC),3217,2122,2122,1709,413,413,0,0,-1095,34.03792353124029,2,24,24,24,0,0,0,0,22,-1100.0,100.0,100.0,0.0,100.0,80.53722902921771,19.462770970782287,Production
831,0,2019-02-07,132453,ACTIVIA SAV VAN 125X12 PLUS 4,1,0,0,ACTIVIA,0,Bailleul(FR),0077,0024 FR LILPARK (DC),3217,2122,2122,1709,413,413,0,0,-1095,34.03792353124029,26,37,37,37,0,0,0,0,11,-42.30769230769231,100.0,100.0,0.0,100.0,80.53722902921771,19.462770970782287,Production
832,0,2019-02-07,132453,ACTIVIA SAV VAN 125X12 PLUS 4,1,0,0,ACTIVIA,0,Bailleul(FR),0085,0024 FR TOULOUSE (DC),3217,2122,2122,1709,413,413,0,0,-1095,34.03792353124029,261,193,193,193,0,0,0,0,-68,26.053639846743295,100.0,100.0,0.0,100.0,80.53722902921771,19.462770970782287,Production
833,0,2019-02-07,132453,ACTIVIA SAV VAN 125X12 PLUS 4,1,0,0,ACTIVIA,0,Bailleul(FR),0083,0024 FR CHAPONNAY (DC),3217,2122,2122,1709,413,413,0,0,-1095,34.03792353124029,606,413,413,0,413,413,0,0,-193,31.848184818481847,100.0,0.0,100.0,100.0,80.53722902921771,19.462770970782287,Production
834,1,2019-02-07,132453,ACTIVIA SAV VAN 125X12 PLUS 4,1,0,0,ACTIVIA,0,Bailleul(FR),0083,0024 FR CHAPONNAY (DC),3217,2122,2122,1709,413,413,0,0,-1095,34.03792353124029,606,413,413,0,413,413,0,0,-193,31.848184818481847,100.0,0.0,100.0,100.0,80.53722902921771,19.462770970782287,Production
835,0,2019-02-07,132453,ACTIVIA SAV VAN 125X12 PLUS 4,1,0,0,ACTIVIA,0,Bailleul(FR),0079,0024 FR PARIS SUD (DC),3217,2122,2122,1709,413,413,0,0,-1095,34.03792353124029,216,204,204,204,0,0,0,0,-12,5.555555555555555,100.0,100.0,0.0,100.0,80.53722902921771,19.462770970782287,Production
836,0,2019-02-07,132453,ACTIVIA SAV VAN 125X12 PLUS 4,1,0,0,ACTIVIA,0,Bailleul(FR),0078,0024 FR PARIS NORD (DC),3217,2122,2122,1709,413,413,0,0,-1095,34.03792353124029,317,224,224,224,0,0,0,0,-93,29.337539432176655,100.0,100.0,0.0,100.0,80.53722902921771,19.462770970782287,Production
837,0,2019-02-07,135120,ACTIVIA SAV CIT 125X12 PLUS 4,0,0,0,ACTIVIA,0,Bailleul(FR),0084,0024 FR AIX (DC),2865,1650,1650,1369,281,281,0,0,-1215,42.40837696335078,311,202,202,202,0,0,0,0,-109,35.048231511254016,100.0,100.0,0.0,100.0,82.96969696969697,17.03030303030303,Production
838,0,2019-02-07,135120,ACTIVIA SAV CIT 125X12 PLUS 4,0,0,0,ACTIVIA,0,Bailleul(FR),0080,0024 FR METZ (DC),2865,1650,1650,1369,281,281,0,0,-1215,42.40837696335078,370,216,216,216,0,0,0,0,-154,41.62162162162162,100.0,100.0,0.0,100.0,82.96969696969697,17.03030303030303,Production
839,0,2019-02-07,135120,ACTIVIA SAV CIT 125X12 PLUS 4,0,0,0,ACTIVIA,0,Bailleul(FR),0081,0024 FR TOURS (DC),2865,1650,1650,1369,281,281,0,0,-1215,42.40837696335078,665,437,437,437,0,0,0,0,-228,34.285714285714285,100.0,100.0,0.0,100.0,82.96969696969697,17.03030303030303,Production
840,0,2019-02-07,135120,ACTIVIA SAV CIT 125X12 PLUS 4,0,0,0,ACTIVIA,0,Bailleul(FR),0082,0024 FR VALLET (DC),2865,1650,1650,1369,281,281,0,0,-1215,42.40837696335078,9,13,13,13,0,0,0,0,4,-44.44444444444444,100.0,100.0,0.0,100.0,82.96969696969697,17.03030303030303,Production
841,0,2019-02-07,135120,ACTIVIA SAV CIT 125X12 PLUS 4,0,0,0,ACTIVIA,0,Bailleul(FR),0077,0024 FR LILPARK (DC),2865,1650,1650,1369,281,281,0,0,-1215,42.40837696335078,18,24,24,24,0,0,0,0,6,-33.333333333333336,100.0,100.0,0.0,100.0,82.96969696969697,17.03030303030303,Production
842,0,2019-02-07,135120,ACTIVIA SAV CIT 125X12 PLUS 4,0,0,0,ACTIVIA,0,Bailleul(FR),0085,0024 FR TOULOUSE (DC),2865,1650,1650,1369,281,281,0,0,-1215,42.40837696335078,199,135,135,135,0,0,0,0,-64,32.1608040201005,100.0,100.0,0.0,100.0,82.96969696969697,17.03030303030303,Production
843,0,2019-02-07,135120,ACTIVIA SAV CIT 125X12 PLUS 4,0,0,0,ACTIVIA,0,Bailleul(FR),0083,0024 FR CHAPONNAY (DC),2865,1650,1650,1369,281,281,0,0,-1215,42.40837696335078,450,301,301,20,281,281,0,0,-149,33.111111111111114,100.0,6.64451827242525,93.35548172757476,100.0,82.96969696969697,17.03030303030303,Production
844,1,2019-02-07,135120,ACTIVIA SAV CIT 125X12 PLUS 4,0,0,0,ACTIVIA,0,Bailleul(FR),0083,0024 FR CHAPONNAY (DC),2865,1650,1650,1369,281,281,0,0,-1215,42.40837696335078,450,301,301,20,281,281,0,0,-149,33.111111111111114,100.0,6.64451827242525,93.35548172757476,100.0,82.96969696969697,17.03030303030303,Production
845,0,2019-02-07,135120,ACTIVIA SAV CIT 125X12 PLUS 4,0,0,0,ACTIVIA,0,Bailleul(FR),0079,0024 FR PARIS SUD (DC),2865,1650,1650,1369,281,281,0,0,-1215,42.40837696335078,96,97,97,97,0,0,0,0,1,-1.0416666666666667,100.0,100.0,0.0,100.0,82.96969696969697,17.03030303030303,Production
846,0,2019-02-07,135120,ACTIVIA SAV CIT 125X12 PLUS 4,0,0,0,ACTIVIA,0,Bailleul(FR),0078,0024 FR PARIS NORD (DC),2865,1650,1650,1369,281,281,0,0,-1215,42.40837696335078,297,225,225,225,0,0,0,0,-72,24.242424242424242,100.0,100.0,0.0,100.0,82.96969696969697,17.03030303030303,Production
847,1,2019-02-07,138543,L2V PTITS MIAM VANILLE 50X6,1,0,0,LES 2 VACHES,0,Ferrières(FR),0080,0024 FR METZ (DC),80,542,533,502,31,40,9,0,462,-577.5,80,79,70,39,31,40,9,0,-1,1.25,88.60759493670885,49.36708860759494,39.24050632911391,98.33948339483395,92.619926199262,5.7195571955719515,A Creuser
848,0,2019-02-07,139104,ALPRO COCONUT-ALMOND DRINK 8X1L,0,0,0,ALPRO,1,Wevelgem(BE),0084,0024 FR AIX (DC),31,440,177,177,0,263,263,0,409,-1319.3548387096773,3,11,11,11,0,0,0,0,8,-266.6666666666667,100.0,100.0,0.0,40.22727272727273,40.22727272727273,0.0,A Creuser
849,0,2019-02-07,139104,ALPRO COCONUT-ALMOND DRINK 8X1L,0,0,0,ALPRO,1,Wevelgem(BE),0080,0024 FR METZ (DC),31,440,177,177,0,263,263,0,409,-1319.3548387096773,5,260,37,37,0,223,223,0,255,-5100.0,14.23076923076923,14.23076923076923,0.0,40.22727272727273,40.22727272727273,0.0,A Creuser
850,0,2019-02-07,139104,ALPRO COCONUT-ALMOND DRINK 8X1L,0,0,0,ALPRO,1,Wevelgem(BE),0082,0024 FR VALLET (DC),31,440,177,177,0,263,263,0,409,-1319.3548387096773,2,5,5,5,0,0,0,0,3,-150.0,100.0,100.0,0.0,40.22727272727273,40.22727272727273,0.0,A Creuser
851,0,2019-02-07,139104,ALPRO COCONUT-ALMOND DRINK 8X1L,0,0,0,ALPRO,1,Wevelgem(BE),0077,0024 FR LILPARK (DC),31,440,177,177,0,263,263,0,409,-1319.3548387096773,2,5,5,5,0,0,0,0,3,-150.0,100.0,100.0,0.0,40.22727272727273,40.22727272727273,0.0,A Creuser
852,0,2019-02-07,139104,ALPRO COCONUT-ALMOND DRINK 8X1L,0,0,0,ALPRO,1,Wevelgem(BE),0085,0024 FR TOULOUSE (DC),31,440,177,177,0,263,263,0,409,-1319.3548387096773,10,7,7,7,0,0,0,0,-3,30.0,100.0,100.0,0.0,40.22727272727273,40.22727272727273,0.0,A Creuser
853,0,2019-02-07,139104,ALPRO COCONUT-ALMOND DRINK 8X1L,0,0,0,ALPRO,1,Wevelgem(BE),0079,0024 FR PARIS SUD (DC),31,440,177,177,0,263,263,0,409,-1319.3548387096773,6,26,26,26,0,0,0,0,20,-333.3333333333333,100.0,100.0,0.0,40.22727272727273,40.22727272727273,0.0,A Creuser
854,0,2019-02-07,139104,ALPRO COCONUT-ALMOND DRINK 8X1L,0,0,0,ALPRO,1,Wevelgem(BE),0078,0024 FR PARIS NORD (DC),31,440,177,177,0,263,263,0,409,-1319.3548387096773,3,6,6,6,0,0,0,0,3,-100.0,100.0,100.0,0.0,40.22727272727273,40.22727272727273,0.0,A Creuser
855,0,2019-02-07,140278,Activia almond/muesli/chia 170g FR-copac,0,0,0,ACTIVIA,1,Roumanie(RO),0084,0024 FR AIX (DC),390,422,401,250,151,172,21,0,32,-8.205128205128204,37,44,44,44,0,0,0,0,7,-18.91891891891892,100.0,100.0,0.0,95.02369668246445,59.241706161137444,35.781990521327,Schéma
856,0,2019-02-07,140278,Activia almond/muesli/chia 170g FR-copac,0,0,0,ACTIVIA,1,Roumanie(RO),0081,0024 FR TOURS (DC),390,422,401,250,151,172,21,0,32,-8.205128205128204,64,60,59,0,59,60,1,0,-4,6.25,98.33333333333333,0.0,98.33333333333333,95.02369668246445,59.241706161137444,35.781990521327,Schéma
857,0,2019-02-07,140278,Activia almond/muesli/chia 170g FR-copac,0,0,0,ACTIVIA,1,Roumanie(RO),0082,0024 FR VALLET (DC),390,422,401,250,151,172,21,0,32,-8.205128205128204,33,34,34,34,0,0,0,0,1,-3.0303030303030303,100.0,100.0,0.0,95.02369668246445,59.241706161137444,35.781990521327,Schéma
858,0,2019-02-07,140278,Activia almond/muesli/chia 170g FR-copac,0,0,0,ACTIVIA,1,Roumanie(RO),0077,0024 FR LILPARK (DC),390,422,401,250,151,172,21,0,32,-8.205128205128204,91,67,67,42,25,25,0,0,-24,26.373626373626372,100.0,62.68656716417911,37.31343283582089,95.02369668246445,59.241706161137444,35.781990521327,Schéma
859,0,2019-02-07,140278,Activia almond/muesli/chia 170g FR-copac,0,0,0,ACTIVIA,1,Roumanie(RO),0085,0024 FR TOULOUSE (DC),390,422,401,250,151,172,21,0,32,-8.205128205128204,37,53,42,41,1,12,11,0,16,-43.24324324324324,79.24528301886792,77.35849056603774,1.8867924528301785,95.02369668246445,59.241706161137444,35.781990521327,Schéma
860,0,2019-02-07,140278,Activia almond/muesli/chia 170g FR-copac,0,0,0,ACTIVIA,1,Roumanie(RO),0083,0024 FR CHAPONNAY (DC),390,422,401,250,151,172,21,0,32,-8.205128205128204,71,89,89,89,0,0,0,0,18,-25.35211267605634,100.0,100.0,0.0,95.02369668246445,59.241706161137444,35.781990521327,Schéma
861,0,2019-02-07,140278,Activia almond/muesli/chia 170g FR-copac,0,0,0,ACTIVIA,1,Roumanie(RO),0079,0024 FR PARIS SUD (DC),390,422,401,250,151,172,21,0,32,-8.205128205128204,57,75,66,0,66,75,9,0,18,-31.57894736842105,88.0,0.0,88.0,95.02369668246445,59.241706161137444,35.781990521327,Schéma
862,0,2019-02-08,79537,LES 2 VACHES FLAN BIO 100X4,0,0,0,LES 2 VACHES,0,LeMolay(FR),0084,0024 FR AIX (DC),921,858,708,708,0,150,150,0,-63,6.840390879478828,118,96,96,96,0,0,0,0,-22,18.64406779661017,100.0,100.0,0.0,82.51748251748252,82.51748251748252,0.0,Previsions
863,0,2019-02-08,79537,LES 2 VACHES FLAN BIO 100X4,0,0,0,LES 2 VACHES,0,LeMolay(FR),0080,0024 FR METZ (DC),921,858,708,708,0,150,150,0,-63,6.840390879478828,100,62,62,62,0,0,0,0,-38,38.0,100.0,100.0,0.0,82.51748251748252,82.51748251748252,0.0,Previsions
864,0,2019-02-08,79537,LES 2 VACHES FLAN BIO 100X4,0,0,0,LES 2 VACHES,0,LeMolay(FR),0081,0024 FR TOURS (DC),921,858,708,708,0,150,150,0,-63,6.840390879478828,105,99,99,99,0,0,0,0,-6,5.714285714285714,100.0,100.0,0.0,82.51748251748252,82.51748251748252,0.0,Previsions
865,0,2019-02-08,79537,LES 2 VACHES FLAN BIO 100X4,0,0,0,LES 2 VACHES,0,LeMolay(FR),0082,0024 FR VALLET (DC),921,858,708,708,0,150,150,0,-63,6.840390879478828,8,80,80,80,0,0,0,0,72,-900.0,100.0,100.0,0.0,82.51748251748252,82.51748251748252,0.0,Previsions
866,0,2019-02-08,79537,LES 2 VACHES FLAN BIO 100X4,0,0,0,LES 2 VACHES,0,LeMolay(FR),0077,0024 FR LILPARK (DC),921,858,708,708,0,150,150,0,-63,6.840390879478828,58,38,38,38,0,0,0,0,-20,34.48275862068966,100.0,100.0,0.0,82.51748251748252,82.51748251748252,0.0,Previsions
867,0,2019-02-08,79537,LES 2 VACHES FLAN BIO 100X4,0,0,0,LES 2 VACHES,0,LeMolay(FR),0085,0024 FR TOULOUSE (DC),921,858,708,708,0,150,150,0,-63,6.840390879478828,176,148,148,148,0,0,0,0,-28,15.909090909090908,100.0,100.0,0.0,82.51748251748252,82.51748251748252,0.0,Previsions
868,0,2019-02-08,79537,LES 2 VACHES FLAN BIO 100X4,0,0,0,LES 2 VACHES,0,LeMolay(FR),0083,0024 FR CHAPONNAY (DC),921,858,708,708,0,150,150,0,-63,6.840390879478828,153,180,30,30,0,150,150,0,27,-17.647058823529413,16.666666666666664,16.666666666666664,0.0,82.51748251748252,82.51748251748252,0.0,Previsions
869,0,2019-02-08,79537,LES 2 VACHES FLAN BIO 100X4,0,0,0,LES 2 VACHES,0,LeMolay(FR),0079,0024 FR PARIS SUD (DC),921,858,708,708,0,150,150,0,-63,6.840390879478828,97,103,103,103,0,0,0,0,6,-6.185567010309279,100.0,100.0,0.0,82.51748251748252,82.51748251748252,0.0,Previsions
870,0,2019-02-08,79537,LES 2 VACHES FLAN BIO 100X4,0,0,0,LES 2 VACHES,0,LeMolay(FR),0078,0024 FR PARIS NORD (DC),921,858,708,708,0,150,150,0,-63,6.840390879478828,106,52,52,52,0,0,0,0,-54,50.943396226415096,100.0,100.0,0.0,82.51748251748252,82.51748251748252,0.0,Previsions
871,0,2019-02-09,121524,TAILLEFINE FRT MUR MYRT 125X4,0,0,0,TAILLEFINE,0,Villecomtal(FR),0084,0024 FR AIX (DC),161,329,311,298,13,31,18,0,168,-104.34782608695652,33,41,41,41,0,0,0,0,8,-24.242424242424242,100.0,100.0,0.0,94.52887537993921,90.5775075987842,3.951367781155014,Previsions
872,0,2019-02-09,121524,TAILLEFINE FRT MUR MYRT 125X4,0,0,0,TAILLEFINE,0,Villecomtal(FR),0080,0024 FR METZ (DC),161,329,311,298,13,31,18,0,168,-104.34782608695652,26,30,16,16,0,14,14,0,4,-15.384615384615385,53.333333333333336,53.333333333333336,0.0,94.52887537993921,90.5775075987842,3.951367781155014,Previsions
873,0,2019-02-09,121524,TAILLEFINE FRT MUR MYRT 125X4,0,0,0,TAILLEFINE,0,Villecomtal(FR),0081,0024 FR TOURS (DC),161,329,311,298,13,31,18,0,168,-104.34782608695652,5,52,52,52,0,0,0,0,47,-940.0,100.0,100.0,0.0,94.52887537993921,90.5775075987842,3.951367781155014,Previsions
874,0,2019-02-09,121524,TAILLEFINE FRT MUR MYRT 125X4,0,0,0,TAILLEFINE,0,Villecomtal(FR),0082,0024 FR VALLET (DC),161,329,311,298,13,31,18,0,168,-104.34782608695652,3,17,17,17,0,0,0,0,14,-466.6666666666667,100.0,100.0,0.0,94.52887537993921,90.5775075987842,3.951367781155014,Previsions
875,0,2019-02-09,121524,TAILLEFINE FRT MUR MYRT 125X4,0,0,0,TAILLEFINE,0,Villecomtal(FR),0077,0024 FR LILPARK (DC),161,329,311,298,13,31,18,0,168,-104.34782608695652,41,85,81,68,13,17,4,0,44,-107.3170731707317,95.29411764705881,80.0,15.294117647058812,94.52887537993921,90.5775075987842,3.951367781155014,Previsions
876,0,2019-02-09,121524,TAILLEFINE FRT MUR MYRT 125X4,0,0,0,TAILLEFINE,0,Villecomtal(FR),0085,0024 FR TOULOUSE (DC),161,329,311,298,13,31,18,0,168,-104.34782608695652,45,57,57,57,0,0,0,0,12,-26.666666666666668,100.0,100.0,0.0,94.52887537993921,90.5775075987842,3.951367781155014,Previsions
877,0,2019-02-09,121524,TAILLEFINE FRT MUR MYRT 125X4,0,0,0,TAILLEFINE,0,Villecomtal(FR),0078,0024 FR PARIS NORD (DC),161,329,311,298,13,31,18,0,168,-104.34782608695652,8,47,47,47,0,0,0,0,39,-487.5,100.0,100.0,0.0,94.52887537993921,90.5775075987842,3.951367781155014,Previsions
878,0,2019-02-09,140493,LIGHT & FREE EDI APRIC 120X4 OD,1,0,0,LIGHT & FREE,0,Ferrières(FR),0084,0024 FR AIX (DC),2116,1012,1012,792,220,220,0,0,-1104,52.17391304347826,217,121,121,120,1,1,0,0,-96,44.23963133640553,100.0,99.17355371900827,0.8264462809917319,100.0,78.26086956521739,21.73913043478261,A Creuser
879,0,2019-02-09,140493,LIGHT & FREE EDI APRIC 120X4 OD,1,0,0,LIGHT & FREE,0,Ferrières(FR),0080,0024 FR METZ (DC),2116,1012,1012,792,220,220,0,0,-1104,52.17391304347826,173,89,89,89,0,0,0,0,-84,48.554913294797686,100.0,100.0,0.0,100.0,78.26086956521739,21.73913043478261,A Creuser
880,0,2019-02-09,140493,LIGHT & FREE EDI APRIC 120X4 OD,1,0,0,LIGHT & FREE,0,Ferrières(FR),0081,0024 FR TOURS (DC),2116,1012,1012,792,220,220,0,0,-1104,52.17391304347826,140,86,86,86,0,0,0,0,-54,38.57142857142857,100.0,100.0,0.0,100.0,78.26086956521739,21.73913043478261,A Creuser
881,0,2019-02-09,140493,LIGHT & FREE EDI APRIC 120X4 OD,1,0,0,LIGHT & FREE,0,Ferrières(FR),0077,0024 FR LILPARK (DC),2116,1012,1012,792,220,220,0,0,-1104,52.17391304347826,383,219,219,0,219,219,0,0,-164,42.819843342036556,100.0,0.0,100.0,100.0,78.26086956521739,21.73913043478261,A Creuser
882,1,2019-02-09,140493,LIGHT & FREE EDI APRIC 120X4 OD,1,0,0,LIGHT & FREE,0,Ferrières(FR),0077,0024 FR LILPARK (DC),2116,1012,1012,792,220,220,0,0,-1104,52.17391304347826,383,219,219,0,219,219,0,0,-164,42.819843342036556,100.0,0.0,100.0,100.0,78.26086956521739,21.73913043478261,A Creuser
883,0,2019-02-09,140493,LIGHT & FREE EDI APRIC 120X4 OD,1,0,0,LIGHT & FREE,0,Ferrières(FR),0085,0024 FR TOULOUSE (DC),2116,1012,1012,792,220,220,0,0,-1104,52.17391304347826,76,57,57,57,0,0,0,0,-19,25.0,100.0,100.0,0.0,100.0,78.26086956521739,21.73913043478261,A Creuser
884,0,2019-02-09,140493,LIGHT & FREE EDI APRIC 120X4 OD,1,0,0,LIGHT & FREE,0,Ferrières(FR),0083,0024 FR CHAPONNAY (DC),2116,1012,1012,792,220,220,0,0,-1104,52.17391304347826,140,88,88,88,0,0,0,0,-52,37.142857142857146,100.0,100.0,0.0,100.0,78.26086956521739,21.73913043478261,A Creuser
885,0,2019-02-09,140493,LIGHT & FREE EDI APRIC 120X4 OD,1,0,0,LIGHT & FREE,0,Ferrières(FR),0079,0024 FR PARIS SUD (DC),2116,1012,1012,792,220,220,0,0,-1104,52.17391304347826,315,200,200,200,0,0,0,0,-115,36.507936507936506,100.0,100.0,0.0,100.0,78.26086956521739,21.73913043478261,A Creuser
886,0,2019-02-09,140493,LIGHT & FREE EDI APRIC 120X4 OD,1,0,0,LIGHT & FREE,0,Ferrières(FR),0078,0024 FR PARIS NORD (DC),2116,1012,1012,792,220,220,0,0,-1104,52.17391304347826,289,152,152,152,0,0,0,0,-137,47.40484429065744,100.0,100.0,0.0,100.0,78.26086956521739,21.73913043478261,A Creuser
887,0,2019-03-11,25528,DANACOL DR PLAIN 0% 100GX4 FR,0,0,0,DANACOL,1,Aldaya(ES),0084,0024 FR AIX (DC),345,363,329,324,5,39,34,0,18,-5.217391304347826,44,47,47,47,0,0,0,0,3,-6.818181818181818,100.0,100.0,0.0,90.633608815427,89.25619834710744,1.3774104683195532,A Creuser
888,0,2019-03-11,25528,DANACOL DR PLAIN 0% 100GX4 FR,0,0,0,DANACOL,1,Aldaya(ES),0080,0024 FR METZ (DC),345,363,329,324,5,39,34,0,18,-5.217391304347826,56,58,58,58,0,0,0,0,2,-3.5714285714285716,100.0,100.0,0.0,90.633608815427,89.25619834710744,1.3774104683195532,A Creuser
889,0,2019-03-11,25528,DANACOL DR PLAIN 0% 100GX4 FR,0,0,0,DANACOL,1,Aldaya(ES),0082,0024 FR VALLET (DC),345,363,329,324,5,39,34,0,18,-5.217391304347826,32,39,5,0,5,39,34,0,7,-21.875,12.82051282051282,0.0,12.82051282051282,90.633608815427,89.25619834710744,1.3774104683195532,A Creuser
890,0,2019-03-11,25528,DANACOL DR PLAIN 0% 100GX4 FR,0,0,0,DANACOL,1,Aldaya(ES),0077,0024 FR LILPARK (DC),345,363,329,324,5,39,34,0,18,-5.217391304347826,15,16,16,16,0,0,0,0,1,-6.666666666666667,100.0,100.0,0.0,90.633608815427,89.25619834710744,1.3774104683195532,A Creuser
891,0,2019-03-11,25528,DANACOL DR PLAIN 0% 100GX4 FR,0,0,0,DANACOL,1,Aldaya(ES),0085,0024 FR TOULOUSE (DC),345,363,329,324,5,39,34,0,18,-5.217391304347826,59,59,59,59,0,0,0,0,0,0.0,100.0,100.0,0.0,90.633608815427,89.25619834710744,1.3774104683195532,A Creuser
892,0,2019-03-11,25528,DANACOL DR PLAIN 0% 100GX4 FR,0,0,0,DANACOL,1,Aldaya(ES),0083,0024 FR CHAPONNAY (DC),345,363,329,324,5,39,34,0,18,-5.217391304347826,66,78,78,78,0,0,0,0,12,-18.181818181818183,100.0,100.0,0.0,90.633608815427,89.25619834710744,1.3774104683195532,A Creuser
893,0,2019-03-11,25528,DANACOL DR PLAIN 0% 100GX4 FR,0,0,0,DANACOL,1,Aldaya(ES),0079,0024 FR PARIS SUD (DC),345,363,329,324,5,39,34,0,18,-5.217391304347826,73,66,66,66,0,0,0,0,-7,9.58904109589041,100.0,100.0,0.0,90.633608815427,89.25619834710744,1.3774104683195532,A Creuser
894,0,2019-03-11,83925,ACTIMEL 0% NATU 3x(14x100g) FR,0,0,0,ACTIMEL,1,Rotselaar(BE),0084,0024 FR AIX (DC),776,679,554,544,10,135,125,0,-97,12.5,258,260,152,142,10,118,108,0,2,-0.7751937984496124,58.46153846153847,54.61538461538461,3.846153846153854,81.59057437407952,80.11782032400589,1.4727540500736325,Previsions
895,1,2019-03-11,83925,ACTIMEL 0% NATU 3x(14x100g) FR,0,0,0,ACTIMEL,1,Rotselaar(BE),0084,0024 FR AIX (DC),776,679,554,544,10,135,125,0,-97,12.5,258,260,152,142,10,118,108,0,2,-0.7751937984496124,58.46153846153847,54.61538461538461,3.846153846153854,81.59057437407952,80.11782032400589,1.4727540500736325,Previsions
896,0,2019-03-11,83925,ACTIMEL 0% NATU 3x(14x100g) FR,0,0,0,ACTIMEL,1,Rotselaar(BE),0081,0024 FR TOURS (DC),776,679,554,544,10,135,125,0,-97,12.5,127,156,156,156,0,0,0,0,29,-22.834645669291337,100.0,100.0,0.0,81.59057437407952,80.11782032400589,1.4727540500736325,Previsions
897,0,2019-03-11,83925,ACTIMEL 0% NATU 3x(14x100g) FR,0,0,0,ACTIMEL,1,Rotselaar(BE),0082,0024 FR VALLET (DC),776,679,554,544,10,135,125,0,-97,12.5,58,57,40,40,0,17,17,0,-1,1.7241379310344827,70.17543859649122,70.17543859649122,0.0,81.59057437407952,80.11782032400589,1.4727540500736325,Previsions
898,1,2019-03-11,83925,ACTIMEL 0% NATU 3x(14x100g) FR,0,0,0,ACTIMEL,1,Rotselaar(BE),0082,0024 FR VALLET (DC),776,679,554,544,10,135,125,0,-97,12.5,58,57,40,40,0,17,17,0,-1,1.7241379310344827,70.17543859649122,70.17543859649122,0.0,81.59057437407952,80.11782032400589,1.4727540500736325,Previsions
899,0,2019-03-11,83925,ACTIMEL 0% NATU 3x(14x100g) FR,0,0,0,ACTIMEL,1,Rotselaar(BE),0077,0024 FR LILPARK (DC),776,679,554,544,10,135,125,0,-97,12.5,-6,47,47,47,0,0,0,0,53,883.3333333333334,100.0,100.0,0.0,81.59057437407952,80.11782032400589,1.4727540500736325,Previsions
900,0,2019-03-11,83925,ACTIMEL 0% NATU 3x(14x100g) FR,0,0,0,ACTIMEL,1,Rotselaar(BE),0085,0024 FR TOULOUSE (DC),776,679,554,544,10,135,125,0,-97,12.5,8,138,138,138,0,0,0,0,130,-1625.0,100.0,100.0,0.0,81.59057437407952,80.11782032400589,1.4727540500736325,Previsions
901,0,2019-03-11,83925,ACTIMEL 0% NATU 3x(14x100g) FR,0,0,0,ACTIMEL,1,Rotselaar(BE),0083,0024 FR CHAPONNAY (DC),776,679,554,544,10,135,125,0,-97,12.5,15,21,21,21,0,0,0,0,6,-40.0,100.0,100.0,0.0,81.59057437407952,80.11782032400589,1.4727540500736325,Previsions
902,0,2019-03-11,115026,FJORD NATURE 125GX8 OPL,1,0,0,FJORD,0,LeMolay(FR),0084,0024 FR AIX (DC),50,251,87,87,0,164,164,0,201,-402.0,10,125,16,16,0,109,109,0,115,-1150.0,12.8,12.8,0.0,34.66135458167331,34.66135458167331,0.0,Previsions
903,0,2019-03-11,115026,FJORD NATURE 125GX8 OPL,1,0,0,FJORD,0,LeMolay(FR),0082,0024 FR VALLET (DC),50,251,87,87,0,164,164,0,201,-402.0,10,27,15,15,0,12,12,0,17,-170.0,55.55555555555556,55.55555555555556,0.0,34.66135458167331,34.66135458167331,0.0,Previsions
904,0,2019-03-11,115026,FJORD NATURE 125GX8 OPL,1,0,0,FJORD,0,LeMolay(FR),0083,0024 FR CHAPONNAY (DC),50,251,87,87,0,164,164,0,201,-402.0,30,99,56,56,0,43,43,0,69,-230.0,56.56565656565656,56.56565656565656,0.0,34.66135458167331,34.66135458167331,0.0,Previsions
905,0,2019-03-11,121320,ACTIMEL NATU 4x(12x100g) FR,0,0,0,ACTIMEL,1,Rotselaar(BE),0084,0024 FR AIX (DC),2264,2406,2402,2208,194,198,4,0,142,-6.27208480565371,224,217,217,217,0,0,0,0,-7,3.125,100.0,100.0,0.0,99.833748960931,91.77057356608479,8.063175394846212,Previsions
906,0,2019-03-11,121320,ACTIMEL NATU 4x(12x100g) FR,0,0,0,ACTIMEL,1,Rotselaar(BE),0080,0024 FR METZ (DC),2264,2406,2402,2208,194,198,4,0,142,-6.27208480565371,262,245,245,51,194,194,0,0,-17,6.488549618320611,100.0,20.816326530612244,79.18367346938776,99.833748960931,91.77057356608479,8.063175394846212,Previsions
907,0,2019-03-11,121320,ACTIMEL NATU 4x(12x100g) FR,0,0,0,ACTIMEL,1,Rotselaar(BE),0081,0024 FR TOURS (DC),2264,2406,2402,2208,194,198,4,0,142,-6.27208480565371,225,308,308,308,0,0,0,0,83,-36.888888888888886,100.0,100.0,0.0,99.833748960931,91.77057356608479,8.063175394846212,Previsions
908,0,2019-03-11,121320,ACTIMEL NATU 4x(12x100g) FR,0,0,0,ACTIMEL,1,Rotselaar(BE),0082,0024 FR VALLET (DC),2264,2406,2402,2208,194,198,4,0,142,-6.27208480565371,158,177,177,177,0,0,0,0,19,-12.025316455696203,100.0,100.0,0.0,99.833748960931,91.77057356608479,8.063175394846212,Previsions
909,0,2019-03-11,121320,ACTIMEL NATU 4x(12x100g) FR,0,0,0,ACTIMEL,1,Rotselaar(BE),0077,0024 FR LILPARK (DC),2264,2406,2402,2208,194,198,4,0,142,-6.27208480565371,74,169,169,169,0,0,0,0,95,-128.3783783783784,100.0,100.0,0.0,99.833748960931,91.77057356608479,8.063175394846212,Previsions
910,0,2019-03-11,121320,ACTIMEL NATU 4x(12x100g) FR,0,0,0,ACTIMEL,1,Rotselaar(BE),0085,0024 FR TOULOUSE (DC),2264,2406,2402,2208,194,198,4,0,142,-6.27208480565371,358,348,344,344,0,4,4,0,-10,2.793296089385475,98.85057471264368,98.85057471264368,0.0,99.833748960931,91.77057356608479,8.063175394846212,Previsions
911,0,2019-03-11,121320,ACTIMEL NATU 4x(12x100g) FR,0,0,0,ACTIMEL,1,Rotselaar(BE),0083,0024 FR CHAPONNAY (DC),2264,2406,2402,2208,194,198,4,0,142,-6.27208480565371,411,398,398,398,0,0,0,0,-13,3.1630170316301705,100.0,100.0,0.0,99.833748960931,91.77057356608479,8.063175394846212,Previsions
912,0,2019-03-11,121320,ACTIMEL NATU 4x(12x100g) FR,0,0,0,ACTIMEL,1,Rotselaar(BE),0079,0024 FR PARIS SUD (DC),2264,2406,2402,2208,194,198,4,0,142,-6.27208480565371,285,285,285,285,0,0,0,0,0,0.0,100.0,100.0,0.0,99.833748960931,91.77057356608479,8.063175394846212,Previsions
913,0,2019-03-11,121320,ACTIMEL NATU 4x(12x100g) FR,0,0,0,ACTIMEL,1,Rotselaar(BE),0078,0024 FR PARIS NORD (DC),2264,2406,2402,2208,194,198,4,0,142,-6.27208480565371,267,259,259,259,0,0,0,0,-8,2.9962546816479403,100.0,100.0,0.0,99.833748960931,91.77057356608479,8.063175394846212,Previsions
914,0,2019-03-11,127395,DANONE LAIT ENT AROME VAN 125X8,0,0,0,DANONE,0,Bailleul(FR),0084,0024 FR AIX (DC),581,1115,891,886,5,229,224,0,534,-91.9104991394148,138,251,188,183,5,68,63,0,113,-81.8840579710145,74.9003984063745,72.90836653386454,1.992031872509969,79.91031390134529,79.46188340807176,0.4484304932735341,Previsions
915,0,2019-03-11,127395,DANONE LAIT ENT AROME VAN 125X8,0,0,0,DANONE,0,Bailleul(FR),0080,0024 FR METZ (DC),581,1115,891,886,5,229,224,0,534,-91.9104991394148,41,96,96,96,0,0,0,0,55,-134.14634146341464,100.0,100.0,0.0,79.91031390134529,79.46188340807176,0.4484304932735341,Previsions
916,0,2019-03-11,127395,DANONE LAIT ENT AROME VAN 125X8,0,0,0,DANONE,0,Bailleul(FR),0081,0024 FR TOURS (DC),581,1115,891,886,5,229,224,0,534,-91.9104991394148,146,208,208,208,0,0,0,0,62,-42.465753424657535,100.0,100.0,0.0,79.91031390134529,79.46188340807176,0.4484304932735341,Previsions
917,0,2019-03-11,127395,DANONE LAIT ENT AROME VAN 125X8,0,0,0,DANONE,0,Bailleul(FR),0082,0024 FR VALLET (DC),581,1115,891,886,5,229,224,0,534,-91.9104991394148,69,155,146,146,0,9,9,0,86,-124.6376811594203,94.19354838709677,94.19354838709677,0.0,79.91031390134529,79.46188340807176,0.4484304932735341,Previsions
918,0,2019-03-11,127395,DANONE LAIT ENT AROME VAN 125X8,0,0,0,DANONE,0,Bailleul(FR),0077,0024 FR LILPARK (DC),581,1115,891,886,5,229,224,0,534,-91.9104991394148,12,22,22,22,0,0,0,0,10,-83.33333333333333,100.0,100.0,0.0,79.91031390134529,79.46188340807176,0.4484304932735341,Previsions
919,0,2019-03-11,127395,DANONE LAIT ENT AROME VAN 125X8,0,0,0,DANONE,0,Bailleul(FR),0085,0024 FR TOULOUSE (DC),581,1115,891,886,5,229,224,0,534,-91.9104991394148,47,120,43,43,0,77,77,0,73,-155.31914893617022,35.833333333333336,35.833333333333336,0.0,79.91031390134529,79.46188340807176,0.4484304932735341,Previsions
920,0,2019-03-11,127395,DANONE LAIT ENT AROME VAN 125X8,0,0,0,DANONE,0,Bailleul(FR),0083,0024 FR CHAPONNAY (DC),581,1115,891,886,5,229,224,0,534,-91.9104991394148,47,84,84,84,0,0,0,0,37,-78.72340425531915,100.0,100.0,0.0,79.91031390134529,79.46188340807176,0.4484304932735341,Previsions
921,0,2019-03-11,127395,DANONE LAIT ENT AROME VAN 125X8,0,0,0,DANONE,0,Bailleul(FR),0079,0024 FR PARIS SUD (DC),581,1115,891,886,5,229,224,0,534,-91.9104991394148,40,144,69,69,0,75,75,0,104,-260.0,47.91666666666667,47.91666666666667,0.0,79.91031390134529,79.46188340807176,0.4484304932735341,Previsions
922,0,2019-03-11,127395,DANONE LAIT ENT AROME VAN 125X8,0,0,0,DANONE,0,Bailleul(FR),0078,0024 FR PARIS NORD (DC),581,1115,891,886,5,229,224,0,534,-91.9104991394148,41,35,35,35,0,0,0,0,-6,14.634146341463415,100.0,100.0,0.0,79.91031390134529,79.46188340807176,0.4484304932735341,Previsions
923,0,2019-03-11,127396,DANONE LAIT ENT FLEUR ORAN 125X4,0,0,0,DANONE,0,Bailleul(FR),0084,0024 FR AIX (DC),815,1166,971,962,9,204,195,0,351,-43.06748466257669,62,142,124,122,2,20,18,0,80,-129.03225806451613,87.32394366197182,85.91549295774648,1.408450704225345,83.2761578044597,82.50428816466552,0.7718696397941756,Previsions
924,0,2019-03-11,127396,DANONE LAIT ENT FLEUR ORAN 125X4,0,0,0,DANONE,0,Bailleul(FR),0080,0024 FR METZ (DC),815,1166,971,962,9,204,195,0,351,-43.06748466257669,102,156,156,156,0,0,0,0,54,-52.94117647058823,100.0,100.0,0.0,83.2761578044597,82.50428816466552,0.7718696397941756,Previsions
925,0,2019-03-11,127396,DANONE LAIT ENT FLEUR ORAN 125X4,0,0,0,DANONE,0,Bailleul(FR),0081,0024 FR TOURS (DC),815,1166,971,962,9,204,195,0,351,-43.06748466257669,153,205,174,174,0,31,31,0,52,-33.98692810457516,84.8780487804878,84.8780487804878,0.0,83.2761578044597,82.50428816466552,0.7718696397941756,Previsions
926,0,2019-03-11,127396,DANONE LAIT ENT FLEUR ORAN 125X4,0,0,0,DANONE,0,Bailleul(FR),0082,0024 FR VALLET (DC),815,1166,971,962,9,204,195,0,351,-43.06748466257669,63,107,107,107,0,0,0,0,44,-69.84126984126983,100.0,100.0,0.0,83.2761578044597,82.50428816466552,0.7718696397941756,Previsions
927,0,2019-03-11,127396,DANONE LAIT ENT FLEUR ORAN 125X4,0,0,0,DANONE,0,Bailleul(FR),0077,0024 FR LILPARK (DC),815,1166,971,962,9,204,195,0,351,-43.06748466257669,13,13,13,13,0,0,0,0,0,0.0,100.0,100.0,0.0,83.2761578044597,82.50428816466552,0.7718696397941756,Previsions
928,0,2019-03-11,127396,DANONE LAIT ENT FLEUR ORAN 125X4,0,0,0,DANONE,0,Bailleul(FR),0085,0024 FR TOULOUSE (DC),815,1166,971,962,9,204,195,0,351,-43.06748466257669,124,177,119,119,0,58,58,0,53,-42.74193548387097,67.2316384180791,67.2316384180791,0.0,83.2761578044597,82.50428816466552,0.7718696397941756,Previsions
929,0,2019-03-11,127396,DANONE LAIT ENT FLEUR ORAN 125X4,0,0,0,DANONE,0,Bailleul(FR),0083,0024 FR CHAPONNAY (DC),815,1166,971,962,9,204,195,0,351,-43.06748466257669,106,144,56,56,0,88,88,0,38,-35.84905660377358,38.88888888888889,38.88888888888889,0.0,83.2761578044597,82.50428816466552,0.7718696397941756,Previsions
930,0,2019-03-11,127396,DANONE LAIT ENT FLEUR ORAN 125X4,0,0,0,DANONE,0,Bailleul(FR),0079,0024 FR PARIS SUD (DC),815,1166,971,962,9,204,195,0,351,-43.06748466257669,43,113,113,106,7,7,0,0,70,-162.7906976744186,100.0,93.80530973451327,6.194690265486727,83.2761578044597,82.50428816466552,0.7718696397941756,Previsions
931,0,2019-03-11,127396,DANONE LAIT ENT FLEUR ORAN 125X4,0,0,0,DANONE,0,Bailleul(FR),0078,0024 FR PARIS NORD (DC),815,1166,971,962,9,204,195,0,351,-43.06748466257669,149,109,109,109,0,0,0,0,-40,26.845637583892618,100.0,100.0,0.0,83.2761578044597,82.50428816466552,0.7718696397941756,Previsions
932,0,2019-03-11,128869,LES 2 VACHES CHOCOLATE 95X4,0,0,0,LES 2 VACHES,0,LeMolay(FR),0084,0024 FR AIX (DC),3395,3359,3061,3061,0,298,298,0,-36,1.0603829160530192,176,193,193,193,0,0,0,0,17,-9.659090909090908,100.0,100.0,0.0,91.12831199761834,91.12831199761834,0.0,Previsions
933,0,2019-03-11,128869,LES 2 VACHES CHOCOLATE 95X4,0,0,0,LES 2 VACHES,0,LeMolay(FR),0080,0024 FR METZ (DC),3395,3359,3061,3061,0,298,298,0,-36,1.0603829160530192,308,318,318,318,0,0,0,0,10,-3.2467532467532467,100.0,100.0,0.0,91.12831199761834,91.12831199761834,0.0,Previsions
934,0,2019-03-11,128869,LES 2 VACHES CHOCOLATE 95X4,0,0,0,LES 2 VACHES,0,LeMolay(FR),0081,0024 FR TOURS (DC),3395,3359,3061,3061,0,298,298,0,-36,1.0603829160530192,350,331,331,331,0,0,0,0,-19,5.428571428571429,100.0,100.0,0.0,91.12831199761834,91.12831199761834,0.0,Previsions
935,0,2019-03-11,128869,LES 2 VACHES CHOCOLATE 95X4,0,0,0,LES 2 VACHES,0,LeMolay(FR),0082,0024 FR VALLET (DC),3395,3359,3061,3061,0,298,298,0,-36,1.0603829160530192,588,645,449,449,0,196,196,0,57,-9.693877551020408,69.61240310077518,69.61240310077518,0.0,91.12831199761834,91.12831199761834,0.0,Previsions
936,0,2019-03-11,128869,LES 2 VACHES CHOCOLATE 95X4,0,0,0,LES 2 VACHES,0,LeMolay(FR),0077,0024 FR LILPARK (DC),3395,3359,3061,3061,0,298,298,0,-36,1.0603829160530192,153,158,158,158,0,0,0,0,5,-3.2679738562091503,100.0,100.0,0.0,91.12831199761834,91.12831199761834,0.0,Previsions
937,0,2019-03-11,128869,LES 2 VACHES CHOCOLATE 95X4,0,0,0,LES 2 VACHES,0,LeMolay(FR),0085,0024 FR TOULOUSE (DC),3395,3359,3061,3061,0,298,298,0,-36,1.0603829160530192,548,493,493,493,0,0,0,0,-55,10.036496350364963,100.0,100.0,0.0,91.12831199761834,91.12831199761834,0.0,Previsions
938,0,2019-03-11,128869,LES 2 VACHES CHOCOLATE 95X4,0,0,0,LES 2 VACHES,0,LeMolay(FR),0083,0024 FR CHAPONNAY (DC),3395,3359,3061,3061,0,298,298,0,-36,1.0603829160530192,518,471,471,471,0,0,0,0,-47,9.073359073359073,100.0,100.0,0.0,91.12831199761834,91.12831199761834,0.0,Previsions
939,0,2019-03-11,128869,LES 2 VACHES CHOCOLATE 95X4,0,0,0,LES 2 VACHES,0,LeMolay(FR),0079,0024 FR PARIS SUD (DC),3395,3359,3061,3061,0,298,298,0,-36,1.0603829160530192,433,304,304,304,0,0,0,0,-129,29.792147806004618,100.0,100.0,0.0,91.12831199761834,91.12831199761834,0.0,Previsions
940,0,2019-03-11,128869,LES 2 VACHES CHOCOLATE 95X4,0,0,0,LES 2 VACHES,0,LeMolay(FR),0078,0024 FR PARIS NORD (DC),3395,3359,3061,3061,0,298,298,0,-36,1.0603829160530192,321,446,344,344,0,102,102,0,125,-38.940809968847354,77.13004484304933,77.13004484304933,0.0,91.12831199761834,91.12831199761834,0.0,Previsions
941,0,2019-03-12,121321,ACTIMEL MULTI 3x(8x100g) FR,0,0,0,ACTIMEL,1,Rotselaar(BE),0080,0024 FR METZ (DC),1935,2106,1557,1551,6,555,549,0,171,-8.837209302325581,154,121,35,31,4,90,86,0,-33,21.428571428571427,28.92561983471074,25.6198347107438,3.305785123966942,73.93162393162393,73.64672364672364,0.2849002849002886,Schéma
942,0,2019-03-12,121321,ACTIMEL MULTI 3x(8x100g) FR,0,0,0,ACTIMEL,1,Rotselaar(BE),0081,0024 FR TOURS (DC),1935,2106,1557,1551,6,555,549,0,171,-8.837209302325581,325,273,2,0,2,273,271,0,-52,16.0,0.7326007326007326,0.0,0.7326007326007326,73.93162393162393,73.64672364672364,0.2849002849002886,Schéma
943,0,2019-03-12,121321,ACTIMEL MULTI 3x(8x100g) FR,0,0,0,ACTIMEL,1,Rotselaar(BE),0082,0024 FR VALLET (DC),1935,2106,1557,1551,6,555,549,0,171,-8.837209302325581,171,108,108,108,0,0,0,0,-63,36.8421052631579,100.0,100.0,0.0,73.93162393162393,73.64672364672364,0.2849002849002886,Schéma
944,0,2019-03-12,121321,ACTIMEL MULTI 3x(8x100g) FR,0,0,0,ACTIMEL,1,Rotselaar(BE),0077,0024 FR LILPARK (DC),1935,2106,1557,1551,6,555,549,0,171,-8.837209302325581,292,205,20,20,0,185,185,0,-87,29.794520547945204,9.75609756097561,9.75609756097561,0.0,73.93162393162393,73.64672364672364,0.2849002849002886,Schéma
945,0,2019-03-12,121321,ACTIMEL MULTI 3x(8x100g) FR,0,0,0,ACTIMEL,1,Rotselaar(BE),0085,0024 FR TOULOUSE (DC),1935,2106,1557,1551,6,555,549,0,171,-8.837209302325581,181,235,235,235,0,0,0,0,54,-29.834254143646408,100.0,100.0,0.0,73.93162393162393,73.64672364672364,0.2849002849002886,Schéma
946,0,2019-03-12,121321,ACTIMEL MULTI 3x(8x100g) FR,0,0,0,ACTIMEL,1,Rotselaar(BE),0083,0024 FR CHAPONNAY (DC),1935,2106,1557,1551,6,555,549,0,171,-8.837209302325581,252,299,292,292,0,7,7,0,47,-18.650793650793652,97.65886287625418,97.65886287625418,0.0,73.93162393162393,73.64672364672364,0.2849002849002886,Schéma
947,0,2019-03-12,121321,ACTIMEL MULTI 3x(8x100g) FR,0,0,0,ACTIMEL,1,Rotselaar(BE),0079,0024 FR PARIS SUD (DC),1935,2106,1557,1551,6,555,549,0,171,-8.837209302325581,427,640,640,640,0,0,0,0,213,-49.88290398126464,100.0,100.0,0.0,73.93162393162393,73.64672364672364,0.2849002849002886,Schéma
948,0,2019-03-12,121321,ACTIMEL MULTI 3x(8x100g) FR,0,0,0,ACTIMEL,1,Rotselaar(BE),0078,0024 FR PARIS NORD (DC),1935,2106,1557,1551,6,555,549,0,171,-8.837209302325581,133,225,225,225,0,0,0,0,92,-69.17293233082707,100.0,100.0,0.0,73.93162393162393,73.64672364672364,0.2849002849002886,Schéma
949,0,2019-03-12,127396,DANONE LAIT ENT FLEUR ORAN 125X4,0,0,0,DANONE,0,Bailleul(FR),0084,0024 FR AIX (DC),569,843,501,496,5,347,342,0,274,-48.154657293497365,139,137,91,91,0,46,46,0,-2,1.4388489208633093,66.42335766423358,66.42335766423358,0.0,59.430604982206404,58.83748517200475,0.5931198102016566,Previsions
950,0,2019-03-12,127396,DANONE LAIT ENT FLEUR ORAN 125X4,0,0,0,DANONE,0,Bailleul(FR),0080,0024 FR METZ (DC),569,843,501,496,5,347,342,0,274,-48.154657293497365,69,93,60,55,5,38,33,0,24,-34.78260869565217,64.51612903225806,59.13978494623656,5.376344086021504,59.430604982206404,58.83748517200475,0.5931198102016566,Previsions
951,0,2019-03-12,127396,DANONE LAIT ENT FLEUR ORAN 125X4,0,0,0,DANONE,0,Bailleul(FR),0081,0024 FR TOURS (DC),569,843,501,496,5,347,342,0,274,-48.154657293497365,107,137,44,44,0,93,93,0,30,-28.037383177570092,32.11678832116788,32.11678832116788,0.0,59.430604982206404,58.83748517200475,0.5931198102016566,Previsions
952,0,2019-03-12,127396,DANONE LAIT ENT FLEUR ORAN 125X4,0,0,0,DANONE,0,Bailleul(FR),0082,0024 FR VALLET (DC),569,843,501,496,5,347,342,0,274,-48.154657293497365,22,57,2,2,0,55,55,0,35,-159.0909090909091,3.508771929824561,3.508771929824561,0.0,59.430604982206404,58.83748517200475,0.5931198102016566,Previsions
953,0,2019-03-12,127396,DANONE LAIT ENT FLEUR ORAN 125X4,0,0,0,DANONE,0,Bailleul(FR),0077,0024 FR LILPARK (DC),569,843,501,496,5,347,342,0,274,-48.154657293497365,45,86,85,85,0,1,1,0,41,-91.11111111111111,98.83720930232558,98.83720930232558,0.0,59.430604982206404,58.83748517200475,0.5931198102016566,Previsions
954,0,2019-03-12,127396,DANONE LAIT ENT FLEUR ORAN 125X4,0,0,0,DANONE,0,Bailleul(FR),0085,0024 FR TOULOUSE (DC),569,843,501,496,5,347,342,0,274,-48.154657293497365,81,166,87,87,0,79,79,0,85,-104.93827160493827,52.40963855421686,52.40963855421686,0.0,59.430604982206404,58.83748517200475,0.5931198102016566,Previsions
955,0,2019-03-12,127396,DANONE LAIT ENT FLEUR ORAN 125X4,0,0,0,DANONE,0,Bailleul(FR),0083,0024 FR CHAPONNAY (DC),569,843,501,496,5,347,342,0,274,-48.154657293497365,52,106,78,78,0,28,28,0,54,-103.84615384615384,73.58490566037736,73.58490566037736,0.0,59.430604982206404,58.83748517200475,0.5931198102016566,Previsions
956,0,2019-03-12,127396,DANONE LAIT ENT FLEUR ORAN 125X4,0,0,0,DANONE,0,Bailleul(FR),0078,0024 FR PARIS NORD (DC),569,843,501,496,5,347,342,0,274,-48.154657293497365,54,61,54,54,0,7,7,0,7,-12.962962962962964,88.52459016393442,88.52459016393442,0.0,59.430604982206404,58.83748517200475,0.5931198102016566,Previsions
957,0,2019-03-12,127398,DANONE LAIT ENTIER CITRON 125X4,0,0,0,DANONE,0,Bailleul(FR),0084,0024 FR AIX (DC),848,1061,698,697,1,364,363,0,213,-25.117924528301888,146,141,65,65,0,76,76,0,-5,3.4246575342465753,46.09929078014184,46.09929078014184,0.0,65.78699340245052,65.69274269557022,0.09425070688030246,Previsions
958,1,2019-03-12,127398,DANONE LAIT ENTIER CITRON 125X4,0,0,0,DANONE,0,Bailleul(FR),0084,0024 FR AIX (DC),848,1061,698,697,1,364,363,0,213,-25.117924528301888,146,141,65,65,0,76,76,0,-5,3.4246575342465753,46.09929078014184,46.09929078014184,0.0,65.78699340245052,65.69274269557022,0.09425070688030246,Previsions
959,0,2019-03-12,127398,DANONE LAIT ENTIER CITRON 125X4,0,0,0,DANONE,0,Bailleul(FR),0080,0024 FR METZ (DC),848,1061,698,697,1,364,363,0,213,-25.117924528301888,70,97,58,58,0,39,39,0,27,-38.57142857142857,59.79381443298969,59.79381443298969,0.0,65.78699340245052,65.69274269557022,0.09425070688030246,Previsions
960,0,2019-03-12,127398,DANONE LAIT ENTIER CITRON 125X4,0,0,0,DANONE,0,Bailleul(FR),0081,0024 FR TOURS (DC),848,1061,698,697,1,364,363,0,213,-25.117924528301888,125,203,73,73,0,130,130,0,78,-62.4,35.960591133004925,35.960591133004925,0.0,65.78699340245052,65.69274269557022,0.09425070688030246,Previsions
961,0,2019-03-12,127398,DANONE LAIT ENTIER CITRON 125X4,0,0,0,DANONE,0,Bailleul(FR),0082,0024 FR VALLET (DC),848,1061,698,697,1,364,363,0,213,-25.117924528301888,46,82,31,30,1,52,51,0,36,-78.26086956521739,37.80487804878049,36.58536585365854,1.2195121951219505,65.78699340245052,65.69274269557022,0.09425070688030246,Previsions
962,0,2019-03-12,127398,DANONE LAIT ENTIER CITRON 125X4,0,0,0,DANONE,0,Bailleul(FR),0077,0024 FR LILPARK (DC),848,1061,698,697,1,364,363,0,213,-25.117924528301888,65,109,109,109,0,0,0,0,44,-67.6923076923077,100.0,100.0,0.0,65.78699340245052,65.69274269557022,0.09425070688030246,Previsions
963,0,2019-03-12,127398,DANONE LAIT ENTIER CITRON 125X4,0,0,0,DANONE,0,Bailleul(FR),0085,0024 FR TOULOUSE (DC),848,1061,698,697,1,364,363,0,213,-25.117924528301888,93,158,96,96,0,62,62,0,65,-69.89247311827957,60.75949367088608,60.75949367088608,0.0,65.78699340245052,65.69274269557022,0.09425070688030246,Previsions
964,0,2019-03-12,127398,DANONE LAIT ENTIER CITRON 125X4,0,0,0,DANONE,0,Bailleul(FR),0083,0024 FR CHAPONNAY (DC),848,1061,698,697,1,364,363,0,213,-25.117924528301888,93,189,184,184,0,5,5,0,96,-103.2258064516129,97.35449735449735,97.35449735449735,0.0,65.78699340245052,65.69274269557022,0.09425070688030246,Previsions
965,0,2019-03-12,127398,DANONE LAIT ENTIER CITRON 125X4,0,0,0,DANONE,0,Bailleul(FR),0078,0024 FR PARIS NORD (DC),848,1061,698,697,1,364,363,0,213,-25.117924528301888,64,82,82,82,0,0,0,0,18,-28.125,100.0,100.0,0.0,65.78699340245052,65.69274269557022,0.09425070688030246,Previsions
966,0,2019-03-12,135119,ACTIVIA SAV CITRON 125X16 OD,0,0,0,ACTIVIA,0,Bailleul(FR),0084,0024 FR AIX (DC),813,958,591,589,2,369,367,0,145,-17.83517835178352,244,244,162,162,0,82,82,0,0,0.0,66.39344262295081,66.39344262295081,0.0,61.691022964509386,61.48225469728601,0.20876826722337682,A Creuser
967,0,2019-03-12,135119,ACTIVIA SAV CITRON 125X16 OD,0,0,0,ACTIVIA,0,Bailleul(FR),0080,0024 FR METZ (DC),813,958,591,589,2,369,367,0,145,-17.83517835178352,42,42,42,42,0,0,0,0,0,0.0,100.0,100.0,0.0,61.691022964509386,61.48225469728601,0.20876826722337682,A Creuser
968,0,2019-03-12,135119,ACTIVIA SAV CITRON 125X16 OD,0,0,0,ACTIVIA,0,Bailleul(FR),0081,0024 FR TOURS (DC),813,958,591,589,2,369,367,0,145,-17.83517835178352,77,77,77,77,0,0,0,0,0,0.0,100.0,100.0,0.0,61.691022964509386,61.48225469728601,0.20876826722337682,A Creuser
969,0,2019-03-12,135119,ACTIVIA SAV CITRON 125X16 OD,0,0,0,ACTIVIA,0,Bailleul(FR),0082,0024 FR VALLET (DC),813,958,591,589,2,369,367,0,145,-17.83517835178352,111,153,13,13,0,140,140,0,42,-37.83783783783784,8.49673202614379,8.49673202614379,0.0,61.691022964509386,61.48225469728601,0.20876826722337682,A Creuser
970,0,2019-03-12,135119,ACTIVIA SAV CITRON 125X16 OD,0,0,0,ACTIVIA,0,Bailleul(FR),0077,0024 FR LILPARK (DC),813,958,591,589,2,369,367,0,145,-17.83517835178352,26,50,37,37,0,13,13,0,24,-92.3076923076923,74.0,74.0,0.0,61.691022964509386,61.48225469728601,0.20876826722337682,A Creuser
971,0,2019-03-12,135119,ACTIVIA SAV CITRON 125X16 OD,0,0,0,ACTIVIA,0,Bailleul(FR),0085,0024 FR TOULOUSE (DC),813,958,591,589,2,369,367,0,145,-17.83517835178352,91,170,149,147,2,23,21,0,79,-86.81318681318682,87.6470588235294,86.47058823529412,1.17647058823529,61.691022964509386,61.48225469728601,0.20876826722337682,A Creuser
972,0,2019-03-12,135119,ACTIVIA SAV CITRON 125X16 OD,0,0,0,ACTIVIA,0,Bailleul(FR),0083,0024 FR CHAPONNAY (DC),813,958,591,589,2,369,367,0,145,-17.83517835178352,168,168,57,57,0,111,111,0,0,0.0,33.92857142857143,33.92857142857143,0.0,61.691022964509386,61.48225469728601,0.20876826722337682,A Creuser
973,0,2019-03-12,135119,ACTIVIA SAV CITRON 125X16 OD,0,0,0,ACTIVIA,0,Bailleul(FR),0078,0024 FR PARIS NORD (DC),813,958,591,589,2,369,367,0,145,-17.83517835178352,54,54,54,54,0,0,0,0,0,0.0,100.0,100.0,0.0,61.691022964509386,61.48225469728601,0.20876826722337682,A Creuser
974,1,2019-03-12,140278,Activia almond/muesli/chia 170g FR-copac,0,0,0,ACTIVIA,1,Roumanie(RO),0082,0024 FR VALLET (DC),83,753,532,461,71,292,221,0,670,-807.2289156626506,83,63,40,0,40,63,23,0,-20,24.096385542168676,63.49206349206349,0.0,63.49206349206349,70.6507304116866,61.221779548472774,9.42895086321382,Transport
975,0,2019-03-12,140280,Activia chia/raspb/muesli 170g FR-copack,0,0,0,ACTIVIA,1,Roumanie(RO),0080,0024 FR METZ (DC),929,731,566,359,207,372,165,0,-198,21.31324004305705,60,58,51,0,51,58,7,0,-2,3.3333333333333335,87.93103448275862,0.0,87.93103448275862,77.4281805745554,49.11080711354309,28.31737346101231,Transport
976,1,2019-03-12,140280,Activia chia/raspb/muesli 170g FR-copack,0,0,0,ACTIVIA,1,Roumanie(RO),0080,0024 FR METZ (DC),929,731,566,359,207,372,165,0,-198,21.31324004305705,60,58,51,0,51,58,7,0,-2,3.3333333333333335,87.93103448275862,0.0,87.93103448275862,77.4281805745554,49.11080711354309,28.31737346101231,Transport
977,0,2019-03-12,140280,Activia chia/raspb/muesli 170g FR-copack,0,0,0,ACTIVIA,1,Roumanie(RO),0081,0024 FR TOURS (DC),929,731,566,359,207,372,165,0,-198,21.31324004305705,97,98,49,49,0,49,49,0,1,-1.0309278350515463,50.0,50.0,0.0,77.4281805745554,49.11080711354309,28.31737346101231,Transport
978,0,2019-03-12,140280,Activia chia/raspb/muesli 170g FR-copack,0,0,0,ACTIVIA,1,Roumanie(RO),0082,0024 FR VALLET (DC),929,731,566,359,207,372,165,0,-198,21.31324004305705,86,76,76,24,52,52,0,0,-10,11.627906976744185,100.0,31.57894736842105,68.42105263157895,77.4281805745554,49.11080711354309,28.31737346101231,Transport
979,1,2019-03-12,140280,Activia chia/raspb/muesli 170g FR-copack,0,0,0,ACTIVIA,1,Roumanie(RO),0082,0024 FR VALLET (DC),929,731,566,359,207,372,165,0,-198,21.31324004305705,86,76,76,24,52,52,0,0,-10,11.627906976744185,100.0,31.57894736842105,68.42105263157895,77.4281805745554,49.11080711354309,28.31737346101231,Transport
980,0,2019-03-12,140280,Activia chia/raspb/muesli 170g FR-copack,0,0,0,ACTIVIA,1,Roumanie(RO),0077,0024 FR LILPARK (DC),929,731,566,359,207,372,165,0,-198,21.31324004305705,90,89,66,55,11,34,23,0,-1,1.1111111111111112,74.15730337078652,61.79775280898876,12.35955056179776,77.4281805745554,49.11080711354309,28.31737346101231,Transport
981,0,2019-03-12,140280,Activia chia/raspb/muesli 170g FR-copack,0,0,0,ACTIVIA,1,Roumanie(RO),0085,0024 FR TOULOUSE (DC),929,731,566,359,207,372,165,0,-198,21.31324004305705,44,72,45,10,35,62,27,0,28,-63.63636363636363,62.5,13.88888888888889,48.611111111111114,77.4281805745554,49.11080711354309,28.31737346101231,Transport
982,0,2019-03-12,140280,Activia chia/raspb/muesli 170g FR-copack,0,0,0,ACTIVIA,1,Roumanie(RO),0083,0024 FR CHAPONNAY (DC),929,731,566,359,207,372,165,0,-198,21.31324004305705,75,93,89,89,0,4,4,0,18,-24.0,95.6989247311828,95.6989247311828,0.0,77.4281805745554,49.11080711354309,28.31737346101231,Transport
983,0,2019-03-12,140280,Activia chia/raspb/muesli 170g FR-copack,0,0,0,ACTIVIA,1,Roumanie(RO),0079,0024 FR PARIS SUD (DC),929,731,566,359,207,372,165,0,-198,21.31324004305705,73,157,136,132,4,25,21,0,84,-115.06849315068493,86.62420382165605,84.07643312101911,2.5477707006369457,77.4281805745554,49.11080711354309,28.31737346101231,Transport
984,0,2019-03-12,140280,Activia chia/raspb/muesli 170g FR-copack,0,0,0,ACTIVIA,1,Roumanie(RO),0078,0024 FR PARIS NORD (DC),929,731,566,359,207,372,165,0,-198,21.31324004305705,129,88,54,0,54,88,34,0,-41,31.782945736434108,61.36363636363637,0.0,61.36363636363637,77.4281805745554,49.11080711354309,28.31737346101231,Transport
985,1,2019-03-12,140280,Activia chia/raspb/muesli 170g FR-copack,0,0,0,ACTIVIA,1,Roumanie(RO),0078,0024 FR PARIS NORD (DC),929,731,566,359,207,372,165,0,-198,21.31324004305705,129,88,54,0,54,88,34,0,-41,31.782945736434108,61.36363636363637,0.0,61.36363636363637,77.4281805745554,49.11080711354309,28.31737346101231,Transport
986,1,2019-03-12,142727,ACTIVIA SAV VAN FRAM 125X12+4,0,0,0,ACTIVIA,0,Bailleul(FR),0080,0024 FR METZ (DC),178,870,827,807,20,63,43,0,692,-388.76404494382024,178,178,135,115,20,63,43,0,0,0.0,75.84269662921348,64.60674157303372,11.235955056179762,95.05747126436782,92.75862068965517,2.2988505747126453,Expe usine
987,0,2019-03-13,105287,DANET MOUS CHOC LIEG 80gx4 Lidl,0,0,0,DANETTE,1,Ochsenfurt(ALL),0084,0024 FR AIX (DC),6287,5808,4350,4311,39,1497,1458,0,-479,7.618896134881502,989,840,664,664,0,176,176,0,-149,15.06572295247725,79.04761904761905,79.04761904761905,0.0,74.89669421487604,74.22520661157024,0.6714876033057919,Client
988,0,2019-03-13,105287,DANET MOUS CHOC LIEG 80gx4 Lidl,0,0,0,DANETTE,1,Ochsenfurt(ALL),0080,0024 FR METZ (DC),6287,5808,4350,4311,39,1497,1458,0,-479,7.618896134881502,1206,1080,609,609,0,471,471,0,-126,10.447761194029852,56.388888888888886,56.388888888888886,0.0,74.89669421487604,74.22520661157024,0.6714876033057919,Client
989,0,2019-03-13,105287,DANET MOUS CHOC LIEG 80gx4 Lidl,0,0,0,DANETTE,1,Ochsenfurt(ALL),0081,0024 FR TOURS (DC),6287,5808,4350,4311,39,1497,1458,0,-479,7.618896134881502,845,480,232,232,0,248,248,0,-365,43.19526627218935,48.333333333333336,48.333333333333336,0.0,74.89669421487604,74.22520661157024,0.6714876033057919,Client
990,0,2019-03-13,105287,DANET MOUS CHOC LIEG 80gx4 Lidl,0,0,0,DANETTE,1,Ochsenfurt(ALL),0082,0024 FR VALLET (DC),6287,5808,4350,4311,39,1497,1458,0,-479,7.618896134881502,339,240,175,136,39,104,65,0,-99,29.20353982300885,72.91666666666666,56.666666666666664,16.249999999999993,74.89669421487604,74.22520661157024,0.6714876033057919,Client
991,0,2019-03-13,105287,DANET MOUS CHOC LIEG 80gx4 Lidl,0,0,0,DANETTE,1,Ochsenfurt(ALL),0077,0024 FR LILPARK (DC),6287,5808,4350,4311,39,1497,1458,0,-479,7.618896134881502,867,960,742,742,0,218,218,0,93,-10.726643598615917,77.29166666666667,77.29166666666667,0.0,74.89669421487604,74.22520661157024,0.6714876033057919,Client
992,0,2019-03-13,105287,DANET MOUS CHOC LIEG 80gx4 Lidl,0,0,0,DANETTE,1,Ochsenfurt(ALL),0085,0024 FR TOULOUSE (DC),6287,5808,4350,4311,39,1497,1458,0,-479,7.618896134881502,573,240,240,240,0,0,0,0,-333,58.1151832460733,100.0,100.0,0.0,74.89669421487604,74.22520661157024,0.6714876033057919,Client
993,0,2019-03-13,105287,DANET MOUS CHOC LIEG 80gx4 Lidl,0,0,0,DANETTE,1,Ochsenfurt(ALL),0083,0024 FR CHAPONNAY (DC),6287,5808,4350,4311,39,1497,1458,0,-479,7.618896134881502,527,600,600,600,0,0,0,0,73,-13.851992409867172,100.0,100.0,0.0,74.89669421487604,74.22520661157024,0.6714876033057919,Client
994,0,2019-03-13,105287,DANET MOUS CHOC LIEG 80gx4 Lidl,0,0,0,DANETTE,1,Ochsenfurt(ALL),0079,0024 FR PARIS SUD (DC),6287,5808,4350,4311,39,1497,1458,0,-479,7.618896134881502,154,408,136,136,0,272,272,0,254,-164.93506493506493,33.33333333333333,33.33333333333333,0.0,74.89669421487604,74.22520661157024,0.6714876033057919,Client
995,0,2019-03-13,105287,DANET MOUS CHOC LIEG 80gx4 Lidl,0,0,0,DANETTE,1,Ochsenfurt(ALL),0078,0024 FR PARIS NORD (DC),6287,5808,4350,4311,39,1497,1458,0,-479,7.618896134881502,787,960,952,952,0,8,8,0,173,-21.982210927573064,99.16666666666667,99.16666666666667,0.0,74.89669421487604,74.22520661157024,0.6714876033057919,Client
996,0,2019-03-13,133234,VELOUTE FRUIX PANACHE 125X12 D,1,0,0,VELOUTE,0,Villecomtal(FR),0084,0024 FR AIX (DC),17280,7680,5040,4968,72,2712,2640,0,-9600,55.55555555555556,1455,1152,1140,1140,0,12,12,0,-303,20.824742268041238,98.95833333333334,98.95833333333334,0.0,65.625,64.6875,0.9375,A Creuser
997,0,2019-03-13,133234,VELOUTE FRUIX PANACHE 125X12 D,1,0,0,VELOUTE,0,Villecomtal(FR),0080,0024 FR METZ (DC),17280,7680,5040,4968,72,2712,2640,0,-9600,55.55555555555556,1687,1344,1262,1262,0,82,82,0,-343,20.33195020746888,93.89880952380952,93.89880952380952,0.0,65.625,64.6875,0.9375,A Creuser
998,0,2019-03-13,133234,VELOUTE FRUIX PANACHE 125X12 D,1,0,0,VELOUTE,0,Villecomtal(FR),0081,0024 FR TOURS (DC),17280,7680,5040,4968,72,2712,2640,0,-9600,55.55555555555556,2574,576,129,129,0,447,447,0,-1998,77.62237762237763,22.395833333333336,22.395833333333336,0.0,65.625,64.6875,0.9375,A Creuser
999,0,2019-03-13,133234,VELOUTE FRUIX PANACHE 125X12 D,1,0,0,VELOUTE,0,Villecomtal(FR),0082,0024 FR VALLET (DC),17280,7680,5040,4968,72,2712,2640,0,-9600,55.55555555555556,669,432,186,186,0,246,246,0,-237,35.426008968609864,43.05555555555556,43.05555555555556,0.0,65.625,64.6875,0.9375,A Creuser
1000,0,2019-03-13,133234,VELOUTE FRUIX PANACHE 125X12 D,1,0,0,VELOUTE,0,Villecomtal(FR),0077,0024 FR LILPARK (DC),17280,7680,5040,4968,72,2712,2640,0,-9600,55.55555555555556,1950,1152,681,681,0,471,471,0,-798,40.92307692307692,59.114583333333336,59.114583333333336,0.0,65.625,64.6875,0.9375,A Creuser
1001,0,2019-03-13,133234,VELOUTE FRUIX PANACHE 125X12 D,1,0,0,VELOUTE,0,Villecomtal(FR),0085,0024 FR TOULOUSE (DC),17280,7680,5040,4968,72,2712,2640,0,-9600,55.55555555555556,658,288,126,288,-162,0,162,0,-370,56.23100303951368,43.75,100.0,-56.25,65.625,64.6875,0.9375,A Creuser
1002,0,2019-03-13,133234,VELOUTE FRUIX PANACHE 125X12 D,1,0,0,VELOUTE,0,Villecomtal(FR),0083,0024 FR CHAPONNAY (DC),17280,7680,5040,4968,72,2712,2640,0,-9600,55.55555555555556,2179,1008,666,432,234,576,342,0,-1171,53.74024782010096,66.07142857142857,42.857142857142854,23.214285714285715,65.625,64.6875,0.9375,A Creuser
1003,0,2019-03-13,133234,VELOUTE FRUIX PANACHE 125X12 D,1,0,0,VELOUTE,0,Villecomtal(FR),0079,0024 FR PARIS SUD (DC),17280,7680,5040,4968,72,2712,2640,0,-9600,55.55555555555556,1259,576,576,576,0,0,0,0,-683,54.249404289118345,100.0,100.0,0.0,65.625,64.6875,0.9375,A Creuser
1004,0,2019-03-13,133234,VELOUTE FRUIX PANACHE 125X12 D,1,0,0,VELOUTE,0,Villecomtal(FR),0078,0024 FR PARIS NORD (DC),17280,7680,5040,4968,72,2712,2640,0,-9600,55.55555555555556,4849,1152,274,274,0,878,878,0,-3697,76.24252423180037,23.78472222222222,23.78472222222222,0.0,65.625,64.6875,0.9375,A Creuser
1005,0,2019-03-13,135435,TAILLEFINE RED FRUIT 125X8 D,0,0,0,TAILLEFINE,0,Villecomtal(FR),0084,0024 FR AIX (DC),1673,1260,814,667,147,593,446,0,-413,24.686192468619247,698,585,255,216,39,369,330,0,-113,16.189111747851,43.58974358974359,36.92307692307693,6.666666666666664,64.60317460317461,52.93650793650794,11.666666666666671,Client
1006,0,2019-03-13,135435,TAILLEFINE RED FRUIT 125X8 D,0,0,0,TAILLEFINE,0,Villecomtal(FR),0081,0024 FR TOURS (DC),1673,1260,814,667,147,593,446,0,-413,24.686192468619247,481,135,19,19,0,116,116,0,-346,71.93347193347194,14.074074074074074,14.074074074074074,0.0,64.60317460317461,52.93650793650794,11.666666666666671,Client
1007,0,2019-03-13,135435,TAILLEFINE RED FRUIT 125X8 D,0,0,0,TAILLEFINE,0,Villecomtal(FR),0077,0024 FR LILPARK (DC),1673,1260,814,667,147,593,446,0,-413,24.686192468619247,494,540,540,432,108,108,0,0,46,-9.31174089068826,100.0,80.0,20.0,64.60317460317461,52.93650793650794,11.666666666666671,Client
1008,0,2019-03-13,145080,DANET CHOCOLAT 125GX6 D,0,1,0,DANETTE,0,StJust(FR),0084,0024 FR AIX (DC),10914,9828,6908,6907,1,2921,2920,0,-1086,9.950522264980759,1763,1638,1160,1160,0,478,478,0,-125,7.090187180941577,70.81807081807082,70.81807081807082,0.0,70.28897028897029,70.27879527879529,0.010175010175004218,Client
1009,0,2019-03-13,145080,DANET CHOCOLAT 125GX6 D,0,1,0,DANETTE,0,StJust(FR),0080,0024 FR METZ (DC),10914,9828,6908,6907,1,2921,2920,0,-1086,9.950522264980759,2086,1820,907,907,0,913,913,0,-266,12.751677852348994,49.83516483516483,49.83516483516483,0.0,70.28897028897029,70.27879527879529,0.010175010175004218,Client
1010,0,2019-03-13,145080,DANET CHOCOLAT 125GX6 D,0,1,0,DANETTE,0,StJust(FR),0081,0024 FR TOURS (DC),10914,9828,6908,6907,1,2921,2920,0,-1086,9.950522264980759,1375,728,330,330,0,398,398,0,-647,47.054545454545455,45.32967032967033,45.32967032967033,0.0,70.28897028897029,70.27879527879529,0.010175010175004218,Client
1011,0,2019-03-13,145080,DANET CHOCOLAT 125GX6 D,0,1,0,DANETTE,0,StJust(FR),0082,0024 FR VALLET (DC),10914,9828,6908,6907,1,2921,2920,0,-1086,9.950522264980759,642,546,530,530,0,16,16,0,-96,14.953271028037383,97.06959706959707,97.06959706959707,0.0,70.28897028897029,70.27879527879529,0.010175010175004218,Client
1012,0,2019-03-13,145080,DANET CHOCOLAT 125GX6 D,0,1,0,DANETTE,0,StJust(FR),0077,0024 FR LILPARK (DC),10914,9828,6908,6907,1,2921,2920,0,-1086,9.950522264980759,1066,1456,1040,1040,0,416,416,0,390,-36.58536585365854,71.42857142857143,71.42857142857143,0.0,70.28897028897029,70.27879527879529,0.010175010175004218,Client
1013,0,2019-03-13,145080,DANET CHOCOLAT 125GX6 D,0,1,0,DANETTE,0,StJust(FR),0085,0024 FR TOULOUSE (DC),10914,9828,6908,6907,1,2921,2920,0,-1086,9.950522264980759,937,364,364,364,0,0,0,0,-573,61.15261472785485,100.0,100.0,0.0,70.28897028897029,70.27879527879529,0.010175010175004218,Client
1014,0,2019-03-13,145080,DANET CHOCOLAT 125GX6 D,0,1,0,DANETTE,0,StJust(FR),0083,0024 FR CHAPONNAY (DC),10914,9828,6908,6907,1,2921,2920,0,-1086,9.950522264980759,1152,1092,985,985,0,107,107,0,-60,5.208333333333333,90.2014652014652,90.2014652014652,0.0,70.28897028897029,70.27879527879529,0.010175010175004218,Client
1015,0,2019-03-13,145080,DANET CHOCOLAT 125GX6 D,0,1,0,DANETTE,0,StJust(FR),0079,0024 FR PARIS SUD (DC),10914,9828,6908,6907,1,2921,2920,0,-1086,9.950522264980759,388,728,136,135,1,593,592,0,340,-87.62886597938144,18.681318681318682,18.543956043956044,0.13736263736263865,70.28897028897029,70.27879527879529,0.010175010175004218,Client
1016,0,2019-03-13,145080,DANET CHOCOLAT 125GX6 D,0,1,0,DANETTE,0,StJust(FR),0078,0024 FR PARIS NORD (DC),10914,9828,6908,6907,1,2921,2920,0,-1086,9.950522264980759,1505,1456,1456,1456,0,0,0,0,-49,3.255813953488372,100.0,100.0,0.0,70.28897028897029,70.27879527879529,0.010175010175004218,Client
1017,0,2019-03-13,145085,DANET VANILLE 125GX6 D,0,1,0,DANETTE,0,StJust(FR),0084,0024 FR AIX (DC),9219,8736,6844,6844,0,1892,1892,0,-483,5.239179954441913,1515,1274,808,808,0,466,466,0,-241,15.907590759075907,63.42229199372057,63.42229199372057,0.0,78.34249084249085,78.34249084249085,0.0,Client
1018,0,2019-03-13,145085,DANET VANILLE 125GX6 D,0,1,0,DANETTE,0,StJust(FR),0080,0024 FR METZ (DC),9219,8736,6844,6844,0,1892,1892,0,-483,5.239179954441913,1915,1638,614,614,0,1024,1024,0,-277,14.464751958224543,37.48473748473749,37.48473748473749,0.0,78.34249084249085,78.34249084249085,0.0,Client
1019,0,2019-03-13,145085,DANET VANILLE 125GX6 D,0,1,0,DANETTE,0,StJust(FR),0081,0024 FR TOURS (DC),9219,8736,6844,6844,0,1892,1892,0,-483,5.239179954441913,1047,546,393,393,0,153,153,0,-501,47.85100286532951,71.97802197802197,71.97802197802197,0.0,78.34249084249085,78.34249084249085,0.0,Client
1020,0,2019-03-13,145085,DANET VANILLE 125GX6 D,0,1,0,DANETTE,0,StJust(FR),0082,0024 FR VALLET (DC),9219,8736,6844,6844,0,1892,1892,0,-483,5.239179954441913,454,364,167,167,0,197,197,0,-90,19.823788546255507,45.879120879120876,45.879120879120876,0.0,78.34249084249085,78.34249084249085,0.0,Client
1021,0,2019-03-13,145085,DANET VANILLE 125GX6 D,0,1,0,DANETTE,0,StJust(FR),0077,0024 FR LILPARK (DC),9219,8736,6844,6844,0,1892,1892,0,-483,5.239179954441913,993,1274,1222,1222,0,52,52,0,281,-28.298086606243707,95.91836734693877,95.91836734693877,0.0,78.34249084249085,78.34249084249085,0.0,Client
1022,0,2019-03-13,145085,DANET VANILLE 125GX6 D,0,1,0,DANETTE,0,StJust(FR),0085,0024 FR TOULOUSE (DC),9219,8736,6844,6844,0,1892,1892,0,-483,5.239179954441913,689,364,364,364,0,0,0,0,-325,47.16981132075472,100.0,100.0,0.0,78.34249084249085,78.34249084249085,0.0,Client
1023,0,2019-03-13,145085,DANET VANILLE 125GX6 D,0,1,0,DANETTE,0,StJust(FR),0083,0024 FR CHAPONNAY (DC),9219,8736,6844,6844,0,1892,1892,0,-483,5.239179954441913,820,1092,1092,1092,0,0,0,0,272,-33.170731707317074,100.0,100.0,0.0,78.34249084249085,78.34249084249085,0.0,Client
1024,0,2019-03-13,145085,DANET VANILLE 125GX6 D,0,1,0,DANETTE,0,StJust(FR),0079,0024 FR PARIS SUD (DC),9219,8736,6844,6844,0,1892,1892,0,-483,5.239179954441913,267,728,728,728,0,0,0,0,461,-172.65917602996254,100.0,100.0,0.0,78.34249084249085,78.34249084249085,0.0,Client
1025,0,2019-03-13,145085,DANET VANILLE 125GX6 D,0,1,0,DANETTE,0,StJust(FR),0078,0024 FR PARIS NORD (DC),9219,8736,6844,6844,0,1892,1892,0,-483,5.239179954441913,1519,1456,1456,1456,0,0,0,0,-63,4.147465437788019,100.0,100.0,0.0,78.34249084249085,78.34249084249085,0.0,Client
1026,0,2019-03-14,133234,VELOUTE FRUIX PANACHE 125X12 D,1,0,0,VELOUTE,0,Villecomtal(FR),0084,0024 FR AIX (DC),5439,4368,4326,3790,536,578,42,0,-1071,19.69111969111969,472,144,144,144,0,0,0,0,-328,69.49152542372882,100.0,100.0,0.0,99.03846153846155,86.76739926739927,12.271062271062277,Client
1027,0,2019-03-14,133234,VELOUTE FRUIX PANACHE 125X12 D,1,0,0,VELOUTE,0,Villecomtal(FR),0080,0024 FR METZ (DC),5439,4368,4326,3790,536,578,42,0,-1071,19.69111969111969,676,336,336,336,0,0,0,0,-340,50.29585798816568,100.0,100.0,0.0,99.03846153846155,86.76739926739927,12.271062271062277,Client
1028,0,2019-03-14,133234,VELOUTE FRUIX PANACHE 125X12 D,1,0,0,VELOUTE,0,Villecomtal(FR),0081,0024 FR TOURS (DC),5439,4368,4326,3790,536,578,42,0,-1071,19.69111969111969,308,144,144,144,0,0,0,0,-164,53.246753246753244,100.0,100.0,0.0,99.03846153846155,86.76739926739927,12.271062271062277,Client
1029,0,2019-03-14,133234,VELOUTE FRUIX PANACHE 125X12 D,1,0,0,VELOUTE,0,Villecomtal(FR),0082,0024 FR VALLET (DC),5439,4368,4326,3790,536,578,42,0,-1071,19.69111969111969,262,288,246,246,0,42,42,0,26,-9.923664122137405,85.41666666666666,85.41666666666666,0.0,99.03846153846155,86.76739926739927,12.271062271062277,Client
1030,0,2019-03-14,133234,VELOUTE FRUIX PANACHE 125X12 D,1,0,0,VELOUTE,0,Villecomtal(FR),0077,0024 FR LILPARK (DC),5439,4368,4326,3790,536,578,42,0,-1071,19.69111969111969,689,288,288,288,0,0,0,0,-401,58.20029027576197,100.0,100.0,0.0,99.03846153846155,86.76739926739927,12.271062271062277,Client
1031,0,2019-03-14,133234,VELOUTE FRUIX PANACHE 125X12 D,1,0,0,VELOUTE,0,Villecomtal(FR),0085,0024 FR TOULOUSE (DC),5439,4368,4326,3790,536,578,42,0,-1071,19.69111969111969,651,720,720,720,0,0,0,0,69,-10.599078341013826,100.0,100.0,0.0,99.03846153846155,86.76739926739927,12.271062271062277,Client
1032,0,2019-03-14,133234,VELOUTE FRUIX PANACHE 125X12 D,1,0,0,VELOUTE,0,Villecomtal(FR),0083,0024 FR CHAPONNAY (DC),5439,4368,4326,3790,536,578,42,0,-1071,19.69111969111969,927,864,864,432,432,432,0,0,-63,6.796116504854369,100.0,50.0,50.0,99.03846153846155,86.76739926739927,12.271062271062277,Client
1033,0,2019-03-14,133234,VELOUTE FRUIX PANACHE 125X12 D,1,0,0,VELOUTE,0,Villecomtal(FR),0079,0024 FR PARIS SUD (DC),5439,4368,4326,3790,536,578,42,0,-1071,19.69111969111969,209,432,432,328,104,104,0,0,223,-106.69856459330144,100.0,75.92592592592592,24.074074074074076,99.03846153846155,86.76739926739927,12.271062271062277,Client
1034,0,2019-03-14,133234,VELOUTE FRUIX PANACHE 125X12 D,1,0,0,VELOUTE,0,Villecomtal(FR),0078,0024 FR PARIS NORD (DC),5439,4368,4326,3790,536,578,42,0,-1071,19.69111969111969,1245,1152,1152,1152,0,0,0,0,-93,7.469879518072289,100.0,100.0,0.0,99.03846153846155,86.76739926739927,12.271062271062277,Client
1035,0,2019-03-14,135358,TAILLEFINE YELLOW FRUIT 125X8 D,0,0,0,TAILLEFINE,0,Villecomtal(FR),0080,0024 FR METZ (DC),806,675,606,536,70,139,69,0,-131,16.253101736972706,164,225,225,221,4,4,0,0,61,-37.19512195121951,100.0,98.22222222222223,1.7777777777777715,89.77777777777777,79.4074074074074,10.370370370370367,Client
1036,0,2019-03-14,135358,TAILLEFINE YELLOW FRUIT 125X8 D,0,0,0,TAILLEFINE,0,Villecomtal(FR),0082,0024 FR VALLET (DC),806,675,606,536,70,139,69,0,-131,16.253101736972706,130,90,90,90,0,0,0,0,-40,30.76923076923077,100.0,100.0,0.0,89.77777777777777,79.4074074074074,10.370370370370367,Client
1037,0,2019-03-14,135358,TAILLEFINE YELLOW FRUIT 125X8 D,0,0,0,TAILLEFINE,0,Villecomtal(FR),0077,0024 FR LILPARK (DC),806,675,606,536,70,139,69,0,-131,16.253101736972706,286,45,45,45,0,0,0,0,-241,84.26573426573427,100.0,100.0,0.0,89.77777777777777,79.4074074074074,10.370370370370367,Client
1038,0,2019-03-14,135358,TAILLEFINE YELLOW FRUIT 125X8 D,0,0,0,TAILLEFINE,0,Villecomtal(FR),0083,0024 FR CHAPONNAY (DC),806,675,606,536,70,139,69,0,-131,16.253101736972706,226,315,246,180,66,135,69,0,89,-39.38053097345133,78.0952380952381,57.14285714285714,20.952380952380963,89.77777777777777,79.4074074074074,10.370370370370367,Client
1039,0,2019-03-14,145085,DANET VANILLE 125GX6 D,0,1,0,DANETTE,0,StJust(FR),0084,0024 FR AIX (DC),4695,4368,4262,4087,175,281,106,0,-327,6.964856230031949,515,182,182,182,0,0,0,0,-333,64.66019417475728,100.0,100.0,0.0,97.57326007326007,93.56684981684981,4.006410256410263,Client
1040,0,2019-03-14,145085,DANET VANILLE 125GX6 D,0,1,0,DANETTE,0,StJust(FR),0080,0024 FR METZ (DC),4695,4368,4262,4087,175,281,106,0,-327,6.964856230031949,658,728,728,728,0,0,0,0,70,-10.638297872340425,100.0,100.0,0.0,97.57326007326007,93.56684981684981,4.006410256410263,Client
1041,0,2019-03-14,145085,DANET VANILLE 125GX6 D,0,1,0,DANETTE,0,StJust(FR),0081,0024 FR TOURS (DC),4695,4368,4262,4087,175,281,106,0,-327,6.964856230031949,389,182,182,182,0,0,0,0,-207,53.2133676092545,100.0,100.0,0.0,97.57326007326007,93.56684981684981,4.006410256410263,Client
1042,0,2019-03-14,145085,DANET VANILLE 125GX6 D,0,1,0,DANETTE,0,StJust(FR),0082,0024 FR VALLET (DC),4695,4368,4262,4087,175,281,106,0,-327,6.964856230031949,164,364,364,364,0,0,0,0,200,-121.95121951219512,100.0,100.0,0.0,97.57326007326007,93.56684981684981,4.006410256410263,Client
1043,0,2019-03-14,145085,DANET VANILLE 125GX6 D,0,1,0,DANETTE,0,StJust(FR),0077,0024 FR LILPARK (DC),4695,4368,4262,4087,175,281,106,0,-327,6.964856230031949,412,364,364,364,0,0,0,0,-48,11.650485436893204,100.0,100.0,0.0,97.57326007326007,93.56684981684981,4.006410256410263,Client
1044,0,2019-03-14,145085,DANET VANILLE 125GX6 D,0,1,0,DANETTE,0,StJust(FR),0085,0024 FR TOULOUSE (DC),4695,4368,4262,4087,175,281,106,0,-327,6.964856230031949,604,728,728,728,0,0,0,0,124,-20.52980132450331,100.0,100.0,0.0,97.57326007326007,93.56684981684981,4.006410256410263,Client
1045,0,2019-03-14,145085,DANET VANILLE 125GX6 D,0,1,0,DANETTE,0,StJust(FR),0083,0024 FR CHAPONNAY (DC),4695,4368,4262,4087,175,281,106,0,-327,6.964856230031949,921,546,546,546,0,0,0,0,-375,40.71661237785016,100.0,100.0,0.0,97.57326007326007,93.56684981684981,4.006410256410263,Client
1046,0,2019-03-14,145085,DANET VANILLE 125GX6 D,0,1,0,DANETTE,0,StJust(FR),0079,0024 FR PARIS SUD (DC),4695,4368,4262,4087,175,281,106,0,-327,6.964856230031949,199,364,258,83,175,281,106,0,165,-82.91457286432161,70.87912087912088,22.802197802197803,48.07692307692307,97.57326007326007,93.56684981684981,4.006410256410263,Client
1047,0,2019-03-14,145085,DANET VANILLE 125GX6 D,0,1,0,DANETTE,0,StJust(FR),0078,0024 FR PARIS NORD (DC),4695,4368,4262,4087,175,281,106,0,-327,6.964856230031949,833,910,910,910,0,0,0,0,77,-9.243697478991596,100.0,100.0,0.0,97.57326007326007,93.56684981684981,4.006410256410263,Client
1048,0,2019-03-15,433,DANET MOUS CHOC LIEG 80gx4,1,0,0,DANETTE,1,Ochsenfurt(ALL),0084,0024 FR AIX (DC),2010,1968,1870,1481,389,487,98,0,-42,2.08955223880597,265,266,221,221,0,45,45,0,1,-0.37735849056603776,83.0827067669173,83.0827067669173,0.0,95.02032520325203,75.2540650406504,19.766260162601625,Client
1049,0,2019-03-15,433,DANET MOUS CHOC LIEG 80gx4,1,0,0,DANETTE,1,Ochsenfurt(ALL),0080,0024 FR METZ (DC),2010,1968,1870,1481,389,487,98,0,-42,2.08955223880597,186,188,188,0,188,188,0,0,2,-1.075268817204301,100.0,0.0,100.0,95.02032520325203,75.2540650406504,19.766260162601625,Client
1050,0,2019-03-15,433,DANET MOUS CHOC LIEG 80gx4,1,0,0,DANETTE,1,Ochsenfurt(ALL),0081,0024 FR TOURS (DC),2010,1968,1870,1481,389,487,98,0,-42,2.08955223880597,387,382,381,380,1,2,1,0,-5,1.2919896640826873,99.73821989528795,99.47643979057592,0.26178010471203095,95.02032520325203,75.2540650406504,19.766260162601625,Client
1051,0,2019-03-15,433,DANET MOUS CHOC LIEG 80gx4,1,0,0,DANETTE,1,Ochsenfurt(ALL),0082,0024 FR VALLET (DC),2010,1968,1870,1481,389,487,98,0,-42,2.08955223880597,426,420,420,420,0,0,0,0,-6,1.408450704225352,100.0,100.0,0.0,95.02032520325203,75.2540650406504,19.766260162601625,Client
1052,0,2019-03-15,433,DANET MOUS CHOC LIEG 80gx4,1,0,0,DANETTE,1,Ochsenfurt(ALL),0077,0024 FR LILPARK (DC),2010,1968,1870,1481,389,487,98,0,-42,2.08955223880597,59,96,46,0,46,96,50,0,37,-62.71186440677966,47.91666666666667,0.0,47.91666666666667,95.02032520325203,75.2540650406504,19.766260162601625,Client
1053,0,2019-03-15,433,DANET MOUS CHOC LIEG 80gx4,1,0,0,DANETTE,1,Ochsenfurt(ALL),0085,0024 FR TOULOUSE (DC),2010,1968,1870,1481,389,487,98,0,-42,2.08955223880597,179,181,181,181,0,0,0,0,2,-1.1173184357541899,100.0,100.0,0.0,95.02032520325203,75.2540650406504,19.766260162601625,Client
1054,0,2019-03-15,433,DANET MOUS CHOC LIEG 80gx4,1,0,0,DANETTE,1,Ochsenfurt(ALL),0083,0024 FR CHAPONNAY (DC),2010,1968,1870,1481,389,487,98,0,-42,2.08955223880597,245,237,237,229,8,8,0,0,-8,3.2653061224489797,100.0,96.62447257383965,3.375527426160346,95.02032520325203,75.2540650406504,19.766260162601625,Client
1055,0,2019-03-15,433,DANET MOUS CHOC LIEG 80gx4,1,0,0,DANETTE,1,Ochsenfurt(ALL),0079,0024 FR PARIS SUD (DC),2010,1968,1870,1481,389,487,98,0,-42,2.08955223880597,72,50,50,50,0,0,0,0,-22,30.555555555555557,100.0,100.0,0.0,95.02032520325203,75.2540650406504,19.766260162601625,Client
1056,0,2019-03-15,433,DANET MOUS CHOC LIEG 80gx4,1,0,0,DANETTE,1,Ochsenfurt(ALL),0078,0024 FR PARIS NORD (DC),2010,1968,1870,1481,389,487,98,0,-42,2.08955223880597,191,148,146,0,146,148,2,0,-43,22.513089005235603,98.64864864864865,0.0,98.64864864864865,95.02032520325203,75.2540650406504,19.766260162601625,Client
1057,0,2019-03-15,83925,ACTIMEL 0% NATU 3x(14x100g) FR,0,0,0,ACTIMEL,1,Rotselaar(BE),0084,0024 FR AIX (DC),1589,1718,1586,1586,0,132,132,0,129,-8.118313404657018,81,80,80,80,0,0,0,0,-1,1.2345679012345678,100.0,100.0,0.0,92.31664726426077,92.31664726426077,0.0,Client
1058,0,2019-03-15,83925,ACTIMEL 0% NATU 3x(14x100g) FR,0,0,0,ACTIMEL,1,Rotselaar(BE),0081,0024 FR TOURS (DC),1589,1718,1586,1586,0,132,132,0,129,-8.118313404657018,35,33,33,33,0,0,0,0,-2,5.714285714285714,100.0,100.0,0.0,92.31664726426077,92.31664726426077,0.0,Client
1059,0,2019-03-15,83925,ACTIMEL 0% NATU 3x(14x100g) FR,0,0,0,ACTIMEL,1,Rotselaar(BE),0082,0024 FR VALLET (DC),1589,1718,1586,1586,0,132,132,0,129,-8.118313404657018,98,80,80,80,0,0,0,0,-18,18.367346938775512,100.0,100.0,0.0,92.31664726426077,92.31664726426077,0.0,Client
1060,0,2019-03-15,83925,ACTIMEL 0% NATU 3x(14x100g) FR,0,0,0,ACTIMEL,1,Rotselaar(BE),0077,0024 FR LILPARK (DC),1589,1718,1586,1586,0,132,132,0,129,-8.118313404657018,129,142,142,142,0,0,0,0,13,-10.077519379844961,100.0,100.0,0.0,92.31664726426077,92.31664726426077,0.0,Client
1061,0,2019-03-15,83925,ACTIMEL 0% NATU 3x(14x100g) FR,0,0,0,ACTIMEL,1,Rotselaar(BE),0085,0024 FR TOULOUSE (DC),1589,1718,1586,1586,0,132,132,0,129,-8.118313404657018,172,171,171,171,0,0,0,0,-1,0.5813953488372093,100.0,100.0,0.0,92.31664726426077,92.31664726426077,0.0,Client
1062,0,2019-03-15,83925,ACTIMEL 0% NATU 3x(14x100g) FR,0,0,0,ACTIMEL,1,Rotselaar(BE),0083,0024 FR CHAPONNAY (DC),1589,1718,1586,1586,0,132,132,0,129,-8.118313404657018,277,362,284,284,0,78,78,0,85,-30.685920577617328,78.45303867403315,78.45303867403315,0.0,92.31664726426077,92.31664726426077,0.0,Client
1063,0,2019-03-15,83925,ACTIMEL 0% NATU 3x(14x100g) FR,0,0,0,ACTIMEL,1,Rotselaar(BE),0079,0024 FR PARIS SUD (DC),1589,1718,1586,1586,0,132,132,0,129,-8.118313404657018,270,312,258,258,0,54,54,0,42,-15.555555555555555,82.6923076923077,82.6923076923077,0.0,92.31664726426077,92.31664726426077,0.0,Client
1064,0,2019-03-15,83925,ACTIMEL 0% NATU 3x(14x100g) FR,0,0,0,ACTIMEL,1,Rotselaar(BE),0078,0024 FR PARIS NORD (DC),1589,1718,1586,1586,0,132,132,0,129,-8.118313404657018,527,538,538,538,0,0,0,0,11,-2.0872865275142316,100.0,100.0,0.0,92.31664726426077,92.31664726426077,0.0,Client
1065,0,2019-03-16,83924,ACTIMEL STRA 3x(14x100g) FR,0,0,0,ACTIMEL,1,Rotselaar(BE),0084,0024 FR AIX (DC),2742,2543,1899,1892,7,651,644,0,-199,7.25747629467542,431,497,497,497,0,0,0,0,66,-15.31322505800464,100.0,100.0,0.0,74.67558002359418,74.40031458906803,0.2752654345261476,Client
1066,0,2019-03-16,83924,ACTIMEL STRA 3x(14x100g) FR,0,0,0,ACTIMEL,1,Rotselaar(BE),0081,0024 FR TOURS (DC),2742,2543,1899,1892,7,651,644,0,-199,7.25747629467542,34,34,34,34,0,0,0,0,0,0.0,100.0,100.0,0.0,74.67558002359418,74.40031458906803,0.2752654345261476,Client
1067,0,2019-03-16,83924,ACTIMEL STRA 3x(14x100g) FR,0,0,0,ACTIMEL,1,Rotselaar(BE),0082,0024 FR VALLET (DC),2742,2543,1899,1892,7,651,644,0,-199,7.25747629467542,300,276,276,276,0,0,0,0,-24,8.0,100.0,100.0,0.0,74.67558002359418,74.40031458906803,0.2752654345261476,Client
1068,0,2019-03-16,83924,ACTIMEL STRA 3x(14x100g) FR,0,0,0,ACTIMEL,1,Rotselaar(BE),0077,0024 FR LILPARK (DC),2742,2543,1899,1892,7,651,644,0,-199,7.25747629467542,245,288,288,288,0,0,0,0,43,-17.551020408163264,100.0,100.0,0.0,74.67558002359418,74.40031458906803,0.2752654345261476,Client
1069,0,2019-03-16,83924,ACTIMEL STRA 3x(14x100g) FR,0,0,0,ACTIMEL,1,Rotselaar(BE),0085,0024 FR TOULOUSE (DC),2742,2543,1899,1892,7,651,644,0,-199,7.25747629467542,196,195,195,195,0,0,0,0,-1,0.5102040816326531,100.0,100.0,0.0,74.67558002359418,74.40031458906803,0.2752654345261476,Client
1070,0,2019-03-16,83924,ACTIMEL STRA 3x(14x100g) FR,0,0,0,ACTIMEL,1,Rotselaar(BE),0083,0024 FR CHAPONNAY (DC),2742,2543,1899,1892,7,651,644,0,-199,7.25747629467542,289,287,277,274,3,13,10,0,-2,0.6920415224913494,96.51567944250871,95.47038327526133,1.0452961672473862,74.67558002359418,74.40031458906803,0.2752654345261476,Client
1071,1,2019-03-16,83924,ACTIMEL STRA 3x(14x100g) FR,0,0,0,ACTIMEL,1,Rotselaar(BE),0083,0024 FR CHAPONNAY (DC),2742,2543,1899,1892,7,651,644,0,-199,7.25747629467542,289,287,277,274,3,13,10,0,-2,0.6920415224913494,96.51567944250871,95.47038327526133,1.0452961672473862,74.67558002359418,74.40031458906803,0.2752654345261476,Client
1072,0,2019-03-16,83924,ACTIMEL STRA 3x(14x100g) FR,0,0,0,ACTIMEL,1,Rotselaar(BE),0079,0024 FR PARIS SUD (DC),2742,2543,1899,1892,7,651,644,0,-199,7.25747629467542,315,318,317,313,4,5,1,0,3,-0.9523809523809523,99.68553459119497,98.42767295597484,1.2578616352201237,74.67558002359418,74.40031458906803,0.2752654345261476,Client
1073,0,2019-03-16,83924,ACTIMEL STRA 3x(14x100g) FR,0,0,0,ACTIMEL,1,Rotselaar(BE),0078,0024 FR PARIS NORD (DC),2742,2543,1899,1892,7,651,644,0,-199,7.25747629467542,643,648,15,15,0,633,633,0,5,-0.7776049766718507,2.314814814814815,2.314814814814815,0.0,74.67558002359418,74.40031458906803,0.2752654345261476,Client
1074,0,2019-03-16,128867,LES 2 VACHES VANILLA 95X4,0,0,0,LES 2 VACHES,0,LeMolay(FR),0084,0024 FR AIX (DC),1843,1647,1204,1204,0,443,443,0,-196,10.634834508952794,173,172,70,70,0,102,102,0,-1,0.5780346820809249,40.69767441860465,40.69767441860465,0.0,73.10261080752885,73.10261080752885,0.0,Previsions
1075,0,2019-03-16,128867,LES 2 VACHES VANILLA 95X4,0,0,0,LES 2 VACHES,0,LeMolay(FR),0080,0024 FR METZ (DC),1843,1647,1204,1204,0,443,443,0,-196,10.634834508952794,107,99,99,99,0,0,0,0,-8,7.4766355140186915,100.0,100.0,0.0,73.10261080752885,73.10261080752885,0.0,Previsions
1076,0,2019-03-16,128867,LES 2 VACHES VANILLA 95X4,0,0,0,LES 2 VACHES,0,LeMolay(FR),0081,0024 FR TOURS (DC),1843,1647,1204,1204,0,443,443,0,-196,10.634834508952794,364,363,158,158,0,205,205,0,-1,0.27472527472527475,43.52617079889807,43.52617079889807,0.0,73.10261080752885,73.10261080752885,0.0,Previsions
1077,1,2019-03-16,128867,LES 2 VACHES VANILLA 95X4,0,0,0,LES 2 VACHES,0,LeMolay(FR),0081,0024 FR TOURS (DC),1843,1647,1204,1204,0,443,443,0,-196,10.634834508952794,364,363,158,158,0,205,205,0,-1,0.27472527472527475,43.52617079889807,43.52617079889807,0.0,73.10261080752885,73.10261080752885,0.0,Previsions
1078,0,2019-03-16,128867,LES 2 VACHES VANILLA 95X4,0,0,0,LES 2 VACHES,0,LeMolay(FR),0082,0024 FR VALLET (DC),1843,1647,1204,1204,0,443,443,0,-196,10.634834508952794,319,318,318,318,0,0,0,0,-1,0.31347962382445144,100.0,100.0,0.0,73.10261080752885,73.10261080752885,0.0,Previsions
1079,0,2019-03-16,128867,LES 2 VACHES VANILLA 95X4,0,0,0,LES 2 VACHES,0,LeMolay(FR),0085,0024 FR TOULOUSE (DC),1843,1647,1204,1204,0,443,443,0,-196,10.634834508952794,120,134,63,63,0,71,71,0,14,-11.666666666666666,47.01492537313433,47.01492537313433,0.0,73.10261080752885,73.10261080752885,0.0,Previsions
1080,0,2019-03-16,128867,LES 2 VACHES VANILLA 95X4,0,0,0,LES 2 VACHES,0,LeMolay(FR),0083,0024 FR CHAPONNAY (DC),1843,1647,1204,1204,0,443,443,0,-196,10.634834508952794,186,224,204,204,0,20,20,0,38,-20.43010752688172,91.07142857142857,91.07142857142857,0.0,73.10261080752885,73.10261080752885,0.0,Previsions
1081,0,2019-03-16,128867,LES 2 VACHES VANILLA 95X4,0,0,0,LES 2 VACHES,0,LeMolay(FR),0079,0024 FR PARIS SUD (DC),1843,1647,1204,1204,0,443,443,0,-196,10.634834508952794,99,210,210,210,0,0,0,0,111,-112.12121212121212,100.0,100.0,0.0,73.10261080752885,73.10261080752885,0.0,Previsions
1082,0,2019-03-16,128867,LES 2 VACHES VANILLA 95X4,0,0,0,LES 2 VACHES,0,LeMolay(FR),0078,0024 FR PARIS NORD (DC),1843,1647,1204,1204,0,443,443,0,-196,10.634834508952794,111,127,82,82,0,45,45,0,16,-14.414414414414415,64.56692913385827,64.56692913385827,0.0,73.10261080752885,73.10261080752885,0.0,Previsions
1083,0,2019-03-16,132458,ACTIVIA SAV CITRON 125X4 OD,0,0,0,ACTIVIA,0,Bailleul(FR),0082,0024 FR VALLET (DC),2,2,2,2,0,0,0,0,0,0.0,2,2,2,2,0,0,0,0,0,0.0,100.0,100.0,0.0,100.0,100.0,0.0,A Creuser
1084,1,2019-03-16,136435,ACTIVIA FRUITS MYRTILLE 125X4 OD,1,0,0,ACTIVIA,0,Villecomtal(FR),0077,0024 FR LILPARK (DC),40,309,309,270,39,39,0,0,269,-672.5,40,39,39,0,39,39,0,0,-1,2.5,100.0,0.0,100.0,100.0,87.37864077669903,12.62135922330097,Expe usine
1085,1,2019-03-16,136436,ACTIVIA FRT CERISE 125X4 OD,1,0,0,ACTIVIA,0,Villecomtal(FR),0077,0024 FR LILPARK (DC),55,385,385,344,41,41,0,0,330,-600.0,55,53,53,12,41,41,0,0,-2,3.6363636363636362,100.0,22.641509433962266,77.35849056603773,100.0,89.35064935064935,10.649350649350652,Déploiement/Quarantaine
1086,0,2019-03-16,140947,ACV 145gx2(x5) BIO PINE-MANGO FR,0,0,0,ACTIVIA,1,Ochsenfurt(ALL),0084,0024 FR AIX (DC),920,895,895,713,182,182,0,0,-25,2.717391304347826,23,13,13,13,0,0,0,0,-10,43.47826086956522,100.0,100.0,0.0,100.0,79.66480446927375,20.335195530726253,Expe usine
1087,0,2019-03-16,140947,ACV 145gx2(x5) BIO PINE-MANGO FR,0,0,0,ACTIVIA,1,Ochsenfurt(ALL),0080,0024 FR METZ (DC),920,895,895,713,182,182,0,0,-25,2.717391304347826,16,20,20,20,0,0,0,0,4,-25.0,100.0,100.0,0.0,100.0,79.66480446927375,20.335195530726253,Expe usine
1088,0,2019-03-16,140947,ACV 145gx2(x5) BIO PINE-MANGO FR,0,0,0,ACTIVIA,1,Ochsenfurt(ALL),0081,0024 FR TOURS (DC),920,895,895,713,182,182,0,0,-25,2.717391304347826,301,299,299,117,182,182,0,0,-2,0.6644518272425249,100.0,39.130434782608695,60.869565217391305,100.0,79.66480446927375,20.335195530726253,Expe usine
1089,0,2019-03-16,140947,ACV 145gx2(x5) BIO PINE-MANGO FR,0,0,0,ACTIVIA,1,Ochsenfurt(ALL),0082,0024 FR VALLET (DC),920,895,895,713,182,182,0,0,-25,2.717391304347826,21,29,29,29,0,0,0,0,8,-38.095238095238095,100.0,100.0,0.0,100.0,79.66480446927375,20.335195530726253,Expe usine
1090,0,2019-03-16,140947,ACV 145gx2(x5) BIO PINE-MANGO FR,0,0,0,ACTIVIA,1,Ochsenfurt(ALL),0077,0024 FR LILPARK (DC),920,895,895,713,182,182,0,0,-25,2.717391304347826,20,20,20,20,0,0,0,0,0,0.0,100.0,100.0,0.0,100.0,79.66480446927375,20.335195530726253,Expe usine
1091,0,2019-03-16,140947,ACV 145gx2(x5) BIO PINE-MANGO FR,0,0,0,ACTIVIA,1,Ochsenfurt(ALL),0085,0024 FR TOULOUSE (DC),920,895,895,713,182,182,0,0,-25,2.717391304347826,189,177,177,177,0,0,0,0,-12,6.349206349206349,100.0,100.0,0.0,100.0,79.66480446927375,20.335195530726253,Expe usine
1092,0,2019-03-16,140947,ACV 145gx2(x5) BIO PINE-MANGO FR,0,0,0,ACTIVIA,1,Ochsenfurt(ALL),0083,0024 FR CHAPONNAY (DC),920,895,895,713,182,182,0,0,-25,2.717391304347826,204,200,200,200,0,0,0,0,-4,1.9607843137254901,100.0,100.0,0.0,100.0,79.66480446927375,20.335195530726253,Expe usine
1093,0,2019-03-16,140947,ACV 145gx2(x5) BIO PINE-MANGO FR,0,0,0,ACTIVIA,1,Ochsenfurt(ALL),0079,0024 FR PARIS SUD (DC),920,895,895,713,182,182,0,0,-25,2.717391304347826,66,51,51,51,0,0,0,0,-15,22.727272727272727,100.0,100.0,0.0,100.0,79.66480446927375,20.335195530726253,Expe usine
1094,0,2019-03-16,140947,ACV 145gx2(x5) BIO PINE-MANGO FR,0,0,0,ACTIVIA,1,Ochsenfurt(ALL),0078,0024 FR PARIS NORD (DC),920,895,895,713,182,182,0,0,-25,2.717391304347826,80,86,86,86,0,0,0,0,6,-7.5,100.0,100.0,0.0,100.0,79.66480446927375,20.335195530726253,Expe usine
1095,0,2019-03-18,79537,LES 2 VACHES FLAN BIO 100X4,0,0,0,LES 2 VACHES,0,LeMolay(FR),0084,0024 FR AIX (DC),1021,1300,981,977,4,323,319,0,279,-27.32615083251714,137,64,64,64,0,0,0,0,-73,53.284671532846716,100.0,100.0,0.0,75.46153846153845,75.15384615384615,0.3076923076923066,Previsions
1096,0,2019-03-18,79537,LES 2 VACHES FLAN BIO 100X4,0,0,0,LES 2 VACHES,0,LeMolay(FR),0080,0024 FR METZ (DC),1021,1300,981,977,4,323,319,0,279,-27.32615083251714,108,132,132,132,0,0,0,0,24,-22.22222222222222,100.0,100.0,0.0,75.46153846153845,75.15384615384615,0.3076923076923066,Previsions
1097,0,2019-03-18,79537,LES 2 VACHES FLAN BIO 100X4,0,0,0,LES 2 VACHES,0,LeMolay(FR),0081,0024 FR TOURS (DC),1021,1300,981,977,4,323,319,0,279,-27.32615083251714,123,105,105,105,0,0,0,0,-18,14.634146341463415,100.0,100.0,0.0,75.46153846153845,75.15384615384615,0.3076923076923066,Previsions
1098,0,2019-03-18,79537,LES 2 VACHES FLAN BIO 100X4,0,0,0,LES 2 VACHES,0,LeMolay(FR),0082,0024 FR VALLET (DC),1021,1300,981,977,4,323,319,0,279,-27.32615083251714,88,106,106,106,0,0,0,0,18,-20.454545454545453,100.0,100.0,0.0,75.46153846153845,75.15384615384615,0.3076923076923066,Previsions
1099,0,2019-03-18,79537,LES 2 VACHES FLAN BIO 100X4,0,0,0,LES 2 VACHES,0,LeMolay(FR),0077,0024 FR LILPARK (DC),1021,1300,981,977,4,323,319,0,279,-27.32615083251714,66,49,49,49,0,0,0,0,-17,25.757575757575758,100.0,100.0,0.0,75.46153846153845,75.15384615384615,0.3076923076923066,Previsions
1100,0,2019-03-18,79537,LES 2 VACHES FLAN BIO 100X4,0,0,0,LES 2 VACHES,0,LeMolay(FR),0085,0024 FR TOULOUSE (DC),1021,1300,981,977,4,323,319,0,279,-27.32615083251714,127,157,157,157,0,0,0,0,30,-23.62204724409449,100.0,100.0,0.0,75.46153846153845,75.15384615384615,0.3076923076923066,Previsions
1101,0,2019-03-18,79537,LES 2 VACHES FLAN BIO 100X4,0,0,0,LES 2 VACHES,0,LeMolay(FR),0083,0024 FR CHAPONNAY (DC),1021,1300,981,977,4,323,319,0,279,-27.32615083251714,183,203,203,203,0,0,0,0,20,-10.92896174863388,100.0,100.0,0.0,75.46153846153845,75.15384615384615,0.3076923076923066,Previsions
1102,0,2019-03-18,79537,LES 2 VACHES FLAN BIO 100X4,0,0,0,LES 2 VACHES,0,LeMolay(FR),0079,0024 FR PARIS SUD (DC),1021,1300,981,977,4,323,319,0,279,-27.32615083251714,117,111,110,110,0,1,1,0,-6,5.128205128205129,99.09909909909909,99.09909909909909,0.0,75.46153846153845,75.15384615384615,0.3076923076923066,Previsions
1103,0,2019-03-18,79537,LES 2 VACHES FLAN BIO 100X4,0,0,0,LES 2 VACHES,0,LeMolay(FR),0078,0024 FR PARIS NORD (DC),1021,1300,981,977,4,323,319,0,279,-27.32615083251714,72,373,55,51,4,322,318,0,301,-418.05555555555554,14.745308310991955,13.672922252010725,1.0723860589812304,75.46153846153845,75.15384615384615,0.3076923076923066,Previsions
1104,0,2019-03-18,83923,ACTIMEL NATU 3x(14x100g) FR,0,0,0,ACTIMEL,1,Rotselaar(BE),0084,0024 FR AIX (DC),601,828,644,636,8,192,184,0,227,-37.770382695507486,213,213,210,203,7,10,3,0,0,0.0,98.59154929577466,95.30516431924883,3.2863849765258237,77.77777777777779,76.81159420289855,0.9661835748792384,Client
1105,1,2019-03-18,83923,ACTIMEL NATU 3x(14x100g) FR,0,0,0,ACTIMEL,1,Rotselaar(BE),0084,0024 FR AIX (DC),601,828,644,636,8,192,184,0,227,-37.770382695507486,213,213,210,203,7,10,3,0,0,0.0,98.59154929577466,95.30516431924883,3.2863849765258237,77.77777777777779,76.81159420289855,0.9661835748792384,Client
1106,0,2019-03-18,83923,ACTIMEL NATU 3x(14x100g) FR,0,0,0,ACTIMEL,1,Rotselaar(BE),0082,0024 FR VALLET (DC),601,828,644,636,8,192,184,0,227,-37.770382695507486,78,67,67,67,0,0,0,0,-11,14.102564102564102,100.0,100.0,0.0,77.77777777777779,76.81159420289855,0.9661835748792384,Client
1107,0,2019-03-18,83923,ACTIMEL NATU 3x(14x100g) FR,0,0,0,ACTIMEL,1,Rotselaar(BE),0077,0024 FR LILPARK (DC),601,828,644,636,8,192,184,0,227,-37.770382695507486,78,145,145,145,0,0,0,0,67,-85.8974358974359,100.0,100.0,0.0,77.77777777777779,76.81159420289855,0.9661835748792384,Client
1108,0,2019-03-18,83923,ACTIMEL NATU 3x(14x100g) FR,0,0,0,ACTIMEL,1,Rotselaar(BE),0085,0024 FR TOULOUSE (DC),601,828,644,636,8,192,184,0,227,-37.770382695507486,19,27,27,27,0,0,0,0,8,-42.10526315789474,100.0,100.0,0.0,77.77777777777779,76.81159420289855,0.9661835748792384,Client
1109,0,2019-03-18,83923,ACTIMEL NATU 3x(14x100g) FR,0,0,0,ACTIMEL,1,Rotselaar(BE),0083,0024 FR CHAPONNAY (DC),601,828,644,636,8,192,184,0,227,-37.770382695507486,0,163,42,42,0,121,121,1,163,10000.0,25.766871165644172,25.766871165644172,0.0,77.77777777777779,76.81159420289855,0.9661835748792384,Client
1110,0,2019-03-18,83923,ACTIMEL NATU 3x(14x100g) FR,0,0,0,ACTIMEL,1,Rotselaar(BE),0079,0024 FR PARIS SUD (DC),601,828,644,636,8,192,184,0,227,-37.770382695507486,0,112,56,55,1,57,56,1,112,10000.0,50.0,49.107142857142854,0.8928571428571459,77.77777777777779,76.81159420289855,0.9661835748792384,Client
1111,0,2019-03-18,83923,ACTIMEL NATU 3x(14x100g) FR,0,0,0,ACTIMEL,1,Rotselaar(BE),0078,0024 FR PARIS NORD (DC),601,828,644,636,8,192,184,0,227,-37.770382695507486,0,101,97,97,0,4,4,1,101,10000.0,96.03960396039604,96.03960396039604,0.0,77.77777777777779,76.81159420289855,0.9661835748792384,Client
1112,0,2019-03-18,83924,ACTIMEL STRA 3x(14x100g) FR,0,0,0,ACTIMEL,1,Rotselaar(BE),0084,0024 FR AIX (DC),860,1296,884,644,240,652,412,0,436,-50.69767441860465,281,282,282,183,99,99,0,0,1,-0.35587188612099646,100.0,64.8936170212766,35.1063829787234,68.20987654320987,49.691358024691354,18.51851851851852,Client
1113,1,2019-03-18,83924,ACTIMEL STRA 3x(14x100g) FR,0,0,0,ACTIMEL,1,Rotselaar(BE),0084,0024 FR AIX (DC),860,1296,884,644,240,652,412,0,436,-50.69767441860465,281,282,282,183,99,99,0,0,1,-0.35587188612099646,100.0,64.8936170212766,35.1063829787234,68.20987654320987,49.691358024691354,18.51851851851852,Client
1114,0,2019-03-18,83924,ACTIMEL STRA 3x(14x100g) FR,0,0,0,ACTIMEL,1,Rotselaar(BE),0081,0024 FR TOURS (DC),860,1296,884,644,240,652,412,0,436,-50.69767441860465,17,10,10,10,0,0,0,0,-7,41.1764705882353,100.0,100.0,0.0,68.20987654320987,49.691358024691354,18.51851851851852,Client
1115,0,2019-03-18,83924,ACTIMEL STRA 3x(14x100g) FR,0,0,0,ACTIMEL,1,Rotselaar(BE),0082,0024 FR VALLET (DC),860,1296,884,644,240,652,412,0,436,-50.69767441860465,129,112,112,112,0,0,0,0,-17,13.178294573643411,100.0,100.0,0.0,68.20987654320987,49.691358024691354,18.51851851851852,Client
1116,0,2019-03-18,83924,ACTIMEL STRA 3x(14x100g) FR,0,0,0,ACTIMEL,1,Rotselaar(BE),0077,0024 FR LILPARK (DC),860,1296,884,644,240,652,412,0,436,-50.69767441860465,122,213,190,183,7,30,23,0,91,-74.59016393442623,89.2018779342723,85.91549295774648,3.2863849765258237,68.20987654320987,49.691358024691354,18.51851851851852,Client
1117,0,2019-03-18,83924,ACTIMEL STRA 3x(14x100g) FR,0,0,0,ACTIMEL,1,Rotselaar(BE),0085,0024 FR TOULOUSE (DC),860,1296,884,644,240,652,412,0,436,-50.69767441860465,30,46,46,46,0,0,0,0,16,-53.333333333333336,100.0,100.0,0.0,68.20987654320987,49.691358024691354,18.51851851851852,Client
1118,0,2019-03-18,83924,ACTIMEL STRA 3x(14x100g) FR,0,0,0,ACTIMEL,1,Rotselaar(BE),0083,0024 FR CHAPONNAY (DC),860,1296,884,644,240,652,412,0,436,-50.69767441860465,0,325,134,0,134,325,191,1,325,10000.0,41.23076923076923,0.0,41.23076923076923,68.20987654320987,49.691358024691354,18.51851851851852,Client
1119,1,2019-03-18,83924,ACTIMEL STRA 3x(14x100g) FR,0,0,0,ACTIMEL,1,Rotselaar(BE),0083,0024 FR CHAPONNAY (DC),860,1296,884,644,240,652,412,0,436,-50.69767441860465,0,325,134,0,134,325,191,1,325,10000.0,41.23076923076923,0.0,41.23076923076923,68.20987654320987,49.691358024691354,18.51851851851852,Client
1120,0,2019-03-18,83924,ACTIMEL STRA 3x(14x100g) FR,0,0,0,ACTIMEL,1,Rotselaar(BE),0079,0024 FR PARIS SUD (DC),860,1296,884,644,240,652,412,0,436,-50.69767441860465,0,193,5,5,0,188,188,1,193,10000.0,2.5906735751295336,2.5906735751295336,0.0,68.20987654320987,49.691358024691354,18.51851851851852,Client
1121,0,2019-03-18,83924,ACTIMEL STRA 3x(14x100g) FR,0,0,0,ACTIMEL,1,Rotselaar(BE),0078,0024 FR PARIS NORD (DC),860,1296,884,644,240,652,412,0,436,-50.69767441860465,0,115,105,105,0,10,10,1,115,10000.0,91.30434782608695,91.30434782608695,0.0,68.20987654320987,49.691358024691354,18.51851851851852,Client
1122,1,2019-03-18,83924,ACTIMEL STRA 3x(14x100g) FR,0,0,0,ACTIMEL,1,Rotselaar(BE),0078,0024 FR PARIS NORD (DC),860,1296,884,644,240,652,412,0,436,-50.69767441860465,0,115,105,105,0,10,10,1,115,10000.0,91.30434782608695,91.30434782608695,0.0,68.20987654320987,49.691358024691354,18.51851851851852,Client
1123,0,2019-03-18,101117,LES 2 VACHES PAIL FRA PE 100X6,0,0,0,LES 2 VACHES,0,LeMolay(FR),0084,0024 FR AIX (DC),724,695,592,522,70,173,103,0,-29,4.005524861878453,47,42,42,42,0,0,0,0,-5,10.638297872340425,100.0,100.0,0.0,85.17985611510791,75.10791366906476,10.071942446043153,Production
1124,0,2019-03-18,101117,LES 2 VACHES PAIL FRA PE 100X6,0,0,0,LES 2 VACHES,0,LeMolay(FR),0080,0024 FR METZ (DC),724,695,592,522,70,173,103,0,-29,4.005524861878453,79,100,68,68,0,32,32,0,21,-26.582278481012658,68.0,68.0,0.0,85.17985611510791,75.10791366906476,10.071942446043153,Production
1125,0,2019-03-18,101117,LES 2 VACHES PAIL FRA PE 100X6,0,0,0,LES 2 VACHES,0,LeMolay(FR),0081,0024 FR TOURS (DC),724,695,592,522,70,173,103,0,-29,4.005524861878453,53,58,44,44,0,14,14,0,5,-9.433962264150944,75.86206896551724,75.86206896551724,0.0,85.17985611510791,75.10791366906476,10.071942446043153,Production
1126,0,2019-03-18,101117,LES 2 VACHES PAIL FRA PE 100X6,0,0,0,LES 2 VACHES,0,LeMolay(FR),0082,0024 FR VALLET (DC),724,695,592,522,70,173,103,0,-29,4.005524861878453,74,67,67,67,0,0,0,0,-7,9.45945945945946,100.0,100.0,0.0,85.17985611510791,75.10791366906476,10.071942446043153,Production
1127,0,2019-03-18,101117,LES 2 VACHES PAIL FRA PE 100X6,0,0,0,LES 2 VACHES,0,LeMolay(FR),0077,0024 FR LILPARK (DC),724,695,592,522,70,173,103,0,-29,4.005524861878453,37,53,53,34,19,19,0,0,16,-43.24324324324324,100.0,64.15094339622641,35.84905660377359,85.17985611510791,75.10791366906476,10.071942446043153,Production
1128,0,2019-03-18,101117,LES 2 VACHES PAIL FRA PE 100X6,0,0,0,LES 2 VACHES,0,LeMolay(FR),0085,0024 FR TOULOUSE (DC),724,695,592,522,70,173,103,0,-29,4.005524861878453,100,121,121,96,25,25,0,0,21,-21.0,100.0,79.33884297520662,20.661157024793383,85.17985611510791,75.10791366906476,10.071942446043153,Production
1129,0,2019-03-18,101117,LES 2 VACHES PAIL FRA PE 100X6,0,0,0,LES 2 VACHES,0,LeMolay(FR),0083,0024 FR CHAPONNAY (DC),724,695,592,522,70,173,103,0,-29,4.005524861878453,145,87,87,87,0,0,0,0,-58,40.0,100.0,100.0,0.0,85.17985611510791,75.10791366906476,10.071942446043153,Production
1130,0,2019-03-18,101117,LES 2 VACHES PAIL FRA PE 100X6,0,0,0,LES 2 VACHES,0,LeMolay(FR),0079,0024 FR PARIS SUD (DC),724,695,592,522,70,173,103,0,-29,4.005524861878453,103,103,83,57,26,46,20,0,0,0.0,80.58252427184466,55.33980582524271,25.24271844660195,85.17985611510791,75.10791366906476,10.071942446043153,Production
1131,0,2019-03-18,101117,LES 2 VACHES PAIL FRA PE 100X6,0,0,0,LES 2 VACHES,0,LeMolay(FR),0078,0024 FR PARIS NORD (DC),724,695,592,522,70,173,103,0,-29,4.005524861878453,86,64,27,27,0,37,37,0,-22,25.58139534883721,42.1875,42.1875,0.0,85.17985611510791,75.10791366906476,10.071942446043153,Production
1132,0,2019-03-18,132258,DANONE YOG FRUIT 125GX8 AFH,0,0,1,DANONE,0,Villecomtal(FR),0084,0024 FR AIX (DC),2174,2046,1907,1906,1,140,139,0,-128,5.887764489420423,178,54,54,54,0,0,0,0,-124,69.66292134831461,100.0,100.0,0.0,93.20625610948191,93.15738025415445,0.04887585532746641,Previsions
1133,0,2019-03-18,132258,DANONE YOG FRUIT 125GX8 AFH,0,0,1,DANONE,0,Villecomtal(FR),0080,0024 FR METZ (DC),2174,2046,1907,1906,1,140,139,0,-128,5.887764489420423,158,177,177,177,0,0,0,0,19,-12.025316455696203,100.0,100.0,0.0,93.20625610948191,93.15738025415445,0.04887585532746641,Previsions
1134,0,2019-03-18,132258,DANONE YOG FRUIT 125GX8 AFH,0,0,1,DANONE,0,Villecomtal(FR),0081,0024 FR TOURS (DC),2174,2046,1907,1906,1,140,139,0,-128,5.887764489420423,162,265,216,215,1,50,49,0,103,-63.58024691358025,81.50943396226415,81.13207547169812,0.37735849056603854,93.20625610948191,93.15738025415445,0.04887585532746641,Previsions
1135,0,2019-03-18,132258,DANONE YOG FRUIT 125GX8 AFH,0,0,1,DANONE,0,Villecomtal(FR),0082,0024 FR VALLET (DC),2174,2046,1907,1906,1,140,139,0,-128,5.887764489420423,154,61,61,61,0,0,0,0,-93,60.38961038961039,100.0,100.0,0.0,93.20625610948191,93.15738025415445,0.04887585532746641,Previsions
1136,0,2019-03-18,132258,DANONE YOG FRUIT 125GX8 AFH,0,0,1,DANONE,0,Villecomtal(FR),0077,0024 FR LILPARK (DC),2174,2046,1907,1906,1,140,139,0,-128,5.887764489420423,184,216,216,216,0,0,0,0,32,-17.391304347826086,100.0,100.0,0.0,93.20625610948191,93.15738025415445,0.04887585532746641,Previsions
1137,0,2019-03-18,132258,DANONE YOG FRUIT 125GX8 AFH,0,0,1,DANONE,0,Villecomtal(FR),0085,0024 FR TOULOUSE (DC),2174,2046,1907,1906,1,140,139,0,-128,5.887764489420423,156,279,279,279,0,0,0,0,123,-78.84615384615384,100.0,100.0,0.0,93.20625610948191,93.15738025415445,0.04887585532746641,Previsions
1138,0,2019-03-18,132258,DANONE YOG FRUIT 125GX8 AFH,0,0,1,DANONE,0,Villecomtal(FR),0083,0024 FR CHAPONNAY (DC),2174,2046,1907,1906,1,140,139,0,-128,5.887764489420423,434,169,169,169,0,0,0,0,-265,61.05990783410138,100.0,100.0,0.0,93.20625610948191,93.15738025415445,0.04887585532746641,Previsions
1139,0,2019-03-18,132258,DANONE YOG FRUIT 125GX8 AFH,0,0,1,DANONE,0,Villecomtal(FR),0079,0024 FR PARIS SUD (DC),2174,2046,1907,1906,1,140,139,0,-128,5.887764489420423,413,486,486,486,0,0,0,0,73,-17.675544794188863,100.0,100.0,0.0,93.20625610948191,93.15738025415445,0.04887585532746641,Previsions
1140,0,2019-03-18,132258,DANONE YOG FRUIT 125GX8 AFH,0,0,1,DANONE,0,Villecomtal(FR),0078,0024 FR PARIS NORD (DC),2174,2046,1907,1906,1,140,139,0,-128,5.887764489420423,335,339,249,249,0,90,90,0,4,-1.1940298507462686,73.45132743362832,73.45132743362832,0.0,93.20625610948191,93.15738025415445,0.04887585532746641,Previsions
1141,0,2019-03-18,138218,ACTIVIA FRTS MIX PAN 125X16 OD,0,0,0,ACTIVIA,0,Villecomtal(FR),0081,0024 FR TOURS (DC),35,69,41,38,3,31,28,0,34,-97.14285714285714,7,11,10,7,3,4,1,0,4,-57.142857142857146,90.9090909090909,63.63636363636363,27.272727272727273,59.42028985507246,55.072463768115945,4.347826086956516,A Creuser
1142,0,2019-03-18,138218,ACTIVIA FRTS MIX PAN 125X16 OD,0,0,0,ACTIVIA,0,Villecomtal(FR),0083,0024 FR CHAPONNAY (DC),35,69,41,38,3,31,28,0,34,-97.14285714285714,8,23,15,15,0,8,8,0,15,-187.5,65.21739130434783,65.21739130434783,0.0,59.42028985507246,55.072463768115945,4.347826086956516,A Creuser
1143,0,2019-03-18,138218,ACTIVIA FRTS MIX PAN 125X16 OD,0,0,0,ACTIVIA,0,Villecomtal(FR),0079,0024 FR PARIS SUD (DC),35,69,41,38,3,31,28,0,34,-97.14285714285714,20,35,16,16,0,19,19,0,15,-75.0,45.714285714285715,45.714285714285715,0.0,59.42028985507246,55.072463768115945,4.347826086956516,A Creuser
1144,0,2019-03-18,143291,DANET CHOCO 125X4 AFH,1,1,1,DANETTE,0,Bailleul(FR),0084,0024 FR AIX (DC),572,808,540,540,0,268,268,0,236,-41.25874125874126,99,80,80,80,0,0,0,0,-19,19.19191919191919,100.0,100.0,0.0,66.83168316831683,66.83168316831683,0.0,Previsions
1145,0,2019-03-18,143291,DANET CHOCO 125X4 AFH,1,1,1,DANETTE,0,Bailleul(FR),0080,0024 FR METZ (DC),572,808,540,540,0,268,268,0,236,-41.25874125874126,26,9,9,9,0,0,0,0,-17,65.38461538461539,100.0,100.0,0.0,66.83168316831683,66.83168316831683,0.0,Previsions
1146,0,2019-03-18,143291,DANET CHOCO 125X4 AFH,1,1,1,DANETTE,0,Bailleul(FR),0081,0024 FR TOURS (DC),572,808,540,540,0,268,268,0,236,-41.25874125874126,63,29,29,29,0,0,0,0,-34,53.96825396825397,100.0,100.0,0.0,66.83168316831683,66.83168316831683,0.0,Previsions
1147,0,2019-03-18,143291,DANET CHOCO 125X4 AFH,1,1,1,DANETTE,0,Bailleul(FR),0082,0024 FR VALLET (DC),572,808,540,540,0,268,268,0,236,-41.25874125874126,25,18,18,18,0,0,0,0,-7,28.0,100.0,100.0,0.0,66.83168316831683,66.83168316831683,0.0,Previsions
1148,0,2019-03-18,143291,DANET CHOCO 125X4 AFH,1,1,1,DANETTE,0,Bailleul(FR),0077,0024 FR LILPARK (DC),572,808,540,540,0,268,268,0,236,-41.25874125874126,88,73,73,73,0,0,0,0,-15,17.045454545454547,100.0,100.0,0.0,66.83168316831683,66.83168316831683,0.0,Previsions
1149,0,2019-03-18,143291,DANET CHOCO 125X4 AFH,1,1,1,DANETTE,0,Bailleul(FR),0085,0024 FR TOULOUSE (DC),572,808,540,540,0,268,268,0,236,-41.25874125874126,40,49,49,49,0,0,0,0,9,-22.5,100.0,100.0,0.0,66.83168316831683,66.83168316831683,0.0,Previsions
1150,0,2019-03-18,143291,DANET CHOCO 125X4 AFH,1,1,1,DANETTE,0,Bailleul(FR),0083,0024 FR CHAPONNAY (DC),572,808,540,540,0,268,268,0,236,-41.25874125874126,68,131,131,131,0,0,0,0,63,-92.6470588235294,100.0,100.0,0.0,66.83168316831683,66.83168316831683,0.0,Previsions
1151,0,2019-03-18,143291,DANET CHOCO 125X4 AFH,1,1,1,DANETTE,0,Bailleul(FR),0079,0024 FR PARIS SUD (DC),572,808,540,540,0,268,268,0,236,-41.25874125874126,133,89,89,89,0,0,0,0,-44,33.08270676691729,100.0,100.0,0.0,66.83168316831683,66.83168316831683,0.0,Previsions
1152,0,2019-03-18,143291,DANET CHOCO 125X4 AFH,1,1,1,DANETTE,0,Bailleul(FR),0078,0024 FR PARIS NORD (DC),572,808,540,540,0,268,268,0,236,-41.25874125874126,30,330,62,62,0,268,268,0,300,-1000.0,18.787878787878785,18.787878787878785,0.0,66.83168316831683,66.83168316831683,0.0,Previsions
1153,0,2019-03-19,433,DANET MOUS CHOC LIEG 80gx4,1,0,0,DANETTE,1,Ochsenfurt(ALL),0084,0024 FR AIX (DC),1669,1275,1094,1070,24,205,181,0,-394,23.60695026962253,93,117,117,117,0,0,0,0,24,-25.806451612903224,100.0,100.0,0.0,85.80392156862744,83.92156862745098,1.882352941176464,Client
1154,0,2019-03-19,433,DANET MOUS CHOC LIEG 80gx4,1,0,0,DANETTE,1,Ochsenfurt(ALL),0080,0024 FR METZ (DC),1669,1275,1094,1070,24,205,181,0,-394,23.60695026962253,83,91,91,67,24,24,0,0,8,-9.63855421686747,100.0,73.62637362637363,26.373626373626365,85.80392156862744,83.92156862745098,1.882352941176464,Client
1155,0,2019-03-19,433,DANET MOUS CHOC LIEG 80gx4,1,0,0,DANETTE,1,Ochsenfurt(ALL),0081,0024 FR TOURS (DC),1669,1275,1094,1070,24,205,181,0,-394,23.60695026962253,325,321,234,234,0,87,87,0,-4,1.2307692307692308,72.89719626168224,72.89719626168224,0.0,85.80392156862744,83.92156862745098,1.882352941176464,Client
1156,1,2019-03-19,433,DANET MOUS CHOC LIEG 80gx4,1,0,0,DANETTE,1,Ochsenfurt(ALL),0081,0024 FR TOURS (DC),1669,1275,1094,1070,24,205,181,0,-394,23.60695026962253,325,321,234,234,0,87,87,0,-4,1.2307692307692308,72.89719626168224,72.89719626168224,0.0,85.80392156862744,83.92156862745098,1.882352941176464,Client
1157,0,2019-03-19,433,DANET MOUS CHOC LIEG 80gx4,1,0,0,DANETTE,1,Ochsenfurt(ALL),0082,0024 FR VALLET (DC),1669,1275,1094,1070,24,205,181,0,-394,23.60695026962253,231,233,139,139,0,94,94,0,2,-0.8658008658008658,59.65665236051502,59.65665236051502,0.0,85.80392156862744,83.92156862745098,1.882352941176464,Client
1158,1,2019-03-19,433,DANET MOUS CHOC LIEG 80gx4,1,0,0,DANETTE,1,Ochsenfurt(ALL),0082,0024 FR VALLET (DC),1669,1275,1094,1070,24,205,181,0,-394,23.60695026962253,231,233,139,139,0,94,94,0,2,-0.8658008658008658,59.65665236051502,59.65665236051502,0.0,85.80392156862744,83.92156862745098,1.882352941176464,Client
1159,0,2019-03-19,433,DANET MOUS CHOC LIEG 80gx4,1,0,0,DANETTE,1,Ochsenfurt(ALL),0077,0024 FR LILPARK (DC),1669,1275,1094,1070,24,205,181,0,-394,23.60695026962253,114,192,192,192,0,0,0,0,78,-68.42105263157895,100.0,100.0,0.0,85.80392156862744,83.92156862745098,1.882352941176464,Client
1160,0,2019-03-19,433,DANET MOUS CHOC LIEG 80gx4,1,0,0,DANETTE,1,Ochsenfurt(ALL),0085,0024 FR TOULOUSE (DC),1669,1275,1094,1070,24,205,181,0,-394,23.60695026962253,65,77,77,77,0,0,0,0,12,-18.46153846153846,100.0,100.0,0.0,85.80392156862744,83.92156862745098,1.882352941176464,Client
1161,0,2019-03-19,433,DANET MOUS CHOC LIEG 80gx4,1,0,0,DANETTE,1,Ochsenfurt(ALL),0083,0024 FR CHAPONNAY (DC),1669,1275,1094,1070,24,205,181,0,-394,23.60695026962253,78,83,83,83,0,0,0,0,5,-6.410256410256411,100.0,100.0,0.0,85.80392156862744,83.92156862745098,1.882352941176464,Client
1162,0,2019-03-19,433,DANET MOUS CHOC LIEG 80gx4,1,0,0,DANETTE,1,Ochsenfurt(ALL),0079,0024 FR PARIS SUD (DC),1669,1275,1094,1070,24,205,181,0,-394,23.60695026962253,59,65,65,65,0,0,0,0,6,-10.169491525423728,100.0,100.0,0.0,85.80392156862744,83.92156862745098,1.882352941176464,Client
1163,0,2019-03-19,433,DANET MOUS CHOC LIEG 80gx4,1,0,0,DANETTE,1,Ochsenfurt(ALL),0078,0024 FR PARIS NORD (DC),1669,1275,1094,1070,24,205,181,0,-394,23.60695026962253,65,96,96,96,0,0,0,0,31,-47.69230769230769,100.0,100.0,0.0,85.80392156862744,83.92156862745098,1.882352941176464,Client
1164,0,2019-03-19,79537,LES 2 VACHES FLAN BIO 100X4,0,0,0,LES 2 VACHES,0,LeMolay(FR),0084,0024 FR AIX (DC),830,1264,1157,914,243,350,107,0,434,-52.28915662650602,141,186,186,186,0,0,0,0,45,-31.914893617021278,100.0,100.0,0.0,91.53481012658227,72.31012658227847,19.2246835443038,Previsions
1165,0,2019-03-19,79537,LES 2 VACHES FLAN BIO 100X4,0,0,0,LES 2 VACHES,0,LeMolay(FR),0080,0024 FR METZ (DC),830,1264,1157,914,243,350,107,0,434,-52.28915662650602,40,63,63,63,0,0,0,0,23,-57.5,100.0,100.0,0.0,91.53481012658227,72.31012658227847,19.2246835443038,Previsions
1166,0,2019-03-19,79537,LES 2 VACHES FLAN BIO 100X4,0,0,0,LES 2 VACHES,0,LeMolay(FR),0081,0024 FR TOURS (DC),830,1264,1157,914,243,350,107,0,434,-52.28915662650602,99,102,102,102,0,0,0,0,3,-3.0303030303030303,100.0,100.0,0.0,91.53481012658227,72.31012658227847,19.2246835443038,Previsions
1167,0,2019-03-19,79537,LES 2 VACHES FLAN BIO 100X4,0,0,0,LES 2 VACHES,0,LeMolay(FR),0082,0024 FR VALLET (DC),830,1264,1157,914,243,350,107,0,434,-52.28915662650602,105,66,66,66,0,0,0,0,-39,37.142857142857146,100.0,100.0,0.0,91.53481012658227,72.31012658227847,19.2246835443038,Previsions
1168,0,2019-03-19,79537,LES 2 VACHES FLAN BIO 100X4,0,0,0,LES 2 VACHES,0,LeMolay(FR),0077,0024 FR LILPARK (DC),830,1264,1157,914,243,350,107,0,434,-52.28915662650602,58,26,26,26,0,0,0,0,-32,55.172413793103445,100.0,100.0,0.0,91.53481012658227,72.31012658227847,19.2246835443038,Previsions
1169,0,2019-03-19,79537,LES 2 VACHES FLAN BIO 100X4,0,0,0,LES 2 VACHES,0,LeMolay(FR),0085,0024 FR TOULOUSE (DC),830,1264,1157,914,243,350,107,0,434,-52.28915662650602,112,161,161,161,0,0,0,0,49,-43.75,100.0,100.0,0.0,91.53481012658227,72.31012658227847,19.2246835443038,Previsions
1170,0,2019-03-19,79537,LES 2 VACHES FLAN BIO 100X4,0,0,0,LES 2 VACHES,0,LeMolay(FR),0083,0024 FR CHAPONNAY (DC),830,1264,1157,914,243,350,107,0,434,-52.28915662650602,81,156,156,156,0,0,0,0,75,-92.5925925925926,100.0,100.0,0.0,91.53481012658227,72.31012658227847,19.2246835443038,Previsions
1171,0,2019-03-19,79537,LES 2 VACHES FLAN BIO 100X4,0,0,0,LES 2 VACHES,0,LeMolay(FR),0079,0024 FR PARIS SUD (DC),830,1264,1157,914,243,350,107,0,434,-52.28915662650602,87,171,154,154,0,17,17,0,84,-96.55172413793103,90.05847953216374,90.05847953216374,0.0,91.53481012658227,72.31012658227847,19.2246835443038,Previsions
1172,0,2019-03-19,79537,LES 2 VACHES FLAN BIO 100X4,0,0,0,LES 2 VACHES,0,LeMolay(FR),0078,0024 FR PARIS NORD (DC),830,1264,1157,914,243,350,107,0,434,-52.28915662650602,107,333,243,0,243,333,90,0,226,-211.21495327102804,72.97297297297297,0.0,72.97297297297297,91.53481012658227,72.31012658227847,19.2246835443038,Previsions
1173,0,2019-03-19,83923,ACTIMEL NATU 3x(14x100g) FR,0,0,0,ACTIMEL,1,Rotselaar(BE),0084,0024 FR AIX (DC),225,430,246,245,1,185,184,0,205,-91.11111111111111,28,58,5,5,0,53,53,0,30,-107.14285714285714,8.620689655172415,8.620689655172415,0.0,57.20930232558139,56.97674418604651,0.23255813953488058,Client
1174,0,2019-03-19,83923,ACTIMEL NATU 3x(14x100g) FR,0,0,0,ACTIMEL,1,Rotselaar(BE),0081,0024 FR TOURS (DC),225,430,246,245,1,185,184,0,205,-91.11111111111111,0,17,17,17,0,0,0,1,17,10000.0,100.0,100.0,0.0,57.20930232558139,56.97674418604651,0.23255813953488058,Client
1175,0,2019-03-19,83923,ACTIMEL NATU 3x(14x100g) FR,0,0,0,ACTIMEL,1,Rotselaar(BE),0082,0024 FR VALLET (DC),225,430,246,245,1,185,184,0,205,-91.11111111111111,16,86,34,34,0,52,52,0,70,-437.5,39.53488372093023,39.53488372093023,0.0,57.20930232558139,56.97674418604651,0.23255813953488058,Client
1176,0,2019-03-19,83923,ACTIMEL NATU 3x(14x100g) FR,0,0,0,ACTIMEL,1,Rotselaar(BE),0077,0024 FR LILPARK (DC),225,430,246,245,1,185,184,0,205,-91.11111111111111,0,44,44,44,0,0,0,1,44,10000.0,100.0,100.0,0.0,57.20930232558139,56.97674418604651,0.23255813953488058,Client
1177,0,2019-03-19,83923,ACTIMEL NATU 3x(14x100g) FR,0,0,0,ACTIMEL,1,Rotselaar(BE),0083,0024 FR CHAPONNAY (DC),225,430,246,245,1,185,184,0,205,-91.11111111111111,63,89,10,9,1,80,79,0,26,-41.26984126984127,11.235955056179774,10.112359550561797,1.1235955056179776,57.20930232558139,56.97674418604651,0.23255813953488058,Client
1178,0,2019-03-19,83923,ACTIMEL NATU 3x(14x100g) FR,0,0,0,ACTIMEL,1,Rotselaar(BE),0078,0024 FR PARIS NORD (DC),225,430,246,245,1,185,184,0,205,-91.11111111111111,118,136,136,136,0,0,0,0,18,-15.254237288135593,100.0,100.0,0.0,57.20930232558139,56.97674418604651,0.23255813953488058,Client
1179,0,2019-03-19,143291,DANET CHOCO 125X4 AFH,1,1,1,DANETTE,0,Bailleul(FR),0084,0024 FR AIX (DC),455,797,612,612,0,185,185,0,342,-75.16483516483517,110,68,68,68,0,0,0,0,-42,38.18181818181818,100.0,100.0,0.0,76.78795483061481,76.78795483061481,0.0,Previsions
1180,0,2019-03-19,143291,DANET CHOCO 125X4 AFH,1,1,1,DANETTE,0,Bailleul(FR),0080,0024 FR METZ (DC),455,797,612,612,0,185,185,0,342,-75.16483516483517,57,109,109,109,0,0,0,0,52,-91.2280701754386,100.0,100.0,0.0,76.78795483061481,76.78795483061481,0.0,Previsions
1181,0,2019-03-19,143291,DANET CHOCO 125X4 AFH,1,1,1,DANETTE,0,Bailleul(FR),0081,0024 FR TOURS (DC),455,797,612,612,0,185,185,0,342,-75.16483516483517,36,25,25,25,0,0,0,0,-11,30.555555555555557,100.0,100.0,0.0,76.78795483061481,76.78795483061481,0.0,Previsions
1182,0,2019-03-19,143291,DANET CHOCO 125X4 AFH,1,1,1,DANETTE,0,Bailleul(FR),0082,0024 FR VALLET (DC),455,797,612,612,0,185,185,0,342,-75.16483516483517,20,6,6,6,0,0,0,0,-14,70.0,100.0,100.0,0.0,76.78795483061481,76.78795483061481,0.0,Previsions
1183,0,2019-03-19,143291,DANET CHOCO 125X4 AFH,1,1,1,DANETTE,0,Bailleul(FR),0077,0024 FR LILPARK (DC),455,797,612,612,0,185,185,0,342,-75.16483516483517,68,76,76,76,0,0,0,0,8,-11.764705882352942,100.0,100.0,0.0,76.78795483061481,76.78795483061481,0.0,Previsions
1184,0,2019-03-19,143291,DANET CHOCO 125X4 AFH,1,1,1,DANETTE,0,Bailleul(FR),0085,0024 FR TOULOUSE (DC),455,797,612,612,0,185,185,0,342,-75.16483516483517,39,36,36,36,0,0,0,0,-3,7.6923076923076925,100.0,100.0,0.0,76.78795483061481,76.78795483061481,0.0,Previsions
1185,0,2019-03-19,143291,DANET CHOCO 125X4 AFH,1,1,1,DANETTE,0,Bailleul(FR),0083,0024 FR CHAPONNAY (DC),455,797,612,612,0,185,185,0,342,-75.16483516483517,58,31,31,31,0,0,0,0,-27,46.55172413793103,100.0,100.0,0.0,76.78795483061481,76.78795483061481,0.0,Previsions
1186,0,2019-03-19,143291,DANET CHOCO 125X4 AFH,1,1,1,DANETTE,0,Bailleul(FR),0079,0024 FR PARIS SUD (DC),455,797,612,612,0,185,185,0,342,-75.16483516483517,7,135,135,135,0,0,0,0,128,-1828.5714285714287,100.0,100.0,0.0,76.78795483061481,76.78795483061481,0.0,Previsions
1187,0,2019-03-19,143291,DANET CHOCO 125X4 AFH,1,1,1,DANETTE,0,Bailleul(FR),0078,0024 FR PARIS NORD (DC),455,797,612,612,0,185,185,0,342,-75.16483516483517,60,311,126,126,0,185,185,0,251,-418.3333333333333,40.51446945337621,40.51446945337621,0.0,76.78795483061481,76.78795483061481,0.0,Previsions
1188,0,2019-03-19,145090,DANET CARAMEL 125X6 D,0,1,0,DANETTE,0,StJust(FR),0084,0024 FR AIX (DC),2413,2709,2709,1092,1617,1617,0,0,296,-12.26688769167012,187,273,273,0,273,273,0,0,86,-45.98930481283423,100.0,0.0,100.0,100.0,40.310077519379846,59.689922480620154,Client
1189,0,2019-03-19,145090,DANET CARAMEL 125X6 D,0,1,0,DANETTE,0,StJust(FR),0080,0024 FR METZ (DC),2413,2709,2709,1092,1617,1617,0,0,296,-12.26688769167012,230,364,364,273,91,91,0,0,134,-58.26086956521739,100.0,75.0,25.0,100.0,40.310077519379846,59.689922480620154,Client
1190,0,2019-03-19,145090,DANET CARAMEL 125X6 D,0,1,0,DANETTE,0,StJust(FR),0081,0024 FR TOURS (DC),2413,2709,2709,1092,1617,1617,0,0,296,-12.26688769167012,130,343,343,0,343,343,0,0,213,-163.84615384615384,100.0,0.0,100.0,100.0,40.310077519379846,59.689922480620154,Client
1191,0,2019-03-19,145090,DANET CARAMEL 125X6 D,0,1,0,DANETTE,0,StJust(FR),0082,0024 FR VALLET (DC),2413,2709,2709,1092,1617,1617,0,0,296,-12.26688769167012,80,364,364,364,0,0,0,0,284,-355.0,100.0,100.0,0.0,100.0,40.310077519379846,59.689922480620154,Client
1192,0,2019-03-19,145090,DANET CARAMEL 125X6 D,0,1,0,DANETTE,0,StJust(FR),0077,0024 FR LILPARK (DC),2413,2709,2709,1092,1617,1617,0,0,296,-12.26688769167012,265,364,364,364,0,0,0,0,99,-37.35849056603774,100.0,100.0,0.0,100.0,40.310077519379846,59.689922480620154,Client
1193,0,2019-03-19,145090,DANET CARAMEL 125X6 D,0,1,0,DANETTE,0,StJust(FR),0085,0024 FR TOULOUSE (DC),2413,2709,2709,1092,1617,1617,0,0,296,-12.26688769167012,505,273,273,0,273,273,0,0,-232,45.94059405940594,100.0,0.0,100.0,100.0,40.310077519379846,59.689922480620154,Client
1194,0,2019-03-19,145090,DANET CARAMEL 125X6 D,0,1,0,DANETTE,0,StJust(FR),0083,0024 FR CHAPONNAY (DC),2413,2709,2709,1092,1617,1617,0,0,296,-12.26688769167012,445,637,637,0,637,637,0,0,192,-43.146067415730336,100.0,0.0,100.0,100.0,40.310077519379846,59.689922480620154,Client
1195,0,2019-03-19,145090,DANET CARAMEL 125X6 D,0,1,0,DANETTE,0,StJust(FR),0078,0024 FR PARIS NORD (DC),2413,2709,2709,1092,1617,1617,0,0,296,-12.26688769167012,571,91,91,91,0,0,0,0,-480,84.0630472854641,100.0,100.0,0.0,100.0,40.310077519379846,59.689922480620154,Client
1196,0,2019-03-20,69190,FJORD NATURE 125GX8,0,0,0,FJORD,0,LeMolay(FR),0084,0024 FR AIX (DC),5364,5747,5244,5244,0,503,503,0,383,-7.140193885160328,715,832,832,832,0,0,0,0,117,-16.363636363636363,100.0,100.0,0.0,91.24760744736385,91.24760744736385,0.0,Previsions
1197,0,2019-03-20,69190,FJORD NATURE 125GX8,0,0,0,FJORD,0,LeMolay(FR),0080,0024 FR METZ (DC),5364,5747,5244,5244,0,503,503,0,383,-7.140193885160328,282,364,325,325,0,39,39,0,82,-29.078014184397162,89.28571428571429,89.28571428571429,0.0,91.24760744736385,91.24760744736385,0.0,Previsions
1198,0,2019-03-20,69190,FJORD NATURE 125GX8,0,0,0,FJORD,0,LeMolay(FR),0081,0024 FR TOURS (DC),5364,5747,5244,5244,0,503,503,0,383,-7.140193885160328,505,591,390,390,0,201,201,0,86,-17.02970297029703,65.98984771573603,65.98984771573603,0.0,91.24760744736385,91.24760744736385,0.0,Previsions
1199,0,2019-03-20,69190,FJORD NATURE 125GX8,0,0,0,FJORD,0,LeMolay(FR),0082,0024 FR VALLET (DC),5364,5747,5244,5244,0,503,503,0,383,-7.140193885160328,399,500,500,500,0,0,0,0,101,-25.31328320802005,100.0,100.0,0.0,91.24760744736385,91.24760744736385,0.0,Previsions
1200,0,2019-03-20,69190,FJORD NATURE 125GX8,0,0,0,FJORD,0,LeMolay(FR),0077,0024 FR LILPARK (DC),5364,5747,5244,5244,0,503,503,0,383,-7.140193885160328,174,190,190,190,0,0,0,0,16,-9.195402298850574,100.0,100.0,0.0,91.24760744736385,91.24760744736385,0.0,Previsions
1201,0,2019-03-20,69190,FJORD NATURE 125GX8,0,0,0,FJORD,0,LeMolay(FR),0085,0024 FR TOULOUSE (DC),5364,5747,5244,5244,0,503,503,0,383,-7.140193885160328,844,759,496,496,0,263,263,0,-85,10.071090047393366,65.34914361001317,65.34914361001317,0.0,91.24760744736385,91.24760744736385,0.0,Previsions
1202,0,2019-03-20,69190,FJORD NATURE 125GX8,0,0,0,FJORD,0,LeMolay(FR),0083,0024 FR CHAPONNAY (DC),5364,5747,5244,5244,0,503,503,0,383,-7.140193885160328,1269,1192,1192,1192,0,0,0,0,-77,6.067769897557132,100.0,100.0,0.0,91.24760744736385,91.24760744736385,0.0,Previsions
1203,0,2019-03-20,69190,FJORD NATURE 125GX8,0,0,0,FJORD,0,LeMolay(FR),0079,0024 FR PARIS SUD (DC),5364,5747,5244,5244,0,503,503,0,383,-7.140193885160328,707,710,710,710,0,0,0,0,3,-0.4243281471004243,100.0,100.0,0.0,91.24760744736385,91.24760744736385,0.0,Previsions
1204,0,2019-03-20,69190,FJORD NATURE 125GX8,0,0,0,FJORD,0,LeMolay(FR),0078,0024 FR PARIS NORD (DC),5364,5747,5244,5244,0,503,503,0,383,-7.140193885160328,469,609,609,609,0,0,0,0,140,-29.850746268656717,100.0,100.0,0.0,91.24760744736385,91.24760744736385,0.0,Previsions
1205,0,2019-03-20,83924,ACTIMEL STRA 3x(14x100g) FR,0,0,0,ACTIMEL,1,Rotselaar(BE),0084,0024 FR AIX (DC),501,1636,643,639,4,997,993,0,1135,-226.54690618762476,124,124,124,124,0,0,0,0,0,0.0,100.0,100.0,0.0,39.30317848410758,39.05867970660147,0.24449877750611648,Client
1206,0,2019-03-20,83924,ACTIMEL STRA 3x(14x100g) FR,0,0,0,ACTIMEL,1,Rotselaar(BE),0081,0024 FR TOURS (DC),501,1636,643,639,4,997,993,0,1135,-226.54690618762476,11,18,18,18,0,0,0,0,7,-63.63636363636363,100.0,100.0,0.0,39.30317848410758,39.05867970660147,0.24449877750611648,Client
1207,0,2019-03-20,83924,ACTIMEL STRA 3x(14x100g) FR,0,0,0,ACTIMEL,1,Rotselaar(BE),0077,0024 FR LILPARK (DC),501,1636,643,639,4,997,993,0,1135,-226.54690618762476,226,94,25,23,2,71,69,0,-132,58.4070796460177,26.595744680851062,24.46808510638298,2.1276595744680833,39.30317848410758,39.05867970660147,0.24449877750611648,Client
1208,0,2019-03-20,83924,ACTIMEL STRA 3x(14x100g) FR,0,0,0,ACTIMEL,1,Rotselaar(BE),0083,0024 FR CHAPONNAY (DC),501,1636,643,639,4,997,993,0,1135,-226.54690618762476,22,94,10,8,2,86,84,0,72,-327.27272727272725,10.638297872340425,8.51063829787234,2.127659574468085,39.30317848410758,39.05867970660147,0.24449877750611648,Client
1209,0,2019-03-20,83924,ACTIMEL STRA 3x(14x100g) FR,0,0,0,ACTIMEL,1,Rotselaar(BE),0079,0024 FR PARIS SUD (DC),501,1636,643,639,4,997,993,0,1135,-226.54690618762476,0,284,117,117,0,167,167,1,284,10000.0,41.19718309859155,41.19718309859155,0.0,39.30317848410758,39.05867970660147,0.24449877750611648,Client
1210,0,2019-03-20,83924,ACTIMEL STRA 3x(14x100g) FR,0,0,0,ACTIMEL,1,Rotselaar(BE),0078,0024 FR PARIS NORD (DC),501,1636,643,639,4,997,993,0,1135,-226.54690618762476,118,1022,349,349,0,673,673,0,904,-766.1016949152543,34.148727984344426,34.148727984344426,0.0,39.30317848410758,39.05867970660147,0.24449877750611648,Client
1211,0,2019-03-20,102497,ACTIVIA CHEESE STRAWBERRY 120X4,0,0,0,ACTIVIA,0,Ferrières(FR),0084,0024 FR AIX (DC),1289,1192,943,657,286,535,249,0,-97,7.525213343677269,186,151,65,44,21,107,86,0,-35,18.817204301075268,43.04635761589404,29.13907284768212,13.90728476821192,79.11073825503355,55.11744966442953,23.993288590604024,Schéma
1212,0,2019-03-20,102497,ACTIVIA CHEESE STRAWBERRY 120X4,0,0,0,ACTIVIA,0,Ferrières(FR),0080,0024 FR METZ (DC),1289,1192,943,657,286,535,249,0,-97,7.525213343677269,130,129,49,47,2,82,80,0,-1,0.7692307692307693,37.98449612403101,36.434108527131784,1.5503875968992276,79.11073825503355,55.11744966442953,23.993288590604024,Schéma
1213,0,2019-03-20,102497,ACTIVIA CHEESE STRAWBERRY 120X4,0,0,0,ACTIVIA,0,Ferrières(FR),0081,0024 FR TOURS (DC),1289,1192,943,657,286,535,249,0,-97,7.525213343677269,122,92,11,9,2,83,81,0,-30,24.59016393442623,11.956521739130435,9.782608695652174,2.1739130434782616,79.11073825503355,55.11744966442953,23.993288590604024,Schéma
1214,0,2019-03-20,102497,ACTIVIA CHEESE STRAWBERRY 120X4,0,0,0,ACTIVIA,0,Ferrières(FR),0082,0024 FR VALLET (DC),1289,1192,943,657,286,535,249,0,-97,7.525213343677269,150,150,149,26,123,124,1,0,0,0.0,99.33333333333333,17.333333333333336,82.0,79.11073825503355,55.11744966442953,23.993288590604024,Schéma
1215,0,2019-03-20,102497,ACTIVIA CHEESE STRAWBERRY 120X4,0,0,0,ACTIVIA,0,Ferrières(FR),0077,0024 FR LILPARK (DC),1289,1192,943,657,286,535,249,0,-97,7.525213343677269,95,96,96,85,11,11,0,0,1,-1.0526315789473684,100.0,88.54166666666666,11.458333333333343,79.11073825503355,55.11744966442953,23.993288590604024,Schéma
1216,0,2019-03-20,102497,ACTIVIA CHEESE STRAWBERRY 120X4,0,0,0,ACTIVIA,0,Ferrières(FR),0085,0024 FR TOULOUSE (DC),1289,1192,943,657,286,535,249,0,-97,7.525213343677269,155,133,132,108,24,25,1,0,-22,14.193548387096774,99.24812030075188,81.203007518797,18.045112781954884,79.11073825503355,55.11744966442953,23.993288590604024,Schéma
1217,0,2019-03-20,102497,ACTIVIA CHEESE STRAWBERRY 120X4,0,0,0,ACTIVIA,0,Ferrières(FR),0083,0024 FR CHAPONNAY (DC),1289,1192,943,657,286,535,249,0,-97,7.525213343677269,173,155,155,87,68,68,0,0,-18,10.404624277456648,100.0,56.12903225806451,43.87096774193549,79.11073825503355,55.11744966442953,23.993288590604024,Schéma
1218,0,2019-03-20,102497,ACTIVIA CHEESE STRAWBERRY 120X4,0,0,0,ACTIVIA,0,Ferrières(FR),0079,0024 FR PARIS SUD (DC),1289,1192,943,657,286,535,249,0,-97,7.525213343677269,195,207,207,173,34,34,0,0,12,-6.153846153846154,100.0,83.57487922705315,16.425120772946855,79.11073825503355,55.11744966442953,23.993288590604024,Schéma
1219,0,2019-03-20,102497,ACTIVIA CHEESE STRAWBERRY 120X4,0,0,0,ACTIVIA,0,Ferrières(FR),0078,0024 FR PARIS NORD (DC),1289,1192,943,657,286,535,249,0,-97,7.525213343677269,83,79,79,78,1,1,0,0,-4,4.819277108433735,100.0,98.73417721518987,1.2658227848101262,79.11073825503355,55.11744966442953,23.993288590604024,Schéma
1220,0,2019-03-20,105287,DANET MOUS CHOC LIEG 80gx4 Lidl,0,0,0,DANETTE,1,Ochsenfurt(ALL),0084,0024 FR AIX (DC),1097,2520,2520,2280,240,240,0,0,1423,-129.71741112123973,184,360,360,360,0,0,0,0,176,-95.65217391304348,100.0,100.0,0.0,100.0,90.47619047619048,9.523809523809518,Client
1221,0,2019-03-20,105287,DANET MOUS CHOC LIEG 80gx4 Lidl,0,0,0,DANETTE,1,Ochsenfurt(ALL),0080,0024 FR METZ (DC),1097,2520,2520,2280,240,240,0,0,1423,-129.71741112123973,151,120,120,120,0,0,0,0,-31,20.52980132450331,100.0,100.0,0.0,100.0,90.47619047619048,9.523809523809518,Client
1222,0,2019-03-20,105287,DANET MOUS CHOC LIEG 80gx4 Lidl,0,0,0,DANETTE,1,Ochsenfurt(ALL),0081,0024 FR TOURS (DC),1097,2520,2520,2280,240,240,0,0,1423,-129.71741112123973,233,360,360,360,0,0,0,0,127,-54.506437768240346,100.0,100.0,0.0,100.0,90.47619047619048,9.523809523809518,Client
1223,0,2019-03-20,105287,DANET MOUS CHOC LIEG 80gx4 Lidl,0,0,0,DANETTE,1,Ochsenfurt(ALL),0082,0024 FR VALLET (DC),1097,2520,2520,2280,240,240,0,0,1423,-129.71741112123973,61,240,240,0,240,240,0,0,179,-293.44262295081967,100.0,0.0,100.0,100.0,90.47619047619048,9.523809523809518,Client
1224,0,2019-03-20,105287,DANET MOUS CHOC LIEG 80gx4 Lidl,0,0,0,DANETTE,1,Ochsenfurt(ALL),0077,0024 FR LILPARK (DC),1097,2520,2520,2280,240,240,0,0,1423,-129.71741112123973,219,600,600,600,0,0,0,0,381,-173.97260273972603,100.0,100.0,0.0,100.0,90.47619047619048,9.523809523809518,Client
1225,0,2019-03-20,105287,DANET MOUS CHOC LIEG 80gx4 Lidl,0,0,0,DANETTE,1,Ochsenfurt(ALL),0083,0024 FR CHAPONNAY (DC),1097,2520,2520,2280,240,240,0,0,1423,-129.71741112123973,56,360,360,360,0,0,0,0,304,-542.8571428571429,100.0,100.0,0.0,100.0,90.47619047619048,9.523809523809518,Client
1226,0,2019-03-20,105287,DANET MOUS CHOC LIEG 80gx4 Lidl,0,0,0,DANETTE,1,Ochsenfurt(ALL),0078,0024 FR PARIS NORD (DC),1097,2520,2520,2280,240,240,0,0,1423,-129.71741112123973,193,480,480,480,0,0,0,0,287,-148.70466321243524,100.0,100.0,0.0,100.0,90.47619047619048,9.523809523809518,Client
1227,0,2019-03-20,132459,ACTIVIA SAV VANILLE 125X4 OD,0,0,0,ACTIVIA,0,Bailleul(FR),0084,0024 FR AIX (DC),1,5,5,5,0,0,0,0,4,-400.0,1,5,5,5,0,0,0,0,4,-400.0,100.0,100.0,0.0,100.0,100.0,0.0,Previsions
1228,1,2019-03-20,135066,ACTIVIA SAV VANILLE 125X12 OD,1,0,0,ACTIVIA,0,Bailleul(FR),0079,0024 FR PARIS SUD (DC),249,394,337,337,0,57,57,0,145,-58.23293172690763,249,232,175,175,0,57,57,0,-17,6.827309236947791,75.43103448275862,75.43103448275862,0.0,85.53299492385787,85.53299492385787,0.0,A Creuser
1229,1,2019-03-20,136436,ACTIVIA FRT CERISE 125X4 OD,1,0,0,ACTIVIA,0,Villecomtal(FR),0077,0024 FR LILPARK (DC),62,498,486,464,22,34,12,0,436,-703.2258064516129,62,103,103,81,22,22,0,0,41,-66.12903225806451,100.0,78.64077669902912,21.359223300970882,97.59036144578313,93.17269076305222,4.417670682730915,A Creuser
1230,0,2019-03-20,140869,ACV 145gx2(x5) BIO BLUE-BLCURR FR,0,0,0,ACTIVIA,1,Ochsenfurt(ALL),0084,0024 FR AIX (DC),624,435,435,310,125,125,0,0,-189,30.28846153846154,83,104,104,104,0,0,0,0,21,-25.301204819277107,100.0,100.0,0.0,100.0,71.26436781609196,28.735632183908038,A Creuser
1231,0,2019-03-20,140869,ACV 145gx2(x5) BIO BLUE-BLCURR FR,0,0,0,ACTIVIA,1,Ochsenfurt(ALL),0080,0024 FR METZ (DC),624,435,435,310,125,125,0,0,-189,30.28846153846154,47,26,26,26,0,0,0,0,-21,44.680851063829785,100.0,100.0,0.0,100.0,71.26436781609196,28.735632183908038,A Creuser
1232,0,2019-03-20,140869,ACV 145gx2(x5) BIO BLUE-BLCURR FR,0,0,0,ACTIVIA,1,Ochsenfurt(ALL),0081,0024 FR TOURS (DC),624,435,435,310,125,125,0,0,-189,30.28846153846154,85,86,86,86,0,0,0,0,1,-1.1764705882352942,100.0,100.0,0.0,100.0,71.26436781609196,28.735632183908038,A Creuser
1233,0,2019-03-20,140869,ACV 145gx2(x5) BIO BLUE-BLCURR FR,0,0,0,ACTIVIA,1,Ochsenfurt(ALL),0082,0024 FR VALLET (DC),624,435,435,310,125,125,0,0,-189,30.28846153846154,150,125,125,1,124,124,0,0,-25,16.666666666666668,100.0,0.8,99.2,100.0,71.26436781609196,28.735632183908038,A Creuser
1234,1,2019-03-20,140869,ACV 145gx2(x5) BIO BLUE-BLCURR FR,0,0,0,ACTIVIA,1,Ochsenfurt(ALL),0082,0024 FR VALLET (DC),624,435,435,310,125,125,0,0,-189,30.28846153846154,150,125,125,1,124,124,0,0,-25,16.666666666666668,100.0,0.8,99.2,100.0,71.26436781609196,28.735632183908038,A Creuser
1235,0,2019-03-20,140869,ACV 145gx2(x5) BIO BLUE-BLCURR FR,0,0,0,ACTIVIA,1,Ochsenfurt(ALL),0077,0024 FR LILPARK (DC),624,435,435,310,125,125,0,0,-189,30.28846153846154,1,3,3,2,1,1,0,0,2,-200.0,100.0,66.66666666666666,33.33333333333334,100.0,71.26436781609196,28.735632183908038,A Creuser
1236,0,2019-03-20,140869,ACV 145gx2(x5) BIO BLUE-BLCURR FR,0,0,0,ACTIVIA,1,Ochsenfurt(ALL),0085,0024 FR TOULOUSE (DC),624,435,435,310,125,125,0,0,-189,30.28846153846154,28,11,11,11,0,0,0,0,-17,60.714285714285715,100.0,100.0,0.0,100.0,71.26436781609196,28.735632183908038,A Creuser
1237,0,2019-03-20,140869,ACV 145gx2(x5) BIO BLUE-BLCURR FR,0,0,0,ACTIVIA,1,Ochsenfurt(ALL),0083,0024 FR CHAPONNAY (DC),624,435,435,310,125,125,0,0,-189,30.28846153846154,39,44,44,44,0,0,0,0,5,-12.820512820512821,100.0,100.0,0.0,100.0,71.26436781609196,28.735632183908038,A Creuser
1238,0,2019-03-20,140869,ACV 145gx2(x5) BIO BLUE-BLCURR FR,0,0,0,ACTIVIA,1,Ochsenfurt(ALL),0079,0024 FR PARIS SUD (DC),624,435,435,310,125,125,0,0,-189,30.28846153846154,26,27,27,27,0,0,0,0,1,-3.8461538461538463,100.0,100.0,0.0,100.0,71.26436781609196,28.735632183908038,A Creuser
1239,0,2019-03-20,140869,ACV 145gx2(x5) BIO BLUE-BLCURR FR,0,0,0,ACTIVIA,1,Ochsenfurt(ALL),0078,0024 FR PARIS NORD (DC),624,435,435,310,125,125,0,0,-189,30.28846153846154,15,9,9,9,0,0,0,0,-6,40.0,100.0,100.0,0.0,100.0,71.26436781609196,28.735632183908038,A Creuser
1240,0,2019-03-21,102497,ACTIVIA CHEESE STRAWBERRY 120X4,0,0,0,ACTIVIA,0,Ferrières(FR),0084,0024 FR AIX (DC),1455,1528,1343,1193,150,335,185,0,73,-5.017182130584192,153,181,181,181,0,0,0,0,28,-18.30065359477124,100.0,100.0,0.0,87.89267015706807,78.07591623036649,9.81675392670158,Schéma
1241,0,2019-03-21,102497,ACTIVIA CHEESE STRAWBERRY 120X4,0,0,0,ACTIVIA,0,Ferrières(FR),0080,0024 FR METZ (DC),1455,1528,1343,1193,150,335,185,0,73,-5.017182130584192,72,65,5,3,2,62,60,0,-7,9.722222222222221,7.6923076923076925,4.615384615384616,3.0769230769230766,87.89267015706807,78.07591623036649,9.81675392670158,Schéma
1242,0,2019-03-21,102497,ACTIVIA CHEESE STRAWBERRY 120X4,0,0,0,ACTIVIA,0,Ferrières(FR),0081,0024 FR TOURS (DC),1455,1528,1343,1193,150,335,185,0,73,-5.017182130584192,154,154,154,154,0,0,0,0,0,0.0,100.0,100.0,0.0,87.89267015706807,78.07591623036649,9.81675392670158,Schéma
1243,0,2019-03-21,102497,ACTIVIA CHEESE STRAWBERRY 120X4,0,0,0,ACTIVIA,0,Ferrières(FR),0082,0024 FR VALLET (DC),1455,1528,1343,1193,150,335,185,0,73,-5.017182130584192,116,98,87,2,85,96,11,0,-18,15.517241379310345,88.77551020408163,2.0408163265306123,86.73469387755101,87.89267015706807,78.07591623036649,9.81675392670158,Schéma
1244,0,2019-03-21,102497,ACTIVIA CHEESE STRAWBERRY 120X4,0,0,0,ACTIVIA,0,Ferrières(FR),0077,0024 FR LILPARK (DC),1455,1528,1343,1193,150,335,185,0,73,-5.017182130584192,236,196,82,19,63,177,114,0,-40,16.949152542372882,41.83673469387755,9.693877551020408,32.142857142857146,87.89267015706807,78.07591623036649,9.81675392670158,Schéma
1245,0,2019-03-21,102497,ACTIVIA CHEESE STRAWBERRY 120X4,0,0,0,ACTIVIA,0,Ferrières(FR),0085,0024 FR TOULOUSE (DC),1455,1528,1343,1193,150,335,185,0,73,-5.017182130584192,187,191,191,191,0,0,0,0,4,-2.1390374331550803,100.0,100.0,0.0,87.89267015706807,78.07591623036649,9.81675392670158,Schéma
1246,0,2019-03-21,102497,ACTIVIA CHEESE STRAWBERRY 120X4,0,0,0,ACTIVIA,0,Ferrières(FR),0083,0024 FR CHAPONNAY (DC),1455,1528,1343,1193,150,335,185,0,73,-5.017182130584192,163,223,223,223,0,0,0,0,60,-36.809815950920246,100.0,100.0,0.0,87.89267015706807,78.07591623036649,9.81675392670158,Schéma
1247,0,2019-03-21,102497,ACTIVIA CHEESE STRAWBERRY 120X4,0,0,0,ACTIVIA,0,Ferrières(FR),0079,0024 FR PARIS SUD (DC),1455,1528,1343,1193,150,335,185,0,73,-5.017182130584192,245,267,267,267,0,0,0,0,22,-8.979591836734693,100.0,100.0,0.0,87.89267015706807,78.07591623036649,9.81675392670158,Schéma
1248,0,2019-03-21,102497,ACTIVIA CHEESE STRAWBERRY 120X4,0,0,0,ACTIVIA,0,Ferrières(FR),0078,0024 FR PARIS NORD (DC),1455,1528,1343,1193,150,335,185,0,73,-5.017182130584192,129,153,153,153,0,0,0,0,24,-18.6046511627907,100.0,100.0,0.0,87.89267015706807,78.07591623036649,9.81675392670158,Schéma
1249,1,2019-03-21,133133,LIGHT&FREE FRAIS BOIS 120X4 OD,1,0,0,LIGHT & FREE,0,Ferrières(FR),0080,0024 FR METZ (DC),129,952,943,943,0,9,9,0,823,-637.984496124031,129,125,116,116,0,9,9,0,-4,3.10077519379845,92.80000000000001,92.80000000000001,0.0,99.0546218487395,99.0546218487395,0.0,Production
1250,0,2019-03-21,133397,LIGHT & FREE FRAIS BOIS 120X4,0,0,0,LIGHT & FREE,0,Ferrières(FR),0081,0024 FR TOURS (DC),433,461,416,416,0,45,45,0,28,-6.466512702078522,95,71,71,71,0,0,0,0,-24,25.263157894736842,100.0,100.0,0.0,90.23861171366593,90.23861171366593,0.0,Production
1251,0,2019-03-21,133397,LIGHT & FREE FRAIS BOIS 120X4,0,0,0,LIGHT & FREE,0,Ferrières(FR),0077,0024 FR LILPARK (DC),433,461,416,416,0,45,45,0,28,-6.466512702078522,99,81,81,81,0,0,0,0,-18,18.181818181818183,100.0,100.0,0.0,90.23861171366593,90.23861171366593,0.0,Production
1252,0,2019-03-21,133397,LIGHT & FREE FRAIS BOIS 120X4,0,0,0,LIGHT & FREE,0,Ferrières(FR),0083,0024 FR CHAPONNAY (DC),433,461,416,416,0,45,45,0,28,-6.466512702078522,63,73,73,73,0,0,0,0,10,-15.873015873015873,100.0,100.0,0.0,90.23861171366593,90.23861171366593,0.0,Production
1253,0,2019-03-21,133397,LIGHT & FREE FRAIS BOIS 120X4,0,0,0,LIGHT & FREE,0,Ferrières(FR),0079,0024 FR PARIS SUD (DC),433,461,416,416,0,45,45,0,28,-6.466512702078522,125,135,135,135,0,0,0,0,10,-8.0,100.0,100.0,0.0,90.23861171366593,90.23861171366593,0.0,Production
1254,0,2019-03-21,133397,LIGHT & FREE FRAIS BOIS 120X4,0,0,0,LIGHT & FREE,0,Ferrières(FR),0078,0024 FR PARIS NORD (DC),433,461,416,416,0,45,45,0,28,-6.466512702078522,51,101,56,56,0,45,45,0,50,-98.03921568627452,55.44554455445545,55.44554455445545,0.0,90.23861171366593,90.23861171366593,0.0,Production
1255,1,2019-03-21,140869,ACV 145gx2(x5) BIO BLUE-BLCURR FR,0,0,0,ACTIVIA,1,Ochsenfurt(ALL),0077,0024 FR LILPARK (DC),56,428,428,401,27,27,0,0,372,-664.2857142857143,56,60,60,33,27,27,0,0,4,-7.142857142857143,100.0,55.00000000000001,44.99999999999999,100.0,93.69158878504673,6.308411214953267,A Creuser
1256,0,2019-03-22,83923,ACTIMEL NATU 3x(14x100g) FR,0,0,0,ACTIMEL,1,Rotselaar(BE),0084,0024 FR AIX (DC),416,616,246,130,116,486,370,0,200,-48.07692307692308,113,113,113,0,113,113,0,0,0,0.0,100.0,0.0,100.0,39.935064935064936,21.1038961038961,18.831168831168835,Previsions
1257,0,2019-03-22,83923,ACTIMEL NATU 3x(14x100g) FR,0,0,0,ACTIMEL,1,Rotselaar(BE),0081,0024 FR TOURS (DC),416,616,246,130,116,486,370,0,200,-48.07692307692308,44,3,3,3,0,0,0,0,-41,93.18181818181819,100.0,100.0,0.0,39.935064935064936,21.1038961038961,18.831168831168835,Previsions
1258,0,2019-03-22,83923,ACTIMEL NATU 3x(14x100g) FR,0,0,0,ACTIMEL,1,Rotselaar(BE),0082,0024 FR VALLET (DC),416,616,246,130,116,486,370,0,200,-48.07692307692308,54,10,10,10,0,0,0,0,-44,81.48148148148148,100.0,100.0,0.0,39.935064935064936,21.1038961038961,18.831168831168835,Previsions
1259,0,2019-03-22,83923,ACTIMEL NATU 3x(14x100g) FR,0,0,0,ACTIMEL,1,Rotselaar(BE),0077,0024 FR LILPARK (DC),416,616,246,130,116,486,370,0,200,-48.07692307692308,8,19,19,19,0,0,0,0,11,-137.5,100.0,100.0,0.0,39.935064935064936,21.1038961038961,18.831168831168835,Previsions
1260,0,2019-03-22,83923,ACTIMEL NATU 3x(14x100g) FR,0,0,0,ACTIMEL,1,Rotselaar(BE),0085,0024 FR TOULOUSE (DC),416,616,246,130,116,486,370,0,200,-48.07692307692308,83,35,35,35,0,0,0,0,-48,57.83132530120482,100.0,100.0,0.0,39.935064935064936,21.1038961038961,18.831168831168835,Previsions
1261,0,2019-03-22,83923,ACTIMEL NATU 3x(14x100g) FR,0,0,0,ACTIMEL,1,Rotselaar(BE),0079,0024 FR PARIS SUD (DC),416,616,246,130,116,486,370,0,200,-48.07692307692308,102,60,60,60,0,0,0,0,-42,41.1764705882353,100.0,100.0,0.0,39.935064935064936,21.1038961038961,18.831168831168835,Previsions
1262,0,2019-03-22,83923,ACTIMEL NATU 3x(14x100g) FR,0,0,0,ACTIMEL,1,Rotselaar(BE),0078,0024 FR PARIS NORD (DC),416,616,246,130,116,486,370,0,200,-48.07692307692308,12,376,6,3,3,373,370,0,364,-3033.3333333333335,1.5957446808510638,0.7978723404255319,0.7978723404255319,39.935064935064936,21.1038961038961,18.831168831168835,Previsions
1263,0,2019-03-22,83924,ACTIMEL STRA 3x(14x100g) FR,0,0,0,ACTIMEL,1,Rotselaar(BE),0081,0024 FR TOURS (DC),414,355,82,75,7,280,273,0,-59,14.251207729468598,63,7,7,7,0,0,0,0,-56,88.88888888888889,100.0,100.0,0.0,23.098591549295776,21.12676056338028,1.9718309859154957,Previsions
1264,0,2019-03-22,83924,ACTIMEL STRA 3x(14x100g) FR,0,0,0,ACTIMEL,1,Rotselaar(BE),0082,0024 FR VALLET (DC),414,355,82,75,7,280,273,0,-59,14.251207729468598,93,31,20,20,0,11,11,0,-62,66.66666666666667,64.51612903225806,64.51612903225806,0.0,23.098591549295776,21.12676056338028,1.9718309859154957,Previsions
1265,0,2019-03-22,83924,ACTIMEL STRA 3x(14x100g) FR,0,0,0,ACTIMEL,1,Rotselaar(BE),0077,0024 FR LILPARK (DC),414,355,82,75,7,280,273,0,-59,14.251207729468598,18,104,9,7,2,97,95,0,86,-477.77777777777777,8.653846153846153,6.730769230769231,1.9230769230769225,23.098591549295776,21.12676056338028,1.9718309859154957,Previsions
1266,0,2019-03-22,83924,ACTIMEL STRA 3x(14x100g) FR,0,0,0,ACTIMEL,1,Rotselaar(BE),0085,0024 FR TOULOUSE (DC),414,355,82,75,7,280,273,0,-59,14.251207729468598,204,55,11,11,0,44,44,0,-149,73.03921568627452,20.0,20.0,0.0,23.098591549295776,21.12676056338028,1.9718309859154957,Previsions
1267,0,2019-03-22,83924,ACTIMEL STRA 3x(14x100g) FR,0,0,0,ACTIMEL,1,Rotselaar(BE),0083,0024 FR CHAPONNAY (DC),414,355,82,75,7,280,273,0,-59,14.251207729468598,36,158,35,30,5,128,123,0,122,-338.8888888888889,22.151898734177212,18.9873417721519,3.164556962025312,23.098591549295776,21.12676056338028,1.9718309859154957,Previsions
1268,0,2019-03-22,83925,ACTIMEL 0% NATU 3x(14x100g) FR,0,0,0,ACTIMEL,1,Rotselaar(BE),0084,0024 FR AIX (DC),252,133,73,56,17,77,60,0,-119,47.22222222222222,37,37,9,8,1,29,28,0,0,0.0,24.324324324324326,21.62162162162162,2.7027027027027053,54.88721804511278,42.10526315789473,12.781954887218049,Previsions
1269,0,2019-03-22,83925,ACTIMEL 0% NATU 3x(14x100g) FR,0,0,0,ACTIMEL,1,Rotselaar(BE),0081,0024 FR TOURS (DC),252,133,73,56,17,77,60,0,-119,47.22222222222222,28,3,3,3,0,0,0,0,-25,89.28571428571429,100.0,100.0,0.0,54.88721804511278,42.10526315789473,12.781954887218049,Previsions
1270,0,2019-03-22,83925,ACTIMEL 0% NATU 3x(14x100g) FR,0,0,0,ACTIMEL,1,Rotselaar(BE),0082,0024 FR VALLET (DC),252,133,73,56,17,77,60,0,-119,47.22222222222222,44,17,14,0,14,17,3,0,-27,61.36363636363637,82.35294117647058,0.0,82.35294117647058,54.88721804511278,42.10526315789473,12.781954887218049,Previsions
1271,0,2019-03-22,83925,ACTIMEL 0% NATU 3x(14x100g) FR,0,0,0,ACTIMEL,1,Rotselaar(BE),0077,0024 FR LILPARK (DC),252,133,73,56,17,77,60,0,-119,47.22222222222222,4,25,25,25,0,0,0,0,21,-525.0,100.0,100.0,0.0,54.88721804511278,42.10526315789473,12.781954887218049,Previsions
1272,0,2019-03-22,83925,ACTIMEL 0% NATU 3x(14x100g) FR,0,0,0,ACTIMEL,1,Rotselaar(BE),0085,0024 FR TOULOUSE (DC),252,133,73,56,17,77,60,0,-119,47.22222222222222,66,9,3,3,0,6,6,0,-57,86.36363636363636,33.33333333333333,33.33333333333333,0.0,54.88721804511278,42.10526315789473,12.781954887218049,Previsions
1273,0,2019-03-22,83925,ACTIMEL 0% NATU 3x(14x100g) FR,0,0,0,ACTIMEL,1,Rotselaar(BE),0083,0024 FR CHAPONNAY (DC),252,133,73,56,17,77,60,0,-119,47.22222222222222,9,26,7,6,1,20,19,0,17,-188.88888888888889,26.923076923076923,23.076923076923077,3.8461538461538467,54.88721804511278,42.10526315789473,12.781954887218049,Previsions
1274,0,2019-03-22,83925,ACTIMEL 0% NATU 3x(14x100g) FR,0,0,0,ACTIMEL,1,Rotselaar(BE),0079,0024 FR PARIS SUD (DC),252,133,73,56,17,77,60,0,-119,47.22222222222222,64,16,12,11,1,5,4,0,-48,75.0,75.0,68.75,6.25,54.88721804511278,42.10526315789473,12.781954887218049,Previsions
1275,0,2019-03-22,90635,DANET CHOCO 125X6,0,1,0,DANETTE,0,StJust(FR),0084,0024 FR AIX (DC),3936,3196,2986,2961,25,235,210,0,-740,18.80081300813008,326,401,360,336,24,65,41,0,75,-23.006134969325153,89.77556109725685,83.79052369077307,5.985037406483784,93.42928660826033,92.64705882352942,0.7822277847309067,Production
1276,1,2019-03-22,90635,DANET CHOCO 125X6,0,1,0,DANETTE,0,StJust(FR),0084,0024 FR AIX (DC),3936,3196,2986,2961,25,235,210,0,-740,18.80081300813008,326,401,360,336,24,65,41,0,75,-23.006134969325153,89.77556109725685,83.79052369077307,5.985037406483784,93.42928660826033,92.64705882352942,0.7822277847309067,Production
1277,0,2019-03-22,90635,DANET CHOCO 125X6,0,1,0,DANETTE,0,StJust(FR),0080,0024 FR METZ (DC),3936,3196,2986,2961,25,235,210,0,-740,18.80081300813008,1054,1202,1033,1032,1,170,169,0,148,-14.041745730550284,85.94009983361065,85.85690515806988,0.0831946755407671,93.42928660826033,92.64705882352942,0.7822277847309067,Production
1278,0,2019-03-22,90635,DANET CHOCO 125X6,0,1,0,DANETTE,0,StJust(FR),0081,0024 FR TOURS (DC),3936,3196,2986,2961,25,235,210,0,-740,18.80081300813008,284,132,132,132,0,0,0,0,-152,53.521126760563384,100.0,100.0,0.0,93.42928660826033,92.64705882352942,0.7822277847309067,Production
1279,0,2019-03-22,90635,DANET CHOCO 125X6,0,1,0,DANETTE,0,StJust(FR),0082,0024 FR VALLET (DC),3936,3196,2986,2961,25,235,210,0,-740,18.80081300813008,302,286,286,286,0,0,0,0,-16,5.298013245033113,100.0,100.0,0.0,93.42928660826033,92.64705882352942,0.7822277847309067,Production
1280,0,2019-03-22,90635,DANET CHOCO 125X6,0,1,0,DANETTE,0,StJust(FR),0077,0024 FR LILPARK (DC),3936,3196,2986,2961,25,235,210,0,-740,18.80081300813008,71,125,125,125,0,0,0,0,54,-76.05633802816901,100.0,100.0,0.0,93.42928660826033,92.64705882352942,0.7822277847309067,Production
1281,0,2019-03-22,90635,DANET CHOCO 125X6,0,1,0,DANETTE,0,StJust(FR),0085,0024 FR TOULOUSE (DC),3936,3196,2986,2961,25,235,210,0,-740,18.80081300813008,1200,640,640,640,0,0,0,0,-560,46.666666666666664,100.0,100.0,0.0,93.42928660826033,92.64705882352942,0.7822277847309067,Production
1282,0,2019-03-22,90635,DANET CHOCO 125X6,0,1,0,DANETTE,0,StJust(FR),0083,0024 FR CHAPONNAY (DC),3936,3196,2986,2961,25,235,210,0,-740,18.80081300813008,192,206,206,206,0,0,0,0,14,-7.291666666666667,100.0,100.0,0.0,93.42928660826033,92.64705882352942,0.7822277847309067,Production
1283,0,2019-03-22,90635,DANET CHOCO 125X6,0,1,0,DANETTE,0,StJust(FR),0079,0024 FR PARIS SUD (DC),3936,3196,2986,2961,25,235,210,0,-740,18.80081300813008,158,176,176,176,0,0,0,0,18,-11.39240506329114,100.0,100.0,0.0,93.42928660826033,92.64705882352942,0.7822277847309067,Production
1284,0,2019-03-22,90635,DANET CHOCO 125X6,0,1,0,DANETTE,0,StJust(FR),0078,0024 FR PARIS NORD (DC),3936,3196,2986,2961,25,235,210,0,-740,18.80081300813008,23,28,28,28,0,0,0,0,5,-21.73913043478261,100.0,100.0,0.0,93.42928660826033,92.64705882352942,0.7822277847309067,Production
1285,0,2019-03-22,105287,DANET MOUS CHOC LIEG 80gx4 Lidl,0,0,0,DANETTE,1,Ochsenfurt(ALL),0084,0024 FR AIX (DC),970,1504,1184,1184,0,320,320,0,534,-55.05154639175258,188,480,282,282,0,198,198,0,292,-155.31914893617022,58.75,58.75,0.0,78.72340425531915,78.72340425531915,0.0,Client
1286,0,2019-03-22,105287,DANET MOUS CHOC LIEG 80gx4 Lidl,0,0,0,DANETTE,1,Ochsenfurt(ALL),0080,0024 FR METZ (DC),970,1504,1184,1184,0,320,320,0,534,-55.05154639175258,152,120,120,120,0,0,0,0,-32,21.05263157894737,100.0,100.0,0.0,78.72340425531915,78.72340425531915,0.0,Client
1287,0,2019-03-22,105287,DANET MOUS CHOC LIEG 80gx4 Lidl,0,0,0,DANETTE,1,Ochsenfurt(ALL),0085,0024 FR TOULOUSE (DC),970,1504,1184,1184,0,320,320,0,534,-55.05154639175258,134,272,233,233,0,39,39,0,138,-102.98507462686567,85.66176470588235,85.66176470588235,0.0,78.72340425531915,78.72340425531915,0.0,Client
1288,0,2019-03-22,105287,DANET MOUS CHOC LIEG 80gx4 Lidl,0,0,0,DANETTE,1,Ochsenfurt(ALL),0083,0024 FR CHAPONNAY (DC),970,1504,1184,1184,0,320,320,0,534,-55.05154639175258,140,240,157,157,0,83,83,0,100,-71.42857142857143,65.41666666666667,65.41666666666667,0.0,78.72340425531915,78.72340425531915,0.0,Client
1289,0,2019-03-22,105287,DANET MOUS CHOC LIEG 80gx4 Lidl,0,0,0,DANETTE,1,Ochsenfurt(ALL),0079,0024 FR PARIS SUD (DC),970,1504,1184,1184,0,320,320,0,534,-55.05154639175258,174,272,272,272,0,0,0,0,98,-56.32183908045977,100.0,100.0,0.0,78.72340425531915,78.72340425531915,0.0,Client
1290,0,2019-03-22,105287,DANET MOUS CHOC LIEG 80gx4 Lidl,0,0,0,DANETTE,1,Ochsenfurt(ALL),0078,0024 FR PARIS NORD (DC),970,1504,1184,1184,0,320,320,0,534,-55.05154639175258,182,120,120,120,0,0,0,0,-62,34.065934065934066,100.0,100.0,0.0,78.72340425531915,78.72340425531915,0.0,Client
1291,0,2019-03-22,120841,VELOUTE FRUIX PANACHES 125X8 AFH,0,0,1,VELOUTE,0,Villecomtal(FR),0084,0024 FR AIX (DC),2724,2498,2185,2185,0,313,313,0,-226,8.29662261380323,107,144,144,144,0,0,0,0,37,-34.57943925233645,100.0,100.0,0.0,87.46997598078462,87.46997598078462,0.0,Previsions
1292,0,2019-03-22,120841,VELOUTE FRUIX PANACHES 125X8 AFH,0,0,1,VELOUTE,0,Villecomtal(FR),0080,0024 FR METZ (DC),2724,2498,2185,2185,0,313,313,0,-226,8.29662261380323,101,225,225,225,0,0,0,0,124,-122.77227722772277,100.0,100.0,0.0,87.46997598078462,87.46997598078462,0.0,Previsions
1293,0,2019-03-22,120841,VELOUTE FRUIX PANACHES 125X8 AFH,0,0,1,VELOUTE,0,Villecomtal(FR),0081,0024 FR TOURS (DC),2724,2498,2185,2185,0,313,313,0,-226,8.29662261380323,136,178,178,178,0,0,0,0,42,-30.88235294117647,100.0,100.0,0.0,87.46997598078462,87.46997598078462,0.0,Previsions
1294,0,2019-03-22,120841,VELOUTE FRUIX PANACHES 125X8 AFH,0,0,1,VELOUTE,0,Villecomtal(FR),0082,0024 FR VALLET (DC),2724,2498,2185,2185,0,313,313,0,-226,8.29662261380323,207,273,273,273,0,0,0,0,66,-31.884057971014492,100.0,100.0,0.0,87.46997598078462,87.46997598078462,0.0,Previsions
1295,0,2019-03-22,120841,VELOUTE FRUIX PANACHES 125X8 AFH,0,0,1,VELOUTE,0,Villecomtal(FR),0077,0024 FR LILPARK (DC),2724,2498,2185,2185,0,313,313,0,-226,8.29662261380323,437,383,383,383,0,0,0,0,-54,12.356979405034325,100.0,100.0,0.0,87.46997598078462,87.46997598078462,0.0,Previsions
1296,0,2019-03-22,120841,VELOUTE FRUIX PANACHES 125X8 AFH,0,0,1,VELOUTE,0,Villecomtal(FR),0085,0024 FR TOULOUSE (DC),2724,2498,2185,2185,0,313,313,0,-226,8.29662261380323,175,291,291,291,0,0,0,0,116,-66.28571428571429,100.0,100.0,0.0,87.46997598078462,87.46997598078462,0.0,Previsions
1297,0,2019-03-22,120841,VELOUTE FRUIX PANACHES 125X8 AFH,0,0,1,VELOUTE,0,Villecomtal(FR),0083,0024 FR CHAPONNAY (DC),2724,2498,2185,2185,0,313,313,0,-226,8.29662261380323,266,309,309,309,0,0,0,0,43,-16.165413533834588,100.0,100.0,0.0,87.46997598078462,87.46997598078462,0.0,Previsions
1298,0,2019-03-22,120841,VELOUTE FRUIX PANACHES 125X8 AFH,0,0,1,VELOUTE,0,Villecomtal(FR),0079,0024 FR PARIS SUD (DC),2724,2498,2185,2185,0,313,313,0,-226,8.29662261380323,812,315,174,174,0,141,141,0,-497,61.206896551724135,55.23809523809524,55.23809523809524,0.0,87.46997598078462,87.46997598078462,0.0,Previsions
1299,0,2019-03-22,120841,VELOUTE FRUIX PANACHES 125X8 AFH,0,0,1,VELOUTE,0,Villecomtal(FR),0078,0024 FR PARIS NORD (DC),2724,2498,2185,2185,0,313,313,0,-226,8.29662261380323,483,380,208,208,0,172,172,0,-103,21.32505175983437,54.736842105263165,54.736842105263165,0.0,87.46997598078462,87.46997598078462,0.0,Previsions
1300,0,2019-03-22,133397,LIGHT & FREE FRAIS BOIS 120X4,0,0,0,LIGHT & FREE,0,Ferrières(FR),0081,0024 FR TOURS (DC),350,288,238,238,0,50,50,0,-62,17.714285714285715,119,84,34,34,0,50,50,0,-35,29.41176470588235,40.476190476190474,40.476190476190474,0.0,82.63888888888889,82.63888888888889,0.0,Production
1301,0,2019-03-22,133397,LIGHT & FREE FRAIS BOIS 120X4,0,0,0,LIGHT & FREE,0,Ferrières(FR),0077,0024 FR LILPARK (DC),350,288,238,238,0,50,50,0,-62,17.714285714285715,44,56,56,56,0,0,0,0,12,-27.272727272727273,100.0,100.0,0.0,82.63888888888889,82.63888888888889,0.0,Production
1302,0,2019-03-22,133397,LIGHT & FREE FRAIS BOIS 120X4,0,0,0,LIGHT & FREE,0,Ferrières(FR),0083,0024 FR CHAPONNAY (DC),350,288,238,238,0,50,50,0,-62,17.714285714285715,90,80,80,80,0,0,0,0,-10,11.11111111111111,100.0,100.0,0.0,82.63888888888889,82.63888888888889,0.0,Production
1303,0,2019-03-22,133397,LIGHT & FREE FRAIS BOIS 120X4,0,0,0,LIGHT & FREE,0,Ferrières(FR),0079,0024 FR PARIS SUD (DC),350,288,238,238,0,50,50,0,-62,17.714285714285715,97,68,68,68,0,0,0,0,-29,29.896907216494846,100.0,100.0,0.0,82.63888888888889,82.63888888888889,0.0,Production
1304,0,2019-03-22,145080,DANET CHOCOLAT 125GX6 D,0,1,0,DANETTE,0,StJust(FR),0084,0024 FR AIX (DC),1891,2366,2192,1750,442,616,174,0,475,-25.118984664198837,388,546,546,416,130,130,0,0,158,-40.72164948453608,100.0,76.19047619047619,23.80952380952381,92.6458157227388,73.96449704142012,18.681318681318686,Client
1305,0,2019-03-22,145080,DANET CHOCOLAT 125GX6 D,0,1,0,DANETTE,0,StJust(FR),0080,0024 FR METZ (DC),1891,2366,2192,1750,442,616,174,0,475,-25.118984664198837,392,364,364,364,0,0,0,0,-28,7.142857142857143,100.0,100.0,0.0,92.6458157227388,73.96449704142012,18.681318681318686,Client
1306,0,2019-03-22,145080,DANET CHOCOLAT 125GX6 D,0,1,0,DANETTE,0,StJust(FR),0081,0024 FR TOURS (DC),1891,2366,2192,1750,442,616,174,0,475,-25.118984664198837,170,338,338,208,130,130,0,0,168,-98.82352941176471,100.0,61.53846153846154,38.46153846153846,92.6458157227388,73.96449704142012,18.681318681318686,Client
1307,0,2019-03-22,145080,DANET CHOCOLAT 125GX6 D,0,1,0,DANETTE,0,StJust(FR),0085,0024 FR TOULOUSE (DC),1891,2366,2192,1750,442,616,174,0,475,-25.118984664198837,314,390,216,216,0,174,174,0,76,-24.203821656050955,55.38461538461539,55.38461538461539,0.0,92.6458157227388,73.96449704142012,18.681318681318686,Client
1308,0,2019-03-22,145080,DANET CHOCOLAT 125GX6 D,0,1,0,DANETTE,0,StJust(FR),0083,0024 FR CHAPONNAY (DC),1891,2366,2192,1750,442,616,174,0,475,-25.118984664198837,145,182,182,0,182,182,0,0,37,-25.517241379310345,100.0,0.0,100.0,92.6458157227388,73.96449704142012,18.681318681318686,Client
1309,0,2019-03-22,145080,DANET CHOCOLAT 125GX6 D,0,1,0,DANETTE,0,StJust(FR),0079,0024 FR PARIS SUD (DC),1891,2366,2192,1750,442,616,174,0,475,-25.118984664198837,209,182,182,182,0,0,0,0,-27,12.91866028708134,100.0,100.0,0.0,92.6458157227388,73.96449704142012,18.681318681318686,Client
1310,0,2019-03-22,145080,DANET CHOCOLAT 125GX6 D,0,1,0,DANETTE,0,StJust(FR),0078,0024 FR PARIS NORD (DC),1891,2366,2192,1750,442,616,174,0,475,-25.118984664198837,273,364,364,364,0,0,0,0,91,-33.333333333333336,100.0,100.0,0.0,92.6458157227388,73.96449704142012,18.681318681318686,Client
1311,1,2019-03-23,433,DANET MOUS CHOC LIEG 80gx4,1,0,0,DANETTE,1,Ochsenfurt(ALL),0083,0024 FR CHAPONNAY (DC),128,960,711,673,38,287,249,0,832,-650.0,128,145,94,56,38,89,51,0,17,-13.28125,64.82758620689654,38.62068965517241,26.206896551724128,74.0625,70.10416666666667,3.9583333333333286,Client
1312,0,2019-03-23,83924,ACTIMEL STRA 3x(14x100g) FR,0,0,0,ACTIMEL,1,Rotselaar(BE),0081,0024 FR TOURS (DC),329,413,74,68,6,345,339,0,84,-25.53191489361702,14,6,6,6,0,0,0,0,-8,57.142857142857146,100.0,100.0,0.0,17.91767554479419,16.46489104116223,1.4527845036319604,Previsions
1313,0,2019-03-23,83924,ACTIMEL STRA 3x(14x100g) FR,0,0,0,ACTIMEL,1,Rotselaar(BE),0082,0024 FR VALLET (DC),329,413,74,68,6,345,339,0,84,-25.53191489361702,23,44,20,20,0,24,24,0,21,-91.30434782608695,45.45454545454545,45.45454545454545,0.0,17.91767554479419,16.46489104116223,1.4527845036319604,Previsions
1314,0,2019-03-23,83924,ACTIMEL STRA 3x(14x100g) FR,0,0,0,ACTIMEL,1,Rotselaar(BE),0077,0024 FR LILPARK (DC),329,413,74,68,6,345,339,0,84,-25.53191489361702,0,65,5,2,3,63,60,1,65,10000.0,7.6923076923076925,3.076923076923077,4.615384615384615,17.91767554479419,16.46489104116223,1.4527845036319604,Previsions
1315,0,2019-03-23,83924,ACTIMEL STRA 3x(14x100g) FR,0,0,0,ACTIMEL,1,Rotselaar(BE),0078,0024 FR PARIS NORD (DC),329,413,74,68,6,345,339,0,84,-25.53191489361702,292,298,43,40,3,258,255,0,6,-2.0547945205479454,14.429530201342283,13.422818791946309,1.0067114093959741,17.91767554479419,16.46489104116223,1.4527845036319604,Previsions
1316,1,2019-03-23,90635,DANET CHOCO 125X6,0,1,0,DANETTE,0,StJust(FR),0083,0024 FR CHAPONNAY (DC),726,2283,2283,2198,85,85,0,0,1557,-214.46280991735537,424,541,541,462,79,79,0,0,117,-27.59433962264151,100.0,85.39741219963032,14.602587800369676,100.0,96.27682873412176,3.7231712658782357,Production
1317,1,2019-03-23,90635,DANET CHOCO 125X6,0,1,0,DANETTE,0,StJust(FR),0078,0024 FR PARIS NORD (DC),726,2283,2283,2198,85,85,0,0,1557,-214.46280991735537,302,325,325,319,6,6,0,0,23,-7.6158940397351,100.0,98.15384615384616,1.8461538461538396,100.0,96.27682873412176,3.7231712658782357,Production
1318,0,2019-03-23,143291,DANET CHOCO 125X4 AFH,1,1,1,DANETTE,0,Bailleul(FR),0082,0024 FR VALLET (DC),41,200,9,8,1,192,191,0,159,-387.8048780487805,10,8,8,8,0,0,0,0,-2,20.0,100.0,100.0,0.0,4.5,4.0,0.5,Previsions
1319,0,2019-03-23,143291,DANET CHOCO 125X4 AFH,1,1,1,DANETTE,0,Bailleul(FR),0078,0024 FR PARIS NORD (DC),41,200,9,8,1,192,191,0,159,-387.8048780487805,31,192,1,0,1,192,191,0,161,-519.3548387096774,0.5208333333333333,0.0,0.5208333333333333,4.5,4.0,0.5,Previsions
1320,0,2019-03-25,81988,GERVITA COCO 100X4,0,0,0,GERVITA,0,Ferrières(FR),0084,0024 FR AIX (DC),399,365,120,73,47,292,245,0,-34,8.521303258145364,64,64,10,5,5,59,54,0,0,0.0,15.625,7.8125,7.8125,32.87671232876712,20.0,12.87671232876712,Production
1321,0,2019-03-25,81988,GERVITA COCO 100X4,0,0,0,GERVITA,0,Ferrières(FR),0080,0024 FR METZ (DC),399,365,120,73,47,292,245,0,-34,8.521303258145364,99,96,18,17,1,79,78,0,-3,3.0303030303030303,18.75,17.708333333333336,1.0416666666666643,32.87671232876712,20.0,12.87671232876712,Production
1322,0,2019-03-25,81988,GERVITA COCO 100X4,0,0,0,GERVITA,0,Ferrières(FR),0082,0024 FR VALLET (DC),399,365,120,73,47,292,245,0,-34,8.521303258145364,39,38,38,0,38,38,0,0,-1,2.5641025641025643,100.0,0.0,100.0,32.87671232876712,20.0,12.87671232876712,Production
1323,0,2019-03-25,81988,GERVITA COCO 100X4,0,0,0,GERVITA,0,Ferrières(FR),0085,0024 FR TOULOUSE (DC),399,365,120,73,47,292,245,0,-34,8.521303258145364,128,96,4,4,0,92,92,0,-32,25.0,4.166666666666666,4.166666666666666,0.0,32.87671232876712,20.0,12.87671232876712,Production
1324,0,2019-03-25,81988,GERVITA COCO 100X4,0,0,0,GERVITA,0,Ferrières(FR),0083,0024 FR CHAPONNAY (DC),399,365,120,73,47,292,245,0,-34,8.521303258145364,69,71,50,47,3,24,21,0,2,-2.898550724637681,70.4225352112676,66.19718309859155,4.225352112676049,32.87671232876712,20.0,12.87671232876712,Production
1325,0,2019-03-25,107076,LES 2 VACHES VANILLA 115X4,0,0,0,LES 2 VACHES,0,LeMolay(FR),0084,0024 FR AIX (DC),4557,4065,3868,3868,0,197,197,0,-492,10.796576695194206,343,339,339,339,0,0,0,0,-4,1.1661807580174928,100.0,100.0,0.0,95.15375153751538,95.15375153751538,0.0,Previsions
1326,0,2019-03-25,107076,LES 2 VACHES VANILLA 115X4,0,0,0,LES 2 VACHES,0,LeMolay(FR),0080,0024 FR METZ (DC),4557,4065,3868,3868,0,197,197,0,-492,10.796576695194206,393,327,327,327,0,0,0,0,-66,16.793893129770993,100.0,100.0,0.0,95.15375153751538,95.15375153751538,0.0,Previsions
1327,0,2019-03-25,107076,LES 2 VACHES VANILLA 115X4,0,0,0,LES 2 VACHES,0,LeMolay(FR),0081,0024 FR TOURS (DC),4557,4065,3868,3868,0,197,197,0,-492,10.796576695194206,431,419,419,419,0,0,0,0,-12,2.7842227378190256,100.0,100.0,0.0,95.15375153751538,95.15375153751538,0.0,Previsions
1328,0,2019-03-25,107076,LES 2 VACHES VANILLA 115X4,0,0,0,LES 2 VACHES,0,LeMolay(FR),0082,0024 FR VALLET (DC),4557,4065,3868,3868,0,197,197,0,-492,10.796576695194206,453,402,402,402,0,0,0,0,-51,11.258278145695364,100.0,100.0,0.0,95.15375153751538,95.15375153751538,0.0,Previsions
1329,0,2019-03-25,107076,LES 2 VACHES VANILLA 115X4,0,0,0,LES 2 VACHES,0,LeMolay(FR),0077,0024 FR LILPARK (DC),4557,4065,3868,3868,0,197,197,0,-492,10.796576695194206,223,141,141,141,0,0,0,0,-82,36.771300448430495,100.0,100.0,0.0,95.15375153751538,95.15375153751538,0.0,Previsions
1330,0,2019-03-25,107076,LES 2 VACHES VANILLA 115X4,0,0,0,LES 2 VACHES,0,LeMolay(FR),0085,0024 FR TOULOUSE (DC),4557,4065,3868,3868,0,197,197,0,-492,10.796576695194206,657,740,740,740,0,0,0,0,83,-12.633181126331811,100.0,100.0,0.0,95.15375153751538,95.15375153751538,0.0,Previsions
1331,0,2019-03-25,107076,LES 2 VACHES VANILLA 115X4,0,0,0,LES 2 VACHES,0,LeMolay(FR),0083,0024 FR CHAPONNAY (DC),4557,4065,3868,3868,0,197,197,0,-492,10.796576695194206,680,595,595,595,0,0,0,0,-85,12.5,100.0,100.0,0.0,95.15375153751538,95.15375153751538,0.0,Previsions
1332,0,2019-03-25,107076,LES 2 VACHES VANILLA 115X4,0,0,0,LES 2 VACHES,0,LeMolay(FR),0079,0024 FR PARIS SUD (DC),4557,4065,3868,3868,0,197,197,0,-492,10.796576695194206,903,536,339,339,0,197,197,0,-367,40.64230343300111,63.24626865671642,63.24626865671642,0.0,95.15375153751538,95.15375153751538,0.0,Previsions
1333,0,2019-03-25,107076,LES 2 VACHES VANILLA 115X4,0,0,0,LES 2 VACHES,0,LeMolay(FR),0078,0024 FR PARIS NORD (DC),4557,4065,3868,3868,0,197,197,0,-492,10.796576695194206,474,566,566,566,0,0,0,0,92,-19.40928270042194,100.0,100.0,0.0,95.15375153751538,95.15375153751538,0.0,Previsions
1334,0,2019-03-25,122177,LES 2 VACHES MYRTILLES 115X4,0,0,0,LES 2 VACHES,0,LeMolay(FR),0084,0024 FR AIX (DC),1928,1799,1370,1370,0,429,429,0,-129,6.690871369294606,151,95,85,85,0,10,10,0,-56,37.086092715231786,89.47368421052632,89.47368421052632,0.0,76.15341856586993,76.15341856586993,0.0,Previsions
1335,0,2019-03-25,122177,LES 2 VACHES MYRTILLES 115X4,0,0,0,LES 2 VACHES,0,LeMolay(FR),0080,0024 FR METZ (DC),1928,1799,1370,1370,0,429,429,0,-129,6.690871369294606,258,239,93,93,0,146,146,0,-19,7.364341085271318,38.912133891213394,38.912133891213394,0.0,76.15341856586993,76.15341856586993,0.0,Previsions
1336,0,2019-03-25,122177,LES 2 VACHES MYRTILLES 115X4,0,0,0,LES 2 VACHES,0,LeMolay(FR),0081,0024 FR TOURS (DC),1928,1799,1370,1370,0,429,429,0,-129,6.690871369294606,229,240,214,214,0,26,26,0,11,-4.8034934497816595,89.16666666666667,89.16666666666667,0.0,76.15341856586993,76.15341856586993,0.0,Previsions
1337,0,2019-03-25,122177,LES 2 VACHES MYRTILLES 115X4,0,0,0,LES 2 VACHES,0,LeMolay(FR),0082,0024 FR VALLET (DC),1928,1799,1370,1370,0,429,429,0,-129,6.690871369294606,197,147,147,147,0,0,0,0,-50,25.380710659898476,100.0,100.0,0.0,76.15341856586993,76.15341856586993,0.0,Previsions
1338,0,2019-03-25,122177,LES 2 VACHES MYRTILLES 115X4,0,0,0,LES 2 VACHES,0,LeMolay(FR),0077,0024 FR LILPARK (DC),1928,1799,1370,1370,0,429,429,0,-129,6.690871369294606,123,103,103,103,0,0,0,0,-20,16.260162601626018,100.0,100.0,0.0,76.15341856586993,76.15341856586993,0.0,Previsions
1339,0,2019-03-25,122177,LES 2 VACHES MYRTILLES 115X4,0,0,0,LES 2 VACHES,0,LeMolay(FR),0085,0024 FR TOULOUSE (DC),1928,1799,1370,1370,0,429,429,0,-129,6.690871369294606,242,251,230,230,0,21,21,0,9,-3.71900826446281,91.63346613545816,91.63346613545816,0.0,76.15341856586993,76.15341856586993,0.0,Previsions
1340,0,2019-03-25,122177,LES 2 VACHES MYRTILLES 115X4,0,0,0,LES 2 VACHES,0,LeMolay(FR),0083,0024 FR CHAPONNAY (DC),1928,1799,1370,1370,0,429,429,0,-129,6.690871369294606,323,272,166,166,0,106,106,0,-51,15.789473684210526,61.029411764705884,61.029411764705884,0.0,76.15341856586993,76.15341856586993,0.0,Previsions
1341,0,2019-03-25,122177,LES 2 VACHES MYRTILLES 115X4,0,0,0,LES 2 VACHES,0,LeMolay(FR),0079,0024 FR PARIS SUD (DC),1928,1799,1370,1370,0,429,429,0,-129,6.690871369294606,209,199,108,108,0,91,91,0,-10,4.784688995215311,54.2713567839196,54.2713567839196,0.0,76.15341856586993,76.15341856586993,0.0,Previsions
1342,0,2019-03-25,122177,LES 2 VACHES MYRTILLES 115X4,0,0,0,LES 2 VACHES,0,LeMolay(FR),0078,0024 FR PARIS NORD (DC),1928,1799,1370,1370,0,429,429,0,-129,6.690871369294606,196,253,224,224,0,29,29,0,57,-29.081632653061224,88.53754940711462,88.53754940711462,0.0,76.15341856586993,76.15341856586993,0.0,Previsions
1343,0,2019-03-25,132659,ACTIVIA SO DELICA THE MENT 125X4,0,0,0,ACTIVIA,0,Bailleul(FR),0084,0024 FR AIX (DC),270,303,168,168,0,135,135,0,33,-12.222222222222221,28,35,35,35,0,0,0,0,7,-25.0,100.0,100.0,0.0,55.44554455445545,55.44554455445545,0.0,Qualité
1344,0,2019-03-25,132659,ACTIVIA SO DELICA THE MENT 125X4,0,0,0,ACTIVIA,0,Bailleul(FR),0080,0024 FR METZ (DC),270,303,168,168,0,135,135,0,33,-12.222222222222221,53,53,20,20,0,33,33,0,0,0.0,37.735849056603776,37.735849056603776,0.0,55.44554455445545,55.44554455445545,0.0,Qualité
1345,0,2019-03-25,132659,ACTIVIA SO DELICA THE MENT 125X4,0,0,0,ACTIVIA,0,Bailleul(FR),0081,0024 FR TOURS (DC),270,303,168,168,0,135,135,0,33,-12.222222222222221,36,42,30,30,0,12,12,0,6,-16.666666666666668,71.42857142857143,71.42857142857143,0.0,55.44554455445545,55.44554455445545,0.0,Qualité
1346,0,2019-03-25,132659,ACTIVIA SO DELICA THE MENT 125X4,0,0,0,ACTIVIA,0,Bailleul(FR),0082,0024 FR VALLET (DC),270,303,168,168,0,135,135,0,33,-12.222222222222221,17,7,7,7,0,0,0,0,-10,58.8235294117647,100.0,100.0,0.0,55.44554455445545,55.44554455445545,0.0,Qualité
1347,0,2019-03-25,132659,ACTIVIA SO DELICA THE MENT 125X4,0,0,0,ACTIVIA,0,Bailleul(FR),0077,0024 FR LILPARK (DC),270,303,168,168,0,135,135,0,33,-12.222222222222221,21,19,19,19,0,0,0,0,-2,9.523809523809524,100.0,100.0,0.0,55.44554455445545,55.44554455445545,0.0,Qualité
1348,0,2019-03-25,132659,ACTIVIA SO DELICA THE MENT 125X4,0,0,0,ACTIVIA,0,Bailleul(FR),0085,0024 FR TOULOUSE (DC),270,303,168,168,0,135,135,0,33,-12.222222222222221,38,53,28,28,0,25,25,0,15,-39.473684210526315,52.83018867924528,52.83018867924528,0.0,55.44554455445545,55.44554455445545,0.0,Qualité
1349,0,2019-03-25,132659,ACTIVIA SO DELICA THE MENT 125X4,0,0,0,ACTIVIA,0,Bailleul(FR),0079,0024 FR PARIS SUD (DC),270,303,168,168,0,135,135,0,33,-12.222222222222221,38,46,5,5,0,41,41,0,8,-21.05263157894737,10.869565217391305,10.869565217391305,0.0,55.44554455445545,55.44554455445545,0.0,Qualité
1350,0,2019-03-25,132659,ACTIVIA SO DELICA THE MENT 125X4,0,0,0,ACTIVIA,0,Bailleul(FR),0078,0024 FR PARIS NORD (DC),270,303,168,168,0,135,135,0,33,-12.222222222222221,39,48,24,24,0,24,24,0,9,-23.076923076923077,50.0,50.0,0.0,55.44554455445545,55.44554455445545,0.0,Qualité
1351,0,2019-03-26,127322,LES 2 VACHES AB VANILLE 266X1,0,0,0,LES 2 VACHES,1,Andros(FR),0084,0024 FR AIX (DC),159,212,212,79,133,133,0,0,53,-33.333333333333336,15,20,20,8,12,12,0,0,5,-33.333333333333336,100.0,40.0,60.0,100.0,37.264150943396224,62.735849056603776,A Creuser
1352,0,2019-03-26,127322,LES 2 VACHES AB VANILLE 266X1,0,0,0,LES 2 VACHES,1,Andros(FR),0080,0024 FR METZ (DC),159,212,212,79,133,133,0,0,53,-33.333333333333336,6,2,2,2,0,0,0,0,-4,66.66666666666667,100.0,100.0,0.0,100.0,37.264150943396224,62.735849056603776,A Creuser
1353,0,2019-03-26,127322,LES 2 VACHES AB VANILLE 266X1,0,0,0,LES 2 VACHES,1,Andros(FR),0081,0024 FR TOURS (DC),159,212,212,79,133,133,0,0,53,-33.333333333333336,11,11,11,2,9,9,0,0,0,0.0,100.0,18.181818181818183,81.81818181818181,100.0,37.264150943396224,62.735849056603776,A Creuser
1354,0,2019-03-26,127322,LES 2 VACHES AB VANILLE 266X1,0,0,0,LES 2 VACHES,1,Andros(FR),0082,0024 FR VALLET (DC),159,212,212,79,133,133,0,0,53,-33.333333333333336,8,8,8,6,2,2,0,0,0,0.0,100.0,75.0,25.0,100.0,37.264150943396224,62.735849056603776,A Creuser
1355,0,2019-03-26,127322,LES 2 VACHES AB VANILLE 266X1,0,0,0,LES 2 VACHES,1,Andros(FR),0077,0024 FR LILPARK (DC),159,212,212,79,133,133,0,0,53,-33.333333333333336,8,20,20,0,20,20,0,0,12,-150.0,100.0,0.0,100.0,100.0,37.264150943396224,62.735849056603776,A Creuser
1356,0,2019-03-26,127322,LES 2 VACHES AB VANILLE 266X1,0,0,0,LES 2 VACHES,1,Andros(FR),0085,0024 FR TOULOUSE (DC),159,212,212,79,133,133,0,0,53,-33.333333333333336,12,15,15,13,2,2,0,0,3,-25.0,100.0,86.66666666666667,13.333333333333329,100.0,37.264150943396224,62.735849056603776,A Creuser
1357,0,2019-03-26,127322,LES 2 VACHES AB VANILLE 266X1,0,0,0,LES 2 VACHES,1,Andros(FR),0083,0024 FR CHAPONNAY (DC),159,212,212,79,133,133,0,0,53,-33.333333333333336,53,58,58,22,36,36,0,0,5,-9.433962264150944,100.0,37.93103448275862,62.06896551724138,100.0,37.264150943396224,62.735849056603776,A Creuser
1358,0,2019-03-26,127322,LES 2 VACHES AB VANILLE 266X1,0,0,0,LES 2 VACHES,1,Andros(FR),0079,0024 FR PARIS SUD (DC),159,212,212,79,133,133,0,0,53,-33.333333333333336,24,38,38,2,36,36,0,0,14,-58.333333333333336,100.0,5.263157894736842,94.73684210526316,100.0,37.264150943396224,62.735849056603776,A Creuser
1359,0,2019-03-26,127322,LES 2 VACHES AB VANILLE 266X1,0,0,0,LES 2 VACHES,1,Andros(FR),0078,0024 FR PARIS NORD (DC),159,212,212,79,133,133,0,0,53,-33.333333333333336,22,40,40,24,16,16,0,0,18,-81.81818181818181,100.0,60.0,40.0,100.0,37.264150943396224,62.735849056603776,A Creuser
1360,0,2019-03-26,135358,TAILLEFINE YELLOW FRUIT 125X8 D,0,0,0,TAILLEFINE,0,Villecomtal(FR),0082,0024 FR VALLET (DC),315,405,405,405,0,0,0,0,90,-28.571428571428573,38,45,45,45,0,0,0,0,7,-18.42105263157895,100.0,100.0,0.0,100.0,100.0,0.0,Previsions
1361,0,2019-03-26,135358,TAILLEFINE YELLOW FRUIT 125X8 D,0,0,0,TAILLEFINE,0,Villecomtal(FR),0077,0024 FR LILPARK (DC),315,405,405,405,0,0,0,0,90,-28.571428571428573,116,225,225,225,0,0,0,0,109,-93.96551724137932,100.0,100.0,0.0,100.0,100.0,0.0,Previsions
1362,0,2019-03-26,135358,TAILLEFINE YELLOW FRUIT 125X8 D,0,0,0,TAILLEFINE,0,Villecomtal(FR),0083,0024 FR CHAPONNAY (DC),315,405,405,405,0,0,0,0,90,-28.571428571428573,161,135,135,135,0,0,0,0,-26,16.149068322981368,100.0,100.0,0.0,100.0,100.0,0.0,Previsions
1363,0,2019-03-27,81988,GERVITA COCO 100X4,0,0,0,GERVITA,0,Ferrières(FR),0084,0024 FR AIX (DC),704,870,770,768,2,102,100,0,166,-23.579545454545453,139,148,148,148,0,0,0,0,9,-6.474820143884892,100.0,100.0,0.0,88.50574712643679,88.27586206896552,0.22988505747126453,Previsions
1364,0,2019-03-27,81988,GERVITA COCO 100X4,0,0,0,GERVITA,0,Ferrières(FR),0080,0024 FR METZ (DC),704,870,770,768,2,102,100,0,166,-23.579545454545453,108,120,120,120,0,0,0,0,12,-11.11111111111111,100.0,100.0,0.0,88.50574712643679,88.27586206896552,0.22988505747126453,Previsions
1365,0,2019-03-27,81988,GERVITA COCO 100X4,0,0,0,GERVITA,0,Ferrières(FR),0081,0024 FR TOURS (DC),704,870,770,768,2,102,100,0,166,-23.579545454545453,55,106,51,49,2,57,55,0,51,-92.72727272727273,48.113207547169814,46.22641509433962,1.8867924528301927,88.50574712643679,88.27586206896552,0.22988505747126453,Previsions
1366,0,2019-03-27,81988,GERVITA COCO 100X4,0,0,0,GERVITA,0,Ferrières(FR),0082,0024 FR VALLET (DC),704,870,770,768,2,102,100,0,166,-23.579545454545453,43,69,69,69,0,0,0,0,26,-60.46511627906977,100.0,100.0,0.0,88.50574712643679,88.27586206896552,0.22988505747126453,Previsions
1367,0,2019-03-27,81988,GERVITA COCO 100X4,0,0,0,GERVITA,0,Ferrières(FR),0085,0024 FR TOULOUSE (DC),704,870,770,768,2,102,100,0,166,-23.579545454545453,133,140,140,140,0,0,0,0,7,-5.2631578947368425,100.0,100.0,0.0,88.50574712643679,88.27586206896552,0.22988505747126453,Previsions
1368,0,2019-03-27,81988,GERVITA COCO 100X4,0,0,0,GERVITA,0,Ferrières(FR),0083,0024 FR CHAPONNAY (DC),704,870,770,768,2,102,100,0,166,-23.579545454545453,79,97,97,97,0,0,0,0,18,-22.78481012658228,100.0,100.0,0.0,88.50574712643679,88.27586206896552,0.22988505747126453,Previsions
1369,0,2019-03-27,81988,GERVITA COCO 100X4,0,0,0,GERVITA,0,Ferrières(FR),0079,0024 FR PARIS SUD (DC),704,870,770,768,2,102,100,0,166,-23.579545454545453,33,88,88,88,0,0,0,0,55,-166.66666666666666,100.0,100.0,0.0,88.50574712643679,88.27586206896552,0.22988505747126453,Previsions
1370,0,2019-03-27,81988,GERVITA COCO 100X4,0,0,0,GERVITA,0,Ferrières(FR),0078,0024 FR PARIS NORD (DC),704,870,770,768,2,102,100,0,166,-23.579545454545453,114,102,57,57,0,45,45,0,-12,10.526315789473685,55.88235294117647,55.88235294117647,0.0,88.50574712643679,88.27586206896552,0.22988505747126453,Previsions
1371,0,2019-03-27,111729,LES 2 VACHES FOND CHOC 125X4,0,0,0,LES 2 VACHES,0,LeMolay(FR),0084,0024 FR AIX (DC),716,837,741,690,51,147,96,0,121,-16.899441340782122,36,47,37,37,0,10,10,0,11,-30.555555555555557,78.72340425531915,78.72340425531915,0.0,88.5304659498208,82.43727598566308,6.093189964157716,Previsions
1372,0,2019-03-27,111729,LES 2 VACHES FOND CHOC 125X4,0,0,0,LES 2 VACHES,0,LeMolay(FR),0080,0024 FR METZ (DC),716,837,741,690,51,147,96,0,121,-16.899441340782122,94,65,65,65,0,0,0,0,-29,30.851063829787233,100.0,100.0,0.0,88.5304659498208,82.43727598566308,6.093189964157716,Previsions
1373,0,2019-03-27,111729,LES 2 VACHES FOND CHOC 125X4,0,0,0,LES 2 VACHES,0,LeMolay(FR),0081,0024 FR TOURS (DC),716,837,741,690,51,147,96,0,121,-16.899441340782122,104,137,130,130,0,7,7,0,33,-31.73076923076923,94.8905109489051,94.8905109489051,0.0,88.5304659498208,82.43727598566308,6.093189964157716,Previsions
1374,0,2019-03-27,111729,LES 2 VACHES FOND CHOC 125X4,0,0,0,LES 2 VACHES,0,LeMolay(FR),0082,0024 FR VALLET (DC),716,837,741,690,51,147,96,0,121,-16.899441340782122,82,79,75,75,0,4,4,0,-3,3.658536585365854,94.9367088607595,94.9367088607595,0.0,88.5304659498208,82.43727598566308,6.093189964157716,Previsions
1375,0,2019-03-27,111729,LES 2 VACHES FOND CHOC 125X4,0,0,0,LES 2 VACHES,0,LeMolay(FR),0077,0024 FR LILPARK (DC),716,837,741,690,51,147,96,0,121,-16.899441340782122,60,56,56,56,0,0,0,0,-4,6.666666666666667,100.0,100.0,0.0,88.5304659498208,82.43727598566308,6.093189964157716,Previsions
1376,0,2019-03-27,111729,LES 2 VACHES FOND CHOC 125X4,0,0,0,LES 2 VACHES,0,LeMolay(FR),0085,0024 FR TOULOUSE (DC),716,837,741,690,51,147,96,0,121,-16.899441340782122,121,130,128,128,0,2,2,0,9,-7.43801652892562,98.46153846153847,98.46153846153847,0.0,88.5304659498208,82.43727598566308,6.093189964157716,Previsions
1377,0,2019-03-27,111729,LES 2 VACHES FOND CHOC 125X4,0,0,0,LES 2 VACHES,0,LeMolay(FR),0083,0024 FR CHAPONNAY (DC),716,837,741,690,51,147,96,0,121,-16.899441340782122,84,115,93,93,0,22,22,0,31,-36.904761904761905,80.8695652173913,80.8695652173913,0.0,88.5304659498208,82.43727598566308,6.093189964157716,Previsions
1378,0,2019-03-27,111729,LES 2 VACHES FOND CHOC 125X4,0,0,0,LES 2 VACHES,0,LeMolay(FR),0079,0024 FR PARIS SUD (DC),716,837,741,690,51,147,96,0,121,-16.899441340782122,83,107,103,103,0,4,4,0,24,-28.91566265060241,96.26168224299066,96.26168224299066,0.0,88.5304659498208,82.43727598566308,6.093189964157716,Previsions
1379,0,2019-03-27,111729,LES 2 VACHES FOND CHOC 125X4,0,0,0,LES 2 VACHES,0,LeMolay(FR),0078,0024 FR PARIS NORD (DC),716,837,741,690,51,147,96,0,121,-16.899441340782122,52,101,54,3,51,98,47,0,49,-94.23076923076923,53.46534653465347,2.9702970297029703,50.4950495049505,88.5304659498208,82.43727598566308,6.093189964157716,Previsions
1380,0,2019-03-27,127762,DANIO 0% MELANGE VANILLE 150X1,0,0,0,DANIO,0,Ferrières(FR),0084,0024 FR AIX (DC),510,517,517,517,0,0,0,0,7,-1.3725490196078431,66,74,74,74,0,0,0,0,8,-12.121212121212121,100.0,100.0,0.0,100.0,100.0,0.0,Production
1381,0,2019-03-27,127762,DANIO 0% MELANGE VANILLE 150X1,0,0,0,DANIO,0,Ferrières(FR),0081,0024 FR TOURS (DC),510,517,517,517,0,0,0,0,7,-1.3725490196078431,61,39,39,39,0,0,0,0,-22,36.0655737704918,100.0,100.0,0.0,100.0,100.0,0.0,Production
1382,0,2019-03-27,127762,DANIO 0% MELANGE VANILLE 150X1,0,0,0,DANIO,0,Ferrières(FR),0082,0024 FR VALLET (DC),510,517,517,517,0,0,0,0,7,-1.3725490196078431,33,46,46,46,0,0,0,0,13,-39.39393939393939,100.0,100.0,0.0,100.0,100.0,0.0,Production
1383,0,2019-03-27,127762,DANIO 0% MELANGE VANILLE 150X1,0,0,0,DANIO,0,Ferrières(FR),0077,0024 FR LILPARK (DC),510,517,517,517,0,0,0,0,7,-1.3725490196078431,33,66,66,66,0,0,0,0,33,-100.0,100.0,100.0,0.0,100.0,100.0,0.0,Production
1384,0,2019-03-27,127762,DANIO 0% MELANGE VANILLE 150X1,0,0,0,DANIO,0,Ferrières(FR),0085,0024 FR TOULOUSE (DC),510,517,517,517,0,0,0,0,7,-1.3725490196078431,46,56,56,56,0,0,0,0,10,-21.73913043478261,100.0,100.0,0.0,100.0,100.0,0.0,Production
1385,0,2019-03-27,127762,DANIO 0% MELANGE VANILLE 150X1,0,0,0,DANIO,0,Ferrières(FR),0083,0024 FR CHAPONNAY (DC),510,517,517,517,0,0,0,0,7,-1.3725490196078431,70,56,56,56,0,0,0,0,-14,20.0,100.0,100.0,0.0,100.0,100.0,0.0,Production
1386,0,2019-03-27,127762,DANIO 0% MELANGE VANILLE 150X1,0,0,0,DANIO,0,Ferrières(FR),0079,0024 FR PARIS SUD (DC),510,517,517,517,0,0,0,0,7,-1.3725490196078431,151,123,123,123,0,0,0,0,-28,18.543046357615893,100.0,100.0,0.0,100.0,100.0,0.0,Production
1387,0,2019-03-27,127762,DANIO 0% MELANGE VANILLE 150X1,0,0,0,DANIO,0,Ferrières(FR),0078,0024 FR PARIS NORD (DC),510,517,517,517,0,0,0,0,7,-1.3725490196078431,50,57,57,57,0,0,0,0,7,-14.0,100.0,100.0,0.0,100.0,100.0,0.0,Production
1388,0,2019-03-27,127910,GERVAIS GRIEGO 115X4 LEMON FR,0,0,0,GERVAIS,1,Rosenheim(ALL),0084,0024 FR AIX (DC),1107,1201,1201,1057,144,144,0,0,94,-8.491418247515808,147,142,142,137,5,5,0,0,-5,3.401360544217687,100.0,96.47887323943662,3.5211267605633765,100.0,88.00999167360533,11.990008326394673,Schéma
1389,0,2019-03-27,127910,GERVAIS GRIEGO 115X4 LEMON FR,0,0,0,GERVAIS,1,Rosenheim(ALL),0080,0024 FR METZ (DC),1107,1201,1201,1057,144,144,0,0,94,-8.491418247515808,138,132,132,132,0,0,0,0,-6,4.3478260869565215,100.0,100.0,0.0,100.0,88.00999167360533,11.990008326394673,Schéma
1390,0,2019-03-27,127910,GERVAIS GRIEGO 115X4 LEMON FR,0,0,0,GERVAIS,1,Rosenheim(ALL),0081,0024 FR TOURS (DC),1107,1201,1201,1057,144,144,0,0,94,-8.491418247515808,167,191,191,169,22,22,0,0,24,-14.37125748502994,100.0,88.48167539267016,11.518324607329845,100.0,88.00999167360533,11.990008326394673,Schéma
1391,0,2019-03-27,127910,GERVAIS GRIEGO 115X4 LEMON FR,0,0,0,GERVAIS,1,Rosenheim(ALL),0082,0024 FR VALLET (DC),1107,1201,1201,1057,144,144,0,0,94,-8.491418247515808,119,135,135,19,116,116,0,0,16,-13.445378151260504,100.0,14.074074074074074,85.92592592592592,100.0,88.00999167360533,11.990008326394673,Schéma
1392,0,2019-03-27,127910,GERVAIS GRIEGO 115X4 LEMON FR,0,0,0,GERVAIS,1,Rosenheim(ALL),0077,0024 FR LILPARK (DC),1107,1201,1201,1057,144,144,0,0,94,-8.491418247515808,28,46,46,46,0,0,0,0,18,-64.28571428571429,100.0,100.0,0.0,100.0,88.00999167360533,11.990008326394673,Schéma
1393,0,2019-03-27,127910,GERVAIS GRIEGO 115X4 LEMON FR,0,0,0,GERVAIS,1,Rosenheim(ALL),0085,0024 FR TOULOUSE (DC),1107,1201,1201,1057,144,144,0,0,94,-8.491418247515808,157,159,159,158,1,1,0,0,2,-1.2738853503184713,100.0,99.37106918238993,0.628930817610069,100.0,88.00999167360533,11.990008326394673,Schéma
1394,0,2019-03-27,127910,GERVAIS GRIEGO 115X4 LEMON FR,0,0,0,GERVAIS,1,Rosenheim(ALL),0083,0024 FR CHAPONNAY (DC),1107,1201,1201,1057,144,144,0,0,94,-8.491418247515808,141,153,153,153,0,0,0,0,12,-8.51063829787234,100.0,100.0,0.0,100.0,88.00999167360533,11.990008326394673,Schéma
1395,0,2019-03-27,127910,GERVAIS GRIEGO 115X4 LEMON FR,0,0,0,GERVAIS,1,Rosenheim(ALL),0079,0024 FR PARIS SUD (DC),1107,1201,1201,1057,144,144,0,0,94,-8.491418247515808,112,132,132,132,0,0,0,0,20,-17.857142857142858,100.0,100.0,0.0,100.0,88.00999167360533,11.990008326394673,Schéma
1396,0,2019-03-27,127910,GERVAIS GRIEGO 115X4 LEMON FR,0,0,0,GERVAIS,1,Rosenheim(ALL),0078,0024 FR PARIS NORD (DC),1107,1201,1201,1057,144,144,0,0,94,-8.491418247515808,98,111,111,111,0,0,0,0,13,-13.26530612244898,100.0,100.0,0.0,100.0,88.00999167360533,11.990008326394673,Schéma
1397,0,2019-03-29,81988,GERVITA COCO 100X4,0,0,0,GERVITA,0,Ferrières(FR),0084,0024 FR AIX (DC),394,552,236,224,12,328,316,0,158,-40.101522842639596,119,157,10,4,6,153,147,0,38,-31.932773109243698,6.369426751592357,2.547770700636943,3.821656050955414,42.7536231884058,40.57971014492754,2.173913043478258,Previsions
1398,0,2019-03-29,81988,GERVITA COCO 100X4,0,0,0,GERVITA,0,Ferrières(FR),0080,0024 FR METZ (DC),394,552,236,224,12,328,316,0,158,-40.101522842639596,49,93,81,81,0,12,12,0,44,-89.79591836734694,87.09677419354838,87.09677419354838,0.0,42.7536231884058,40.57971014492754,2.173913043478258,Previsions
1399,0,2019-03-29,81988,GERVITA COCO 100X4,0,0,0,GERVITA,0,Ferrières(FR),0081,0024 FR TOURS (DC),394,552,236,224,12,328,316,0,158,-40.101522842639596,46,131,43,43,0,88,88,0,85,-184.7826086956522,32.82442748091603,32.82442748091603,0.0,42.7536231884058,40.57971014492754,2.173913043478258,Previsions
1400,0,2019-03-29,81988,GERVITA COCO 100X4,0,0,0,GERVITA,0,Ferrières(FR),0082,0024 FR VALLET (DC),394,552,236,224,12,328,316,0,158,-40.101522842639596,42,29,6,6,0,23,23,0,-13,30.952380952380953,20.689655172413794,20.689655172413794,0.0,42.7536231884058,40.57971014492754,2.173913043478258,Previsions
1401,0,2019-03-29,81988,GERVITA COCO 100X4,0,0,0,GERVITA,0,Ferrières(FR),0085,0024 FR TOULOUSE (DC),394,552,236,224,12,328,316,0,158,-40.101522842639596,82,83,83,83,0,0,0,0,1,-1.2195121951219512,100.0,100.0,0.0,42.7536231884058,40.57971014492754,2.173913043478258,Previsions
1402,0,2019-03-29,81988,GERVITA COCO 100X4,0,0,0,GERVITA,0,Ferrières(FR),0083,0024 FR CHAPONNAY (DC),394,552,236,224,12,328,316,0,158,-40.101522842639596,56,59,13,7,6,52,46,0,3,-5.357142857142857,22.033898305084744,11.864406779661017,10.169491525423727,42.7536231884058,40.57971014492754,2.173913043478258,Previsions
1403,0,2019-03-29,120836,DANONE ARO PANACHE 125X4 AFH,0,0,1,DANONE,0,Bailleul(FR),0084,0024 FR AIX (DC),3306,2796,2557,2494,63,302,239,0,-510,15.426497277676951,472,476,476,476,0,0,0,0,4,-0.847457627118644,100.0,100.0,0.0,91.45207439198856,89.19885550786837,2.2532188841201872,Previsions
1404,0,2019-03-29,120836,DANONE ARO PANACHE 125X4 AFH,0,0,1,DANONE,0,Bailleul(FR),0080,0024 FR METZ (DC),3306,2796,2557,2494,63,302,239,0,-510,15.426497277676951,544,24,24,24,0,0,0,0,-520,95.58823529411765,100.0,100.0,0.0,91.45207439198856,89.19885550786837,2.2532188841201872,Previsions
1405,0,2019-03-29,120836,DANONE ARO PANACHE 125X4 AFH,0,0,1,DANONE,0,Bailleul(FR),0081,0024 FR TOURS (DC),3306,2796,2557,2494,63,302,239,0,-510,15.426497277676951,131,207,35,35,0,172,172,0,76,-58.01526717557252,16.908212560386474,16.908212560386474,0.0,91.45207439198856,89.19885550786837,2.2532188841201872,Previsions
1406,0,2019-03-29,120836,DANONE ARO PANACHE 125X4 AFH,0,0,1,DANONE,0,Bailleul(FR),0082,0024 FR VALLET (DC),3306,2796,2557,2494,63,302,239,0,-510,15.426497277676951,247,289,282,282,0,7,7,0,42,-17.004048582995953,97.57785467128028,97.57785467128028,0.0,91.45207439198856,89.19885550786837,2.2532188841201872,Previsions
1407,0,2019-03-29,120836,DANONE ARO PANACHE 125X4 AFH,0,0,1,DANONE,0,Bailleul(FR),0077,0024 FR LILPARK (DC),3306,2796,2557,2494,63,302,239,0,-510,15.426497277676951,405,243,243,243,0,0,0,0,-162,40.0,100.0,100.0,0.0,91.45207439198856,89.19885550786837,2.2532188841201872,Previsions
1408,0,2019-03-29,120836,DANONE ARO PANACHE 125X4 AFH,0,0,1,DANONE,0,Bailleul(FR),0085,0024 FR TOULOUSE (DC),3306,2796,2557,2494,63,302,239,0,-510,15.426497277676951,440,369,309,309,0,60,60,0,-71,16.136363636363637,83.73983739837398,83.73983739837398,0.0,91.45207439198856,89.19885550786837,2.2532188841201872,Previsions
1409,0,2019-03-29,120836,DANONE ARO PANACHE 125X4 AFH,0,0,1,DANONE,0,Bailleul(FR),0083,0024 FR CHAPONNAY (DC),3306,2796,2557,2494,63,302,239,0,-510,15.426497277676951,342,657,657,594,63,63,0,0,315,-92.10526315789474,100.0,90.41095890410958,9.589041095890423,91.45207439198856,89.19885550786837,2.2532188841201872,Previsions
1410,0,2019-03-29,120836,DANONE ARO PANACHE 125X4 AFH,0,0,1,DANONE,0,Bailleul(FR),0079,0024 FR PARIS SUD (DC),3306,2796,2557,2494,63,302,239,0,-510,15.426497277676951,510,315,315,315,0,0,0,0,-195,38.23529411764706,100.0,100.0,0.0,91.45207439198856,89.19885550786837,2.2532188841201872,Previsions
1411,0,2019-03-29,120836,DANONE ARO PANACHE 125X4 AFH,0,0,1,DANONE,0,Bailleul(FR),0078,0024 FR PARIS NORD (DC),3306,2796,2557,2494,63,302,239,0,-510,15.426497277676951,215,216,216,216,0,0,0,0,1,-0.46511627906976744,100.0,100.0,0.0,91.45207439198856,89.19885550786837,2.2532188841201872,Previsions
1412,0,2019-03-29,120837,DANONE NAT SUCRE 125GX4 AFH,0,0,1,DANONE,0,Bailleul(FR),0084,0024 FR AIX (DC),1925,2454,2098,1989,109,465,356,0,529,-27.48051948051948,213,496,496,496,0,0,0,0,283,-132.8638497652582,100.0,100.0,0.0,85.49307253463732,81.05134474327629,4.441727791361032,Previsions
1413,0,2019-03-29,120837,DANONE NAT SUCRE 125GX4 AFH,0,0,1,DANONE,0,Bailleul(FR),0080,0024 FR METZ (DC),1925,2454,2098,1989,109,465,356,0,529,-27.48051948051948,101,94,94,94,0,0,0,0,-7,6.930693069306931,100.0,100.0,0.0,85.49307253463732,81.05134474327629,4.441727791361032,Previsions
1414,0,2019-03-29,120837,DANONE NAT SUCRE 125GX4 AFH,0,0,1,DANONE,0,Bailleul(FR),0081,0024 FR TOURS (DC),1925,2454,2098,1989,109,465,356,0,529,-27.48051948051948,135,245,245,245,0,0,0,0,110,-81.48148148148148,100.0,100.0,0.0,85.49307253463732,81.05134474327629,4.441727791361032,Previsions
1415,0,2019-03-29,120837,DANONE NAT SUCRE 125GX4 AFH,0,0,1,DANONE,0,Bailleul(FR),0082,0024 FR VALLET (DC),1925,2454,2098,1989,109,465,356,0,529,-27.48051948051948,205,239,216,216,0,23,23,0,34,-16.585365853658537,90.3765690376569,90.3765690376569,0.0,85.49307253463732,81.05134474327629,4.441727791361032,Previsions
1416,0,2019-03-29,120837,DANONE NAT SUCRE 125GX4 AFH,0,0,1,DANONE,0,Bailleul(FR),0077,0024 FR LILPARK (DC),1925,2454,2098,1989,109,465,356,0,529,-27.48051948051948,107,135,135,135,0,0,0,0,28,-26.16822429906542,100.0,100.0,0.0,85.49307253463732,81.05134474327629,4.441727791361032,Previsions
1417,0,2019-03-29,120837,DANONE NAT SUCRE 125GX4 AFH,0,0,1,DANONE,0,Bailleul(FR),0085,0024 FR TOULOUSE (DC),1925,2454,2098,1989,109,465,356,0,529,-27.48051948051948,382,456,226,226,0,230,230,0,74,-19.3717277486911,49.56140350877193,49.56140350877193,0.0,85.49307253463732,81.05134474327629,4.441727791361032,Previsions
1418,0,2019-03-29,120837,DANONE NAT SUCRE 125GX4 AFH,0,0,1,DANONE,0,Bailleul(FR),0083,0024 FR CHAPONNAY (DC),1925,2454,2098,1989,109,465,356,0,529,-27.48051948051948,331,695,592,483,109,212,103,0,364,-109.96978851963746,85.17985611510791,69.49640287769783,15.683453237410077,85.49307253463732,81.05134474327629,4.441727791361032,Previsions
1419,0,2019-03-29,120837,DANONE NAT SUCRE 125GX4 AFH,0,0,1,DANONE,0,Bailleul(FR),0079,0024 FR PARIS SUD (DC),1925,2454,2098,1989,109,465,356,0,529,-27.48051948051948,451,94,94,94,0,0,0,0,-357,79.15742793791574,100.0,100.0,0.0,85.49307253463732,81.05134474327629,4.441727791361032,Previsions
1420,0,2019-03-29,127971,DANET CHOCO 125X4,0,1,0,DANETTE,0,StJust(FR),0084,0024 FR AIX (DC),6217,6263,6192,5879,313,384,71,0,46,-0.739906707415152,741,786,786,786,0,0,0,0,45,-6.0728744939271255,100.0,100.0,0.0,98.86635797541115,93.86875299377296,4.99760498163819,Qualité
1421,0,2019-03-29,127971,DANET CHOCO 125X4,0,1,0,DANETTE,0,StJust(FR),0080,0024 FR METZ (DC),6217,6263,6192,5879,313,384,71,0,46,-0.739906707415152,454,443,434,367,67,76,9,0,-11,2.4229074889867843,97.96839729119638,82.84424379232506,15.124153498871323,98.86635797541115,93.86875299377296,4.99760498163819,Qualité
1422,0,2019-03-29,127971,DANET CHOCO 125X4,0,1,0,DANETTE,0,StJust(FR),0081,0024 FR TOURS (DC),6217,6263,6192,5879,313,384,71,0,46,-0.739906707415152,741,696,696,696,0,0,0,0,-45,6.0728744939271255,100.0,100.0,0.0,98.86635797541115,93.86875299377296,4.99760498163819,Qualité
1423,0,2019-03-29,127971,DANET CHOCO 125X4,0,1,0,DANETTE,0,StJust(FR),0082,0024 FR VALLET (DC),6217,6263,6192,5879,313,384,71,0,46,-0.739906707415152,657,682,682,682,0,0,0,0,25,-3.8051750380517504,100.0,100.0,0.0,98.86635797541115,93.86875299377296,4.99760498163819,Qualité
1424,0,2019-03-29,127971,DANET CHOCO 125X4,0,1,0,DANETTE,0,StJust(FR),0077,0024 FR LILPARK (DC),6217,6263,6192,5879,313,384,71,0,46,-0.739906707415152,312,310,310,310,0,0,0,0,-2,0.6410256410256411,100.0,100.0,0.0,98.86635797541115,93.86875299377296,4.99760498163819,Qualité
1425,0,2019-03-29,127971,DANET CHOCO 125X4,0,1,0,DANETTE,0,StJust(FR),0085,0024 FR TOULOUSE (DC),6217,6263,6192,5879,313,384,71,0,46,-0.739906707415152,694,618,618,618,0,0,0,0,-76,10.951008645533141,100.0,100.0,0.0,98.86635797541115,93.86875299377296,4.99760498163819,Qualité
1426,0,2019-03-29,127971,DANET CHOCO 125X4,0,1,0,DANETTE,0,StJust(FR),0083,0024 FR CHAPONNAY (DC),6217,6263,6192,5879,313,384,71,0,46,-0.739906707415152,1420,1383,1383,1383,0,0,0,0,-37,2.6056338028169015,100.0,100.0,0.0,98.86635797541115,93.86875299377296,4.99760498163819,Qualité
1427,0,2019-03-29,127971,DANET CHOCO 125X4,0,1,0,DANETTE,0,StJust(FR),0079,0024 FR PARIS SUD (DC),6217,6263,6192,5879,313,384,71,0,46,-0.739906707415152,729,864,802,556,246,308,62,0,135,-18.51851851851852,92.82407407407408,64.35185185185185,28.47222222222223,98.86635797541115,93.86875299377296,4.99760498163819,Qualité
1428,0,2019-03-29,127971,DANET CHOCO 125X4,0,1,0,DANETTE,0,StJust(FR),0078,0024 FR PARIS NORD (DC),6217,6263,6192,5879,313,384,71,0,46,-0.739906707415152,469,481,481,481,0,0,0,0,12,-2.55863539445629,100.0,100.0,0.0,98.86635797541115,93.86875299377296,4.99760498163819,Qualité
1429,1,2019-03-29,133131,LIGHT & FREE POIRE VAN 120X4 OD,1,0,0,LIGHT & FREE,0,Ferrières(FR),0080,0024 FR METZ (DC),388,907,842,824,18,83,65,0,519,-133.76288659793815,249,236,236,225,11,11,0,0,-13,5.220883534136546,100.0,95.33898305084746,4.66101694915254,92.8335170893054,90.84895259095921,1.984564498346188,A Creuser
1430,1,2019-03-29,133131,LIGHT & FREE POIRE VAN 120X4 OD,1,0,0,LIGHT & FREE,0,Ferrières(FR),0085,0024 FR TOULOUSE (DC),388,907,842,824,18,83,65,0,519,-133.76288659793815,139,140,75,75,0,65,65,0,1,-0.7194244604316546,53.57142857142857,53.57142857142857,0.0,92.8335170893054,90.84895259095921,1.984564498346188,Qualité
1431,0,2019-03-29,146523,L2V BRASS FRAM 115X4,0,1,0,LES 2 VACHES,0,LeMolay(FR),0084,0024 FR AIX (DC),28,111,111,111,0,0,0,0,83,-296.42857142857144,0,21,21,21,0,0,0,1,21,10000.0,100.0,100.0,0.0,100.0,100.0,0.0,Previsions
1432,0,2019-03-29,146523,L2V BRASS FRAM 115X4,0,1,0,LES 2 VACHES,0,LeMolay(FR),0080,0024 FR METZ (DC),28,111,111,111,0,0,0,0,83,-296.42857142857144,28,14,14,14,0,0,0,0,-14,50.0,100.0,100.0,0.0,100.0,100.0,0.0,Previsions
1433,0,2019-03-29,146523,L2V BRASS FRAM 115X4,0,1,0,LES 2 VACHES,0,LeMolay(FR),0077,0024 FR LILPARK (DC),28,111,111,111,0,0,0,0,83,-296.42857142857144,0,45,45,45,0,0,0,1,45,10000.0,100.0,100.0,0.0,100.0,100.0,0.0,Previsions
1434,0,2019-03-29,146523,L2V BRASS FRAM 115X4,0,1,0,LES 2 VACHES,0,LeMolay(FR),0085,0024 FR TOULOUSE (DC),28,111,111,111,0,0,0,0,83,-296.42857142857144,0,18,18,18,0,0,0,1,18,10000.0,100.0,100.0,0.0,100.0,100.0,0.0,Previsions
1435,0,2019-03-29,146523,L2V BRASS FRAM 115X4,0,1,0,LES 2 VACHES,0,LeMolay(FR),0078,0024 FR PARIS NORD (DC),28,111,111,111,0,0,0,0,83,-296.42857142857144,0,13,13,13,0,0,0,1,13,10000.0,100.0,100.0,0.0,100.0,100.0,0.0,Previsions
1436,0,2019-03-30,81988,GERVITA COCO 100X4,0,0,0,GERVITA,0,Ferrières(FR),0082,0024 FR VALLET (DC),183,115,46,44,2,71,69,0,-68,37.15846994535519,16,17,3,1,2,16,14,0,1,-6.25,17.647058823529413,5.88235294117647,11.764705882352942,40.0,38.26086956521739,1.7391304347826093,Previsions
1437,0,2019-03-30,81988,GERVITA COCO 100X4,0,0,0,GERVITA,0,Ferrières(FR),0085,0024 FR TOULOUSE (DC),183,115,46,44,2,71,69,0,-68,37.15846994535519,130,71,37,37,0,34,34,0,-59,45.38461538461539,52.112676056338024,52.112676056338024,0.0,40.0,38.26086956521739,1.7391304347826093,Previsions
1438,0,2019-03-30,81988,GERVITA COCO 100X4,0,0,0,GERVITA,0,Ferrières(FR),0083,0024 FR CHAPONNAY (DC),183,115,46,44,2,71,69,0,-68,37.15846994535519,37,27,6,6,0,21,21,0,-10,27.027027027027028,22.22222222222222,22.22222222222222,0.0,40.0,38.26086956521739,1.7391304347826093,Previsions
1439,0,2019-03-30,127762,DANIO 0% MELANGE VANILLE 150X1,0,0,0,DANIO,0,Ferrières(FR),0084,0024 FR AIX (DC),412,455,303,293,10,162,152,0,43,-10.436893203883495,41,40,40,40,0,0,0,0,-1,2.4390243902439024,100.0,100.0,0.0,66.59340659340658,64.3956043956044,2.19780219780219,Schéma
1440,0,2019-03-30,127762,DANIO 0% MELANGE VANILLE 150X1,0,0,0,DANIO,0,Ferrières(FR),0081,0024 FR TOURS (DC),412,455,303,293,10,162,152,0,43,-10.436893203883495,23,27,13,10,3,17,14,0,4,-17.391304347826086,48.148148148148145,37.03703703703704,11.111111111111107,66.59340659340658,64.3956043956044,2.19780219780219,Schéma
1441,0,2019-03-30,127762,DANIO 0% MELANGE VANILLE 150X1,0,0,0,DANIO,0,Ferrières(FR),0077,0024 FR LILPARK (DC),412,455,303,293,10,162,152,0,43,-10.436893203883495,42,54,33,32,1,22,21,0,12,-28.571428571428573,61.111111111111114,59.25925925925925,1.8518518518518619,66.59340659340658,64.3956043956044,2.19780219780219,Schéma
1442,0,2019-03-30,127762,DANIO 0% MELANGE VANILLE 150X1,0,0,0,DANIO,0,Ferrières(FR),0085,0024 FR TOULOUSE (DC),412,455,303,293,10,162,152,0,43,-10.436893203883495,53,58,48,48,0,10,10,0,5,-9.433962264150944,82.75862068965517,82.75862068965517,0.0,66.59340659340658,64.3956043956044,2.19780219780219,Schéma
1443,0,2019-03-30,127762,DANIO 0% MELANGE VANILLE 150X1,0,0,0,DANIO,0,Ferrières(FR),0083,0024 FR CHAPONNAY (DC),412,455,303,293,10,162,152,0,43,-10.436893203883495,60,69,16,13,3,56,53,0,9,-15.0,23.18840579710145,18.84057971014493,4.34782608695652,66.59340659340658,64.3956043956044,2.19780219780219,Schéma
1444,0,2019-03-30,127762,DANIO 0% MELANGE VANILLE 150X1,0,0,0,DANIO,0,Ferrières(FR),0079,0024 FR PARIS SUD (DC),412,455,303,293,10,162,152,0,43,-10.436893203883495,138,148,92,91,1,57,56,0,10,-7.246376811594203,62.16216216216216,61.48648648648649,0.6756756756756701,66.59340659340658,64.3956043956044,2.19780219780219,Schéma
1445,0,2019-03-30,127762,DANIO 0% MELANGE VANILLE 150X1,0,0,0,DANIO,0,Ferrières(FR),0078,0024 FR PARIS NORD (DC),412,455,303,293,10,162,152,0,43,-10.436893203883495,55,59,61,59,2,0,-2,0,4,-7.2727272727272725,103.38983050847457,100.0,3.3898305084745743,66.59340659340658,64.3956043956044,2.19780219780219,Schéma
1446,0,2019-03-30,127971,DANET CHOCO 125X4,0,1,0,DANETTE,0,StJust(FR),0084,0024 FR AIX (DC),5384,4529,4405,4267,138,262,124,0,-855,15.88038632986627,654,689,689,689,0,0,0,0,35,-5.351681957186544,100.0,100.0,0.0,97.26208876131597,94.21505851181277,3.0470302495031945,Production
1447,0,2019-03-30,127971,DANET CHOCO 125X4,0,1,0,DANETTE,0,StJust(FR),0080,0024 FR METZ (DC),5384,4529,4405,4267,138,262,124,0,-855,15.88038632986627,291,254,254,128,126,126,0,0,-37,12.714776632302405,100.0,50.39370078740157,49.60629921259843,97.26208876131597,94.21505851181277,3.0470302495031945,Production
1448,0,2019-03-30,127971,DANET CHOCO 125X4,0,1,0,DANETTE,0,StJust(FR),0081,0024 FR TOURS (DC),5384,4529,4405,4267,138,262,124,0,-855,15.88038632986627,515,485,487,485,2,0,-2,0,-30,5.825242718446602,100.41237113402062,100.0,0.4123711340206171,97.26208876131597,94.21505851181277,3.0470302495031945,Production
1449,0,2019-03-30,127971,DANET CHOCO 125X4,0,1,0,DANETTE,0,StJust(FR),0082,0024 FR VALLET (DC),5384,4529,4405,4267,138,262,124,0,-855,15.88038632986627,311,241,241,241,0,0,0,0,-70,22.508038585209004,100.0,100.0,0.0,97.26208876131597,94.21505851181277,3.0470302495031945,Production
1450,0,2019-03-30,127971,DANET CHOCO 125X4,0,1,0,DANETTE,0,StJust(FR),0077,0024 FR LILPARK (DC),5384,4529,4405,4267,138,262,124,0,-855,15.88038632986627,370,424,424,424,0,0,0,0,54,-14.594594594594595,100.0,100.0,0.0,97.26208876131597,94.21505851181277,3.0470302495031945,Production
1451,0,2019-03-30,127971,DANET CHOCO 125X4,0,1,0,DANETTE,0,StJust(FR),0085,0024 FR TOULOUSE (DC),5384,4529,4405,4267,138,262,124,0,-855,15.88038632986627,527,506,506,506,0,0,0,0,-21,3.984819734345351,100.0,100.0,0.0,97.26208876131597,94.21505851181277,3.0470302495031945,Production
1452,0,2019-03-30,127971,DANET CHOCO 125X4,0,1,0,DANETTE,0,StJust(FR),0083,0024 FR CHAPONNAY (DC),5384,4529,4405,4267,138,262,124,0,-855,15.88038632986627,715,638,638,638,0,0,0,0,-77,10.76923076923077,100.0,100.0,0.0,97.26208876131597,94.21505851181277,3.0470302495031945,Production
1453,1,2019-03-30,127971,DANET CHOCO 125X4,0,1,0,DANETTE,0,StJust(FR),0079,0024 FR PARIS SUD (DC),5384,4529,4405,4267,138,262,124,0,-855,15.88038632986627,779,773,637,637,0,136,136,0,-6,0.7702182284980744,82.40620957309184,82.40620957309184,0.0,97.26208876131597,94.21505851181277,3.0470302495031945,Qualité
1454,0,2019-03-30,127971,DANET CHOCO 125X4,0,1,0,DANETTE,0,StJust(FR),0079,0024 FR PARIS SUD (DC),5384,4529,4405,4267,138,262,124,0,-855,15.88038632986627,779,773,637,637,0,136,136,0,-6,0.7702182284980744,82.40620957309184,82.40620957309184,0.0,97.26208876131597,94.21505851181277,3.0470302495031945,Production
1455,0,2019-03-30,127971,DANET CHOCO 125X4,0,1,0,DANETTE,0,StJust(FR),0078,0024 FR PARIS NORD (DC),5384,4529,4405,4267,138,262,124,0,-855,15.88038632986627,443,519,529,519,10,0,-10,0,76,-17.155756207674944,101.92678227360308,100.0,1.9267822736030809,97.26208876131597,94.21505851181277,3.0470302495031945,Production
1456,1,2019-03-30,136436,ACTIVIA FRT CERISE 125X4 OD,1,0,0,ACTIVIA,0,Villecomtal(FR),0081,0024 FR TOURS (DC),65,441,440,418,22,23,1,0,376,-578.4615384615385,65,65,65,51,14,14,0,0,0,0.0,100.0,78.46153846153847,21.538461538461533,99.77324263038548,94.7845804988662,4.988662131519277,A Creuser
1457,0,2019-03-30,141897,DANET LIEG CHOCO 100X8 PC,0,1,0,DANETTE,0,StJust(FR),0084,0024 FR AIX (DC),2113,1420,1321,759,562,661,99,0,-693,32.79697113109323,216,258,258,0,258,258,0,0,42,-19.444444444444443,100.0,0.0,100.0,93.02816901408451,53.450704225352105,39.57746478873241,Production
1458,1,2019-03-30,141897,DANET LIEG CHOCO 100X8 PC,0,1,0,DANETTE,0,StJust(FR),0084,0024 FR AIX (DC),2113,1420,1321,759,562,661,99,0,-693,32.79697113109323,216,258,258,0,258,258,0,0,42,-19.444444444444443,100.0,0.0,100.0,93.02816901408451,53.450704225352105,39.57746478873241,Production
1459,0,2019-03-30,141897,DANET LIEG CHOCO 100X8 PC,0,1,0,DANETTE,0,StJust(FR),0080,0024 FR METZ (DC),2113,1420,1321,759,562,661,99,0,-693,32.79697113109323,18,2,2,2,0,0,0,0,-16,88.88888888888889,100.0,100.0,0.0,93.02816901408451,53.450704225352105,39.57746478873241,Production
1460,0,2019-03-30,141897,DANET LIEG CHOCO 100X8 PC,0,1,0,DANETTE,0,StJust(FR),0081,0024 FR TOURS (DC),2113,1420,1321,759,562,661,99,0,-693,32.79697113109323,89,50,49,49,0,1,1,0,-39,43.82022471910113,98.0,98.0,0.0,93.02816901408451,53.450704225352105,39.57746478873241,Production
1461,0,2019-03-30,141897,DANET LIEG CHOCO 100X8 PC,0,1,0,DANETTE,0,StJust(FR),0082,0024 FR VALLET (DC),2113,1420,1321,759,562,661,99,0,-693,32.79697113109323,212,209,209,42,167,167,0,0,-3,1.4150943396226414,100.0,20.095693779904305,79.90430622009569,93.02816901408451,53.450704225352105,39.57746478873241,Production
1462,1,2019-03-30,141897,DANET LIEG CHOCO 100X8 PC,0,1,0,DANETTE,0,StJust(FR),0082,0024 FR VALLET (DC),2113,1420,1321,759,562,661,99,0,-693,32.79697113109323,212,209,209,42,167,167,0,0,-3,1.4150943396226414,100.0,20.095693779904305,79.90430622009569,93.02816901408451,53.450704225352105,39.57746478873241,Production
1463,0,2019-03-30,141897,DANET LIEG CHOCO 100X8 PC,0,1,0,DANETTE,0,StJust(FR),0077,0024 FR LILPARK (DC),2113,1420,1321,759,562,661,99,0,-693,32.79697113109323,195,178,178,127,51,51,0,0,-17,8.717948717948717,100.0,71.34831460674157,28.651685393258433,93.02816901408451,53.450704225352105,39.57746478873241,Production
1464,0,2019-03-30,141897,DANET LIEG CHOCO 100X8 PC,0,1,0,DANETTE,0,StJust(FR),0085,0024 FR TOULOUSE (DC),2113,1420,1321,759,562,661,99,0,-693,32.79697113109323,153,182,182,167,15,15,0,0,29,-18.954248366013072,100.0,91.75824175824175,8.241758241758248,93.02816901408451,53.450704225352105,39.57746478873241,Production
1465,0,2019-03-30,141897,DANET LIEG CHOCO 100X8 PC,0,1,0,DANETTE,0,StJust(FR),0083,0024 FR CHAPONNAY (DC),2113,1420,1321,759,562,661,99,0,-693,32.79697113109323,229,180,180,180,0,0,0,0,-49,21.397379912663755,100.0,100.0,0.0,93.02816901408451,53.450704225352105,39.57746478873241,Production
1466,0,2019-03-30,141897,DANET LIEG CHOCO 100X8 PC,0,1,0,DANETTE,0,StJust(FR),0079,0024 FR PARIS SUD (DC),2113,1420,1321,759,562,661,99,0,-693,32.79697113109323,227,141,141,135,6,6,0,0,-86,37.88546255506608,100.0,95.74468085106383,4.255319148936167,93.02816901408451,53.450704225352105,39.57746478873241,Production
1467,0,2019-03-30,141897,DANET LIEG CHOCO 100X8 PC,0,1,0,DANETTE,0,StJust(FR),0078,0024 FR PARIS NORD (DC),2113,1420,1321,759,562,661,99,0,-693,32.79697113109323,173,220,122,57,65,163,98,0,47,-27.167630057803468,55.45454545454545,25.90909090909091,29.545454545454543,93.02816901408451,53.450704225352105,39.57746478873241,Production
1468,1,2019-03-30,141897,DANET LIEG CHOCO 100X8 PC,0,1,0,DANETTE,0,StJust(FR),0078,0024 FR PARIS NORD (DC),2113,1420,1321,759,562,661,99,0,-693,32.79697113109323,173,220,122,57,65,163,98,0,47,-27.167630057803468,55.45454545454545,25.90909090909091,29.545454545454543,93.02816901408451,53.450704225352105,39.57746478873241,Production
1469,0,2019-05-13,120163,DANONE FERME NATURE 125X16,0,0,0,DANONE,0,Bailleul(FR),0084,0024 FR AIX (DC),6983,6786,6786,6573,213,213,0,0,-197,2.8211370471144206,642,652,652,652,0,0,0,0,10,-1.557632398753894,100.0,100.0,0.0,100.0,96.86118479221928,3.1388152077807234,Qualité
1470,0,2019-05-13,120163,DANONE FERME NATURE 125X16,0,0,0,DANONE,0,Bailleul(FR),0080,0024 FR METZ (DC),6983,6786,6786,6573,213,213,0,0,-197,2.8211370471144206,681,592,592,592,0,0,0,0,-89,13.069016152716593,100.0,100.0,0.0,100.0,96.86118479221928,3.1388152077807234,Qualité
1471,0,2019-05-13,120163,DANONE FERME NATURE 125X16,0,0,0,DANONE,0,Bailleul(FR),0081,0024 FR TOURS (DC),6983,6786,6786,6573,213,213,0,0,-197,2.8211370471144206,954,831,831,831,0,0,0,0,-123,12.89308176100629,100.0,100.0,0.0,100.0,96.86118479221928,3.1388152077807234,Qualité
1472,0,2019-05-13,120163,DANONE FERME NATURE 125X16,0,0,0,DANONE,0,Bailleul(FR),0082,0024 FR VALLET (DC),6983,6786,6786,6573,213,213,0,0,-197,2.8211370471144206,576,564,564,564,0,0,0,0,-12,2.0833333333333335,100.0,100.0,0.0,100.0,96.86118479221928,3.1388152077807234,Qualité
1473,0,2019-05-13,120163,DANONE FERME NATURE 125X16,0,0,0,DANONE,0,Bailleul(FR),0077,0024 FR LILPARK (DC),6983,6786,6786,6573,213,213,0,0,-197,2.8211370471144206,224,185,185,185,0,0,0,0,-39,17.410714285714285,100.0,100.0,0.0,100.0,96.86118479221928,3.1388152077807234,Qualité
1474,0,2019-05-13,120163,DANONE FERME NATURE 125X16,0,0,0,DANONE,0,Bailleul(FR),0085,0024 FR TOULOUSE (DC),6983,6786,6786,6573,213,213,0,0,-197,2.8211370471144206,774,820,820,820,0,0,0,0,46,-5.943152454780361,100.0,100.0,0.0,100.0,96.86118479221928,3.1388152077807234,Qualité
1475,0,2019-05-13,120163,DANONE FERME NATURE 125X16,0,0,0,DANONE,0,Bailleul(FR),0083,0024 FR CHAPONNAY (DC),6983,6786,6786,6573,213,213,0,0,-197,2.8211370471144206,1387,1534,1534,1534,0,0,0,0,147,-10.598413842826243,100.0,100.0,0.0,100.0,96.86118479221928,3.1388152077807234,Qualité
1476,0,2019-05-13,120163,DANONE FERME NATURE 125X16,0,0,0,DANONE,0,Bailleul(FR),0079,0024 FR PARIS SUD (DC),6983,6786,6786,6573,213,213,0,0,-197,2.8211370471144206,1044,916,916,703,213,213,0,0,-128,12.260536398467433,100.0,76.7467248908297,23.253275109170303,100.0,96.86118479221928,3.1388152077807234,Qualité
1477,0,2019-05-13,120163,DANONE FERME NATURE 125X16,0,0,0,DANONE,0,Bailleul(FR),0078,0024 FR PARIS NORD (DC),6983,6786,6786,6573,213,213,0,0,-197,2.8211370471144206,701,692,692,692,0,0,0,0,-9,1.2838801711840229,100.0,100.0,0.0,100.0,96.86118479221928,3.1388152077807234,Qualité
1478,1,2019-05-13,122529,DANONINO PAIL FT RG PE AB 100X6,0,0,0,DANONINO,0,LeMolay(FR),0077,0024 FR LILPARK (DC),135,1385,1385,1356,29,29,0,0,1250,-925.925925925926,135,146,146,117,29,29,0,0,11,-8.148148148148149,100.0,80.13698630136986,19.86301369863014,100.0,97.90613718411552,2.093862815884478,A Creuser
1479,0,2019-05-13,146531,L2V BRASS NAT 115X4,0,1,0,LES 2 VACHES,0,LeMolay(FR),0084,0024 FR AIX (DC),4053,8589,8204,8103,101,486,385,0,4536,-111.91709844559585,849,1585,1200,1199,1,386,385,0,736,-86.6902237926973,75.70977917981072,75.64668769716089,0.06309148264983833,95.51752241238793,94.34159972057282,1.175922691815117,Production
1480,0,2019-05-13,146531,L2V BRASS NAT 115X4,0,1,0,LES 2 VACHES,0,LeMolay(FR),0080,0024 FR METZ (DC),4053,8589,8204,8103,101,486,385,0,4536,-111.91709844559585,271,824,824,808,16,16,0,0,553,-204.0590405904059,100.0,98.05825242718447,1.9417475728155296,95.51752241238793,94.34159972057282,1.175922691815117,Production
1481,0,2019-05-13,146531,L2V BRASS NAT 115X4,0,1,0,LES 2 VACHES,0,LeMolay(FR),0081,0024 FR TOURS (DC),4053,8589,8204,8103,101,486,385,0,4536,-111.91709844559585,270,854,854,854,0,0,0,0,584,-216.2962962962963,100.0,100.0,0.0,95.51752241238793,94.34159972057282,1.175922691815117,Production
1482,0,2019-05-13,146531,L2V BRASS NAT 115X4,0,1,0,LES 2 VACHES,0,LeMolay(FR),0082,0024 FR VALLET (DC),4053,8589,8204,8103,101,486,385,0,4536,-111.91709844559585,250,527,527,527,0,0,0,0,277,-110.8,100.0,100.0,0.0,95.51752241238793,94.34159972057282,1.175922691815117,Production
1483,0,2019-05-13,146531,L2V BRASS NAT 115X4,0,1,0,LES 2 VACHES,0,LeMolay(FR),0077,0024 FR LILPARK (DC),4053,8589,8204,8103,101,486,385,0,4536,-111.91709844559585,151,440,440,356,84,84,0,0,289,-191.39072847682118,100.0,80.9090909090909,19.090909090909093,95.51752241238793,94.34159972057282,1.175922691815117,Production
1484,0,2019-05-13,146531,L2V BRASS NAT 115X4,0,1,0,LES 2 VACHES,0,LeMolay(FR),0085,0024 FR TOULOUSE (DC),4053,8589,8204,8103,101,486,385,0,4536,-111.91709844559585,339,958,958,958,0,0,0,0,619,-182.59587020648968,100.0,100.0,0.0,95.51752241238793,94.34159972057282,1.175922691815117,Production
1485,0,2019-05-13,146531,L2V BRASS NAT 115X4,0,1,0,LES 2 VACHES,0,LeMolay(FR),0083,0024 FR CHAPONNAY (DC),4053,8589,8204,8103,101,486,385,0,4536,-111.91709844559585,1095,1500,1500,1500,0,0,0,0,405,-36.986301369863014,100.0,100.0,0.0,95.51752241238793,94.34159972057282,1.175922691815117,Production
1486,0,2019-05-13,146531,L2V BRASS NAT 115X4,0,1,0,LES 2 VACHES,0,LeMolay(FR),0079,0024 FR PARIS SUD (DC),4053,8589,8204,8103,101,486,385,0,4536,-111.91709844559585,509,1058,1058,1058,0,0,0,0,549,-107.85854616895874,100.0,100.0,0.0,95.51752241238793,94.34159972057282,1.175922691815117,Production
1487,0,2019-05-13,146531,L2V BRASS NAT 115X4,0,1,0,LES 2 VACHES,0,LeMolay(FR),0078,0024 FR PARIS NORD (DC),4053,8589,8204,8103,101,486,385,0,4536,-111.91709844559585,319,843,843,843,0,0,0,0,524,-164.26332288401255,100.0,100.0,0.0,95.51752241238793,94.34159972057282,1.175922691815117,Production
1488,0,2019-05-13,146534,L2V BRASS CIT 115X4,0,1,0,LES 2 VACHES,0,LeMolay(FR),0084,0024 FR AIX (DC),1734,1482,382,326,56,1156,1100,0,-252,14.53287197231834,102,146,69,68,1,78,77,0,44,-43.13725490196079,47.26027397260274,46.57534246575342,0.6849315068493169,25.775978407557353,21.997300944669366,3.7786774628879876,Production
1489,0,2019-05-13,146534,L2V BRASS CIT 115X4,0,1,0,LES 2 VACHES,0,LeMolay(FR),0080,0024 FR METZ (DC),1734,1482,382,326,56,1156,1100,0,-252,14.53287197231834,301,128,77,77,0,51,51,0,-173,57.475083056478404,60.15625,60.15625,0.0,25.775978407557353,21.997300944669366,3.7786774628879876,Production
1490,0,2019-05-13,146534,L2V BRASS CIT 115X4,0,1,0,LES 2 VACHES,0,LeMolay(FR),0081,0024 FR TOURS (DC),1734,1482,382,326,56,1156,1100,0,-252,14.53287197231834,237,187,34,20,14,167,153,0,-50,21.09704641350211,18.181818181818183,10.695187165775401,7.486631016042782,25.775978407557353,21.997300944669366,3.7786774628879876,Production
1491,0,2019-05-13,146534,L2V BRASS CIT 115X4,0,1,0,LES 2 VACHES,0,LeMolay(FR),0082,0024 FR VALLET (DC),1734,1482,382,326,56,1156,1100,0,-252,14.53287197231834,221,209,28,28,0,181,181,0,-12,5.429864253393665,13.397129186602871,13.397129186602871,0.0,25.775978407557353,21.997300944669366,3.7786774628879876,Production
1492,0,2019-05-13,146534,L2V BRASS CIT 115X4,0,1,0,LES 2 VACHES,0,LeMolay(FR),0085,0024 FR TOULOUSE (DC),1734,1482,382,326,56,1156,1100,0,-252,14.53287197231834,319,189,17,17,0,172,172,0,-130,40.75235109717868,8.994708994708994,8.994708994708994,0.0,25.775978407557353,21.997300944669366,3.7786774628879876,Production
1493,0,2019-05-13,146534,L2V BRASS CIT 115X4,0,1,0,LES 2 VACHES,0,LeMolay(FR),0083,0024 FR CHAPONNAY (DC),1734,1482,382,326,56,1156,1100,0,-252,14.53287197231834,310,281,41,0,41,281,240,0,-29,9.35483870967742,14.590747330960854,0.0,14.590747330960854,25.775978407557353,21.997300944669366,3.7786774628879876,Production
1494,0,2019-05-13,146534,L2V BRASS CIT 115X4,0,1,0,LES 2 VACHES,0,LeMolay(FR),0079,0024 FR PARIS SUD (DC),1734,1482,382,326,56,1156,1100,0,-252,14.53287197231834,138,166,115,115,0,51,51,0,28,-20.28985507246377,69.27710843373494,69.27710843373494,0.0,25.775978407557353,21.997300944669366,3.7786774628879876,Production
1495,0,2019-05-13,146534,L2V BRASS CIT 115X4,0,1,0,LES 2 VACHES,0,LeMolay(FR),0078,0024 FR PARIS NORD (DC),1734,1482,382,326,56,1156,1100,0,-252,14.53287197231834,106,176,1,1,0,175,175,0,70,-66.0377358490566,0.5681818181818182,0.5681818181818182,0.0,25.775978407557353,21.997300944669366,3.7786774628879876,Production
1496,0,2019-05-13,147230,L2V GOURMEUH MARRON VAN 115X2,0,1,0,LES 2 VACHES,0,LeMolay(FR),0081,0024 FR TOURS (DC),39,156,78,71,7,85,78,0,117,-300.0,18,26,2,0,2,26,24,0,8,-44.44444444444444,7.6923076923076925,0.0,7.6923076923076925,50.0,45.51282051282051,4.487179487179489,Previsions
1497,0,2019-05-13,147230,L2V GOURMEUH MARRON VAN 115X2,0,1,0,LES 2 VACHES,0,LeMolay(FR),0083,0024 FR CHAPONNAY (DC),39,156,78,71,7,85,78,0,117,-300.0,10,28,5,0,5,28,23,0,18,-180.0,17.857142857142858,0.0,17.857142857142858,50.0,45.51282051282051,4.487179487179489,Previsions
1498,0,2019-05-13,147230,L2V GOURMEUH MARRON VAN 115X2,0,1,0,LES 2 VACHES,0,LeMolay(FR),0079,0024 FR PARIS SUD (DC),39,156,78,71,7,85,78,0,117,-300.0,11,102,71,71,0,31,31,0,91,-827.2727272727273,69.6078431372549,69.6078431372549,0.0,50.0,45.51282051282051,4.487179487179489,Previsions
1499,0,2019-05-14,105287,DANET MOUS CHOC LIEG 80gx4 Lidl,0,0,0,DANETTE,1,Ochsenfurt(ALL),0084,0024 FR AIX (DC),1092,1080,975,831,144,249,105,0,-12,1.098901098901099,69,120,120,120,0,0,0,0,51,-73.91304347826087,100.0,100.0,0.0,90.27777777777779,76.94444444444444,13.333333333333343,Production
1500,0,2019-05-14,105287,DANET MOUS CHOC LIEG 80gx4 Lidl,0,0,0,DANETTE,1,Ochsenfurt(ALL),0080,0024 FR METZ (DC),1092,1080,975,831,144,249,105,0,-12,1.098901098901099,284,240,240,120,120,120,0,0,-44,15.492957746478874,100.0,50.0,50.0,90.27777777777779,76.94444444444444,13.333333333333343,Production
1501,0,2019-05-14,105287,DANET MOUS CHOC LIEG 80gx4 Lidl,0,0,0,DANETTE,1,Ochsenfurt(ALL),0081,0024 FR TOURS (DC),1092,1080,975,831,144,249,105,0,-12,1.098901098901099,85,120,120,120,0,0,0,0,35,-41.1764705882353,100.0,100.0,0.0,90.27777777777779,76.94444444444444,13.333333333333343,Production
1502,0,2019-05-14,105287,DANET MOUS CHOC LIEG 80gx4 Lidl,0,0,0,DANETTE,1,Ochsenfurt(ALL),0082,0024 FR VALLET (DC),1092,1080,975,831,144,249,105,0,-12,1.098901098901099,35,120,120,120,0,0,0,0,85,-242.85714285714286,100.0,100.0,0.0,90.27777777777779,76.94444444444444,13.333333333333343,Production
1503,0,2019-05-14,105287,DANET MOUS CHOC LIEG 80gx4 Lidl,0,0,0,DANETTE,1,Ochsenfurt(ALL),0085,0024 FR TOULOUSE (DC),1092,1080,975,831,144,249,105,0,-12,1.098901098901099,195,240,240,216,24,24,0,0,45,-23.076923076923077,100.0,90.0,10.0,90.27777777777779,76.94444444444444,13.333333333333343,Production
1504,0,2019-05-14,105287,DANET MOUS CHOC LIEG 80gx4 Lidl,0,0,0,DANETTE,1,Ochsenfurt(ALL),0083,0024 FR CHAPONNAY (DC),1092,1080,975,831,144,249,105,0,-12,1.098901098901099,179,120,120,120,0,0,0,0,-59,32.960893854748605,100.0,100.0,0.0,90.27777777777779,76.94444444444444,13.333333333333343,Production
1505,0,2019-05-14,105287,DANET MOUS CHOC LIEG 80gx4 Lidl,0,0,0,DANETTE,1,Ochsenfurt(ALL),0078,0024 FR PARIS NORD (DC),1092,1080,975,831,144,249,105,0,-12,1.098901098901099,245,120,15,15,0,105,105,0,-125,51.02040816326531,12.5,12.5,0.0,90.27777777777779,76.94444444444444,13.333333333333343,Production
1506,0,2019-05-14,120161,DANONE FERME NATURE 125X4,0,0,0,DANONE,0,Bailleul(FR),0084,0024 FR AIX (DC),8743,8595,8166,8166,0,429,429,0,-148,1.6927827976667047,1437,1302,1302,1302,0,0,0,0,-135,9.394572025052192,100.0,100.0,0.0,95.00872600349041,95.00872600349041,0.0,Qualité
1507,0,2019-05-14,120161,DANONE FERME NATURE 125X4,0,0,0,DANONE,0,Bailleul(FR),0080,0024 FR METZ (DC),8743,8595,8166,8166,0,429,429,0,-148,1.6927827976667047,650,513,513,513,0,0,0,0,-137,21.076923076923077,100.0,100.0,0.0,95.00872600349041,95.00872600349041,0.0,Qualité
1508,0,2019-05-14,120161,DANONE FERME NATURE 125X4,0,0,0,DANONE,0,Bailleul(FR),0081,0024 FR TOURS (DC),8743,8595,8166,8166,0,429,429,0,-148,1.6927827976667047,1599,1892,1463,1463,0,429,429,0,293,-18.323952470293932,77.32558139534885,77.32558139534885,0.0,95.00872600349041,95.00872600349041,0.0,Qualité
1509,0,2019-05-14,120161,DANONE FERME NATURE 125X4,0,0,0,DANONE,0,Bailleul(FR),0082,0024 FR VALLET (DC),8743,8595,8166,8166,0,429,429,0,-148,1.6927827976667047,447,363,363,363,0,0,0,0,-84,18.79194630872483,100.0,100.0,0.0,95.00872600349041,95.00872600349041,0.0,Qualité
1510,0,2019-05-14,120161,DANONE FERME NATURE 125X4,0,0,0,DANONE,0,Bailleul(FR),0077,0024 FR LILPARK (DC),8743,8595,8166,8166,0,429,429,0,-148,1.6927827976667047,491,476,476,476,0,0,0,0,-15,3.054989816700611,100.0,100.0,0.0,95.00872600349041,95.00872600349041,0.0,Qualité
1511,0,2019-05-14,120161,DANONE FERME NATURE 125X4,0,0,0,DANONE,0,Bailleul(FR),0085,0024 FR TOULOUSE (DC),8743,8595,8166,8166,0,429,429,0,-148,1.6927827976667047,787,768,768,768,0,0,0,0,-19,2.4142312579415504,100.0,100.0,0.0,95.00872600349041,95.00872600349041,0.0,Qualité
1512,0,2019-05-14,120161,DANONE FERME NATURE 125X4,0,0,0,DANONE,0,Bailleul(FR),0083,0024 FR CHAPONNAY (DC),8743,8595,8166,8166,0,429,429,0,-148,1.6927827976667047,820,652,652,652,0,0,0,0,-168,20.48780487804878,100.0,100.0,0.0,95.00872600349041,95.00872600349041,0.0,Qualité
1513,0,2019-05-14,120161,DANONE FERME NATURE 125X4,0,0,0,DANONE,0,Bailleul(FR),0079,0024 FR PARIS SUD (DC),8743,8595,8166,8166,0,429,429,0,-148,1.6927827976667047,803,772,772,772,0,0,0,0,-31,3.8605230386052303,100.0,100.0,0.0,95.00872600349041,95.00872600349041,0.0,Qualité
1514,0,2019-05-14,120161,DANONE FERME NATURE 125X4,0,0,0,DANONE,0,Bailleul(FR),0078,0024 FR PARIS NORD (DC),8743,8595,8166,8166,0,429,429,0,-148,1.6927827976667047,1709,1857,1857,1857,0,0,0,0,148,-8.660035108250439,100.0,100.0,0.0,95.00872600349041,95.00872600349041,0.0,Qualité
1515,1,2019-05-14,134010,VELOUTE FRUIX PANACHE 125X16 OD,1,0,0,VELOUTE,0,Villecomtal(FR),0083,0024 FR CHAPONNAY (DC),705,4821,4821,4821,0,0,0,0,4116,-583.8297872340426,705,343,343,343,0,0,0,0,-362,51.347517730496456,100.0,100.0,0.0,100.0,100.0,0.0,Previsions
1516,0,2019-05-14,135066,ACTIVIA SAV VANILLE 125X12 OD,1,0,0,ACTIVIA,0,Bailleul(FR),0080,0024 FR METZ (DC),3184,2566,2566,2367,199,199,0,0,-618,19.40954773869347,422,422,422,422,0,0,0,0,0,0.0,100.0,100.0,0.0,100.0,92.24473889321901,7.755261106780992,A Creuser
1517,0,2019-05-14,135066,ACTIVIA SAV VANILLE 125X12 OD,1,0,0,ACTIVIA,0,Bailleul(FR),0081,0024 FR TOURS (DC),3184,2566,2566,2367,199,199,0,0,-618,19.40954773869347,574,574,574,375,199,199,0,0,0,0.0,100.0,65.33101045296166,34.668989547038336,100.0,92.24473889321901,7.755261106780992,A Creuser
1518,1,2019-05-14,135066,ACTIVIA SAV VANILLE 125X12 OD,1,0,0,ACTIVIA,0,Bailleul(FR),0081,0024 FR TOURS (DC),3184,2566,2566,2367,199,199,0,0,-618,19.40954773869347,574,574,574,375,199,199,0,0,0,0.0,100.0,65.33101045296166,34.668989547038336,100.0,92.24473889321901,7.755261106780992,A Creuser
1519,0,2019-05-14,135066,ACTIVIA SAV VANILLE 125X12 OD,1,0,0,ACTIVIA,0,Bailleul(FR),0082,0024 FR VALLET (DC),3184,2566,2566,2367,199,199,0,0,-618,19.40954773869347,257,257,257,257,0,0,0,0,0,0.0,100.0,100.0,0.0,100.0,92.24473889321901,7.755261106780992,A Creuser
1520,0,2019-05-14,135066,ACTIVIA SAV VANILLE 125X12 OD,1,0,0,ACTIVIA,0,Bailleul(FR),0077,0024 FR LILPARK (DC),3184,2566,2566,2367,199,199,0,0,-618,19.40954773869347,164,164,164,164,0,0,0,0,0,0.0,100.0,100.0,0.0,100.0,92.24473889321901,7.755261106780992,A Creuser
1521,0,2019-05-14,135066,ACTIVIA SAV VANILLE 125X12 OD,1,0,0,ACTIVIA,0,Bailleul(FR),0085,0024 FR TOULOUSE (DC),3184,2566,2566,2367,199,199,0,0,-618,19.40954773869347,162,166,166,166,0,0,0,0,4,-2.4691358024691357,100.0,100.0,0.0,100.0,92.24473889321901,7.755261106780992,A Creuser
1522,0,2019-05-14,135066,ACTIVIA SAV VANILLE 125X12 OD,1,0,0,ACTIVIA,0,Bailleul(FR),0083,0024 FR CHAPONNAY (DC),3184,2566,2566,2367,199,199,0,0,-618,19.40954773869347,447,447,447,447,0,0,0,0,0,0.0,100.0,100.0,0.0,100.0,92.24473889321901,7.755261106780992,A Creuser
1523,0,2019-05-14,135066,ACTIVIA SAV VANILLE 125X12 OD,1,0,0,ACTIVIA,0,Bailleul(FR),0079,0024 FR PARIS SUD (DC),3184,2566,2566,2367,199,199,0,0,-618,19.40954773869347,117,69,69,69,0,0,0,0,-48,41.02564102564103,100.0,100.0,0.0,100.0,92.24473889321901,7.755261106780992,A Creuser
1524,0,2019-05-14,135066,ACTIVIA SAV VANILLE 125X12 OD,1,0,0,ACTIVIA,0,Bailleul(FR),0078,0024 FR PARIS NORD (DC),3184,2566,2566,2367,199,199,0,0,-618,19.40954773869347,467,467,467,467,0,0,0,0,0,0.0,100.0,100.0,0.0,100.0,92.24473889321901,7.755261106780992,A Creuser
1525,1,2019-05-14,136049,ACTIVIA 4X120G(X6) MUESLI  FR PROMO,1,0,0,ACTIVIA,1,Ochsenfurt(ALL),0084,0024 FR AIX (DC),86,389,371,291,80,98,18,0,303,-352.3255813953488,86,78,78,0,78,78,0,0,-8,9.30232558139535,100.0,0.0,100.0,95.37275064267352,74.80719794344472,20.565552699228803,Expe usine
1526,1,2019-05-14,143410,DANET CHOCO LAIT 125X8 PC,0,0,0,DANETTE,0,StJust(FR),0079,0024 FR PARIS SUD (DC),69,634,634,515,119,119,0,0,565,-818.8405797101449,69,115,115,0,115,115,0,0,46,-66.66666666666667,100.0,0.0,100.0,100.0,81.23028391167192,18.76971608832808,A Creuser
1527,0,2019-05-14,146161,LIGHT&FREE SKYR MANG PASS 145X1,0,1,0,LIGHT & FREE,0,Ferrières(FR),0080,0024 FR METZ (DC),55,195,104,46,58,149,91,0,140,-254.54545454545453,11,27,27,27,0,0,0,0,16,-145.45454545454547,100.0,100.0,0.0,53.333333333333336,23.589743589743588,29.743589743589748,Production
1528,0,2019-05-14,146161,LIGHT&FREE SKYR MANG PASS 145X1,0,1,0,LIGHT & FREE,0,Ferrières(FR),0081,0024 FR TOURS (DC),55,195,104,46,58,149,91,0,140,-254.54545454545453,14,17,17,17,0,0,0,0,3,-21.428571428571427,100.0,100.0,0.0,53.333333333333336,23.589743589743588,29.743589743589748,Production
1529,0,2019-05-14,146161,LIGHT&FREE SKYR MANG PASS 145X1,0,1,0,LIGHT & FREE,0,Ferrières(FR),0082,0024 FR VALLET (DC),55,195,104,46,58,149,91,0,140,-254.54545454545453,7,6,2,2,0,4,4,0,-1,14.285714285714286,33.33333333333333,33.33333333333333,0.0,53.333333333333336,23.589743589743588,29.743589743589748,Production
1530,0,2019-05-14,146161,LIGHT&FREE SKYR MANG PASS 145X1,0,1,0,LIGHT & FREE,0,Ferrières(FR),0079,0024 FR PARIS SUD (DC),55,195,104,46,58,149,91,0,140,-254.54545454545453,23,145,58,0,58,145,87,0,122,-530.4347826086956,40.0,0.0,40.0,53.333333333333336,23.589743589743588,29.743589743589748,Production
1531,0,2019-05-15,54518,ACTIVIA 0% NATURE 125X8,0,0,0,ACTIVIA,0,Bailleul(FR),0084,0024 FR AIX (DC),2356,2131,2018,2016,2,115,113,0,-225,9.550084889643463,270,309,309,309,0,0,0,0,39,-14.444444444444445,100.0,100.0,0.0,94.69732519943689,94.60347254809949,0.09385265133740006,Qualité
1532,0,2019-05-15,54518,ACTIVIA 0% NATURE 125X8,0,0,0,ACTIVIA,0,Bailleul(FR),0081,0024 FR TOURS (DC),2356,2131,2018,2016,2,115,113,0,-225,9.550084889643463,261,241,235,233,2,8,6,0,-20,7.662835249042145,97.5103734439834,96.6804979253112,0.8298755186721962,94.69732519943689,94.60347254809949,0.09385265133740006,Qualité
1533,0,2019-05-15,54518,ACTIVIA 0% NATURE 125X8,0,0,0,ACTIVIA,0,Bailleul(FR),0082,0024 FR VALLET (DC),2356,2131,2018,2016,2,115,113,0,-225,9.550084889643463,213,204,97,97,0,107,107,0,-9,4.225352112676056,47.549019607843135,47.549019607843135,0.0,94.69732519943689,94.60347254809949,0.09385265133740006,Qualité
1534,0,2019-05-15,54518,ACTIVIA 0% NATURE 125X8,0,0,0,ACTIVIA,0,Bailleul(FR),0077,0024 FR LILPARK (DC),2356,2131,2018,2016,2,115,113,0,-225,9.550084889643463,127,131,131,131,0,0,0,0,4,-3.1496062992125986,100.0,100.0,0.0,94.69732519943689,94.60347254809949,0.09385265133740006,Qualité
1535,0,2019-05-15,54518,ACTIVIA 0% NATURE 125X8,0,0,0,ACTIVIA,0,Bailleul(FR),0085,0024 FR TOULOUSE (DC),2356,2131,2018,2016,2,115,113,0,-225,9.550084889643463,382,291,291,291,0,0,0,0,-91,23.82198952879581,100.0,100.0,0.0,94.69732519943689,94.60347254809949,0.09385265133740006,Qualité
1536,0,2019-05-15,54518,ACTIVIA 0% NATURE 125X8,0,0,0,ACTIVIA,0,Bailleul(FR),0083,0024 FR CHAPONNAY (DC),2356,2131,2018,2016,2,115,113,0,-225,9.550084889643463,431,323,323,323,0,0,0,0,-108,25.05800464037123,100.0,100.0,0.0,94.69732519943689,94.60347254809949,0.09385265133740006,Qualité
1537,0,2019-05-15,54518,ACTIVIA 0% NATURE 125X8,0,0,0,ACTIVIA,0,Bailleul(FR),0079,0024 FR PARIS SUD (DC),2356,2131,2018,2016,2,115,113,0,-225,9.550084889643463,399,381,381,381,0,0,0,0,-18,4.511278195488722,100.0,100.0,0.0,94.69732519943689,94.60347254809949,0.09385265133740006,Qualité
1538,0,2019-05-15,54518,ACTIVIA 0% NATURE 125X8,0,0,0,ACTIVIA,0,Bailleul(FR),0078,0024 FR PARIS NORD (DC),2356,2131,2018,2016,2,115,113,0,-225,9.550084889643463,273,251,251,251,0,0,0,0,-22,8.058608058608058,100.0,100.0,0.0,94.69732519943689,94.60347254809949,0.09385265133740006,Qualité
1539,1,2019-05-15,59540,DANET MOU LIEG CHOCO 80gx8,0,0,0,DANETTE,1,Ochsenfurt(ALL),0077,0024 FR LILPARK (DC),377,5825,5621,4983,638,842,204,0,5448,-1445.0928381962865,377,516,516,148,368,368,0,0,139,-36.87002652519894,100.0,28.68217054263566,71.31782945736434,96.49785407725322,85.5450643776824,10.952789699570829,A Creuser
1540,0,2019-05-15,113944,ACTIVIA NATURE 125X12,0,0,0,ACTIVIA,0,Bailleul(FR),0084,0024 FR AIX (DC),4159,3676,3202,3202,0,474,474,0,-483,11.613368598220726,484,539,539,539,0,0,0,0,55,-11.363636363636363,100.0,100.0,0.0,87.10554951033733,87.10554951033733,0.0,Déploiement/Quarantaine
1541,0,2019-05-15,113944,ACTIVIA NATURE 125X12,0,0,0,ACTIVIA,0,Bailleul(FR),0081,0024 FR TOURS (DC),4159,3676,3202,3202,0,474,474,0,-483,11.613368598220726,942,648,648,648,0,0,0,0,-294,31.21019108280255,100.0,100.0,0.0,87.10554951033733,87.10554951033733,0.0,Déploiement/Quarantaine
1542,0,2019-05-15,113944,ACTIVIA NATURE 125X12,0,0,0,ACTIVIA,0,Bailleul(FR),0082,0024 FR VALLET (DC),4159,3676,3202,3202,0,474,474,0,-483,11.613368598220726,478,486,187,187,0,299,299,0,8,-1.6736401673640167,38.477366255144034,38.477366255144034,0.0,87.10554951033733,87.10554951033733,0.0,Déploiement/Quarantaine
1543,0,2019-05-15,113944,ACTIVIA NATURE 125X12,0,0,0,ACTIVIA,0,Bailleul(FR),0077,0024 FR LILPARK (DC),4159,3676,3202,3202,0,474,474,0,-483,11.613368598220726,182,190,15,15,0,175,175,0,8,-4.395604395604396,7.894736842105263,7.894736842105263,0.0,87.10554951033733,87.10554951033733,0.0,Déploiement/Quarantaine
1544,0,2019-05-15,113944,ACTIVIA NATURE 125X12,0,0,0,ACTIVIA,0,Bailleul(FR),0085,0024 FR TOULOUSE (DC),4159,3676,3202,3202,0,474,474,0,-483,11.613368598220726,527,453,453,453,0,0,0,0,-74,14.041745730550284,100.0,100.0,0.0,87.10554951033733,87.10554951033733,0.0,Déploiement/Quarantaine
1545,0,2019-05-15,113944,ACTIVIA NATURE 125X12,0,0,0,ACTIVIA,0,Bailleul(FR),0083,0024 FR CHAPONNAY (DC),4159,3676,3202,3202,0,474,474,0,-483,11.613368598220726,1026,990,990,990,0,0,0,0,-36,3.508771929824561,100.0,100.0,0.0,87.10554951033733,87.10554951033733,0.0,Déploiement/Quarantaine
1546,0,2019-05-15,113944,ACTIVIA NATURE 125X12,0,0,0,ACTIVIA,0,Bailleul(FR),0079,0024 FR PARIS SUD (DC),4159,3676,3202,3202,0,474,474,0,-483,11.613368598220726,520,370,370,370,0,0,0,0,-150,28.846153846153847,100.0,100.0,0.0,87.10554951033733,87.10554951033733,0.0,Déploiement/Quarantaine
1547,0,2019-05-15,133904,DANONE BIO NATURE SUCRE 125X4,0,0,0,DANONE,0,Bailleul(FR),0084,0024 FR AIX (DC),477,561,507,504,3,57,54,0,84,-17.61006289308176,38,16,16,16,0,0,0,0,-22,57.89473684210526,100.0,100.0,0.0,90.37433155080214,89.83957219251337,0.5347593582887669,Qualité
1548,0,2019-05-15,133904,DANONE BIO NATURE SUCRE 125X4,0,0,0,DANONE,0,Bailleul(FR),0080,0024 FR METZ (DC),477,561,507,504,3,57,54,0,84,-17.61006289308176,56,230,181,178,3,52,49,0,174,-310.7142857142857,78.69565217391305,77.39130434782608,1.3043478260869676,90.37433155080214,89.83957219251337,0.5347593582887669,Qualité
1549,0,2019-05-15,133904,DANONE BIO NATURE SUCRE 125X4,0,0,0,DANONE,0,Bailleul(FR),0081,0024 FR TOURS (DC),477,561,507,504,3,57,54,0,84,-17.61006289308176,121,75,75,75,0,0,0,0,-46,38.01652892561984,100.0,100.0,0.0,90.37433155080214,89.83957219251337,0.5347593582887669,Qualité
1550,0,2019-05-15,133904,DANONE BIO NATURE SUCRE 125X4,0,0,0,DANONE,0,Bailleul(FR),0082,0024 FR VALLET (DC),477,561,507,504,3,57,54,0,84,-17.61006289308176,62,63,63,63,0,0,0,0,1,-1.6129032258064515,100.0,100.0,0.0,90.37433155080214,89.83957219251337,0.5347593582887669,Qualité
1551,0,2019-05-15,133904,DANONE BIO NATURE SUCRE 125X4,0,0,0,DANONE,0,Bailleul(FR),0077,0024 FR LILPARK (DC),477,561,507,504,3,57,54,0,84,-17.61006289308176,31,35,35,35,0,0,0,0,4,-12.903225806451612,100.0,100.0,0.0,90.37433155080214,89.83957219251337,0.5347593582887669,Qualité
1552,0,2019-05-15,133904,DANONE BIO NATURE SUCRE 125X4,0,0,0,DANONE,0,Bailleul(FR),0085,0024 FR TOULOUSE (DC),477,561,507,504,3,57,54,0,84,-17.61006289308176,50,32,27,27,0,5,5,0,-18,36.0,84.375,84.375,0.0,90.37433155080214,89.83957219251337,0.5347593582887669,Qualité
1553,0,2019-05-15,133904,DANONE BIO NATURE SUCRE 125X4,0,0,0,DANONE,0,Bailleul(FR),0083,0024 FR CHAPONNAY (DC),477,561,507,504,3,57,54,0,84,-17.61006289308176,87,88,88,88,0,0,0,0,1,-1.1494252873563218,100.0,100.0,0.0,90.37433155080214,89.83957219251337,0.5347593582887669,Qualité
1554,0,2019-05-15,133904,DANONE BIO NATURE SUCRE 125X4,0,0,0,DANONE,0,Bailleul(FR),0079,0024 FR PARIS SUD (DC),477,561,507,504,3,57,54,0,84,-17.61006289308176,32,22,22,22,0,0,0,0,-10,31.25,100.0,100.0,0.0,90.37433155080214,89.83957219251337,0.5347593582887669,Qualité
1555,0,2019-05-15,139406,ALPRO SOYA DRINK CHOCO 1LX8,0,0,0,ALPRO,1,Issenheim(FR),0080,0024 FR METZ (DC),42,202,107,69,38,133,95,0,160,-380.95238095238096,15,40,40,40,0,0,0,0,25,-166.66666666666666,100.0,100.0,0.0,52.97029702970298,34.15841584158416,18.811881188118818,Production
1556,0,2019-05-15,139406,ALPRO SOYA DRINK CHOCO 1LX8,0,0,0,ALPRO,1,Issenheim(FR),0081,0024 FR TOURS (DC),42,202,107,69,38,133,95,0,160,-380.95238095238096,6,10,10,10,0,0,0,0,4,-66.66666666666667,100.0,100.0,0.0,52.97029702970298,34.15841584158416,18.811881188118818,Production
1557,0,2019-05-15,139406,ALPRO SOYA DRINK CHOCO 1LX8,0,0,0,ALPRO,1,Issenheim(FR),0085,0024 FR TOULOUSE (DC),42,202,107,69,38,133,95,0,160,-380.95238095238096,14,12,12,12,0,0,0,0,-2,14.285714285714286,100.0,100.0,0.0,52.97029702970298,34.15841584158416,18.811881188118818,Production
1558,0,2019-05-15,139406,ALPRO SOYA DRINK CHOCO 1LX8,0,0,0,ALPRO,1,Issenheim(FR),0083,0024 FR CHAPONNAY (DC),42,202,107,69,38,133,95,0,160,-380.95238095238096,0,1,1,1,0,0,0,1,1,10000.0,100.0,100.0,0.0,52.97029702970298,34.15841584158416,18.811881188118818,Production
1559,0,2019-05-15,139406,ALPRO SOYA DRINK CHOCO 1LX8,0,0,0,ALPRO,1,Issenheim(FR),0079,0024 FR PARIS SUD (DC),42,202,107,69,38,133,95,0,160,-380.95238095238096,5,2,2,2,0,0,0,0,-3,60.0,100.0,100.0,0.0,52.97029702970298,34.15841584158416,18.811881188118818,Production
1560,0,2019-05-15,139406,ALPRO SOYA DRINK CHOCO 1LX8,0,0,0,ALPRO,1,Issenheim(FR),0078,0024 FR PARIS NORD (DC),42,202,107,69,38,133,95,0,160,-380.95238095238096,2,4,4,4,0,0,0,0,2,-100.0,100.0,100.0,0.0,52.97029702970298,34.15841584158416,18.811881188118818,Production
1561,0,2019-05-16,54518,ACTIVIA 0% NATURE 125X8,0,0,0,ACTIVIA,0,Bailleul(FR),0084,0024 FR AIX (DC),2377,2773,2761,2704,57,69,12,0,396,-16.659655027345394,324,277,277,277,0,0,0,0,-47,14.506172839506172,100.0,100.0,0.0,99.5672556797692,97.51172015867292,2.0555355210962887,Qualité
1562,0,2019-05-16,54518,ACTIVIA 0% NATURE 125X8,0,0,0,ACTIVIA,0,Bailleul(FR),0080,0024 FR METZ (DC),2377,2773,2761,2704,57,69,12,0,396,-16.659655027345394,118,156,156,125,31,31,0,0,38,-32.20338983050848,100.0,80.12820512820514,19.87179487179486,99.5672556797692,97.51172015867292,2.0555355210962887,Qualité
1563,0,2019-05-16,54518,ACTIVIA 0% NATURE 125X8,0,0,0,ACTIVIA,0,Bailleul(FR),0081,0024 FR TOURS (DC),2377,2773,2761,2704,57,69,12,0,396,-16.659655027345394,252,227,215,215,0,12,12,0,-25,9.920634920634921,94.7136563876652,94.7136563876652,0.0,99.5672556797692,97.51172015867292,2.0555355210962887,Qualité
1564,0,2019-05-16,54518,ACTIVIA 0% NATURE 125X8,0,0,0,ACTIVIA,0,Bailleul(FR),0082,0024 FR VALLET (DC),2377,2773,2761,2704,57,69,12,0,396,-16.659655027345394,96,112,112,86,26,26,0,0,16,-16.666666666666668,100.0,76.78571428571429,23.214285714285708,99.5672556797692,97.51172015867292,2.0555355210962887,Qualité
1565,0,2019-05-16,54518,ACTIVIA 0% NATURE 125X8,0,0,0,ACTIVIA,0,Bailleul(FR),0077,0024 FR LILPARK (DC),2377,2773,2761,2704,57,69,12,0,396,-16.659655027345394,161,180,180,180,0,0,0,0,19,-11.801242236024844,100.0,100.0,0.0,99.5672556797692,97.51172015867292,2.0555355210962887,Qualité
1566,0,2019-05-16,54518,ACTIVIA 0% NATURE 125X8,0,0,0,ACTIVIA,0,Bailleul(FR),0085,0024 FR TOULOUSE (DC),2377,2773,2761,2704,57,69,12,0,396,-16.659655027345394,319,317,317,317,0,0,0,0,-2,0.6269592476489029,100.0,100.0,0.0,99.5672556797692,97.51172015867292,2.0555355210962887,Qualité
1567,0,2019-05-16,54518,ACTIVIA 0% NATURE 125X8,0,0,0,ACTIVIA,0,Bailleul(FR),0083,0024 FR CHAPONNAY (DC),2377,2773,2761,2704,57,69,12,0,396,-16.659655027345394,305,383,383,383,0,0,0,0,78,-25.57377049180328,100.0,100.0,0.0,99.5672556797692,97.51172015867292,2.0555355210962887,Qualité
1568,0,2019-05-16,54518,ACTIVIA 0% NATURE 125X8,0,0,0,ACTIVIA,0,Bailleul(FR),0079,0024 FR PARIS SUD (DC),2377,2773,2761,2704,57,69,12,0,396,-16.659655027345394,491,685,685,685,0,0,0,0,194,-39.5112016293279,100.0,100.0,0.0,99.5672556797692,97.51172015867292,2.0555355210962887,Qualité
1569,0,2019-05-16,54518,ACTIVIA 0% NATURE 125X8,0,0,0,ACTIVIA,0,Bailleul(FR),0078,0024 FR PARIS NORD (DC),2377,2773,2761,2704,57,69,12,0,396,-16.659655027345394,311,436,436,436,0,0,0,0,125,-40.19292604501608,100.0,100.0,0.0,99.5672556797692,97.51172015867292,2.0555355210962887,Qualité
1570,0,2019-05-16,105287,DANET MOUS CHOC LIEG 80gx4 Lidl,0,0,0,DANETTE,1,Ochsenfurt(ALL),0080,0024 FR METZ (DC),1165,992,784,648,136,344,208,0,-173,14.849785407725323,207,240,32,32,0,208,208,0,33,-15.942028985507246,13.333333333333334,13.333333333333334,0.0,79.03225806451613,65.32258064516128,13.709677419354847,Production
1571,0,2019-05-16,105287,DANET MOUS CHOC LIEG 80gx4 Lidl,0,0,0,DANETTE,1,Ochsenfurt(ALL),0077,0024 FR LILPARK (DC),1165,992,784,648,136,344,208,0,-173,14.849785407725323,169,120,120,120,0,0,0,0,-49,28.994082840236686,100.0,100.0,0.0,79.03225806451613,65.32258064516128,13.709677419354847,Production
1572,0,2019-05-16,105287,DANET MOUS CHOC LIEG 80gx4 Lidl,0,0,0,DANETTE,1,Ochsenfurt(ALL),0085,0024 FR TOULOUSE (DC),1165,992,784,648,136,344,208,0,-173,14.849785407725323,259,120,120,120,0,0,0,0,-139,53.66795366795367,100.0,100.0,0.0,79.03225806451613,65.32258064516128,13.709677419354847,Production
1573,0,2019-05-16,105287,DANET MOUS CHOC LIEG 80gx4 Lidl,0,0,0,DANETTE,1,Ochsenfurt(ALL),0083,0024 FR CHAPONNAY (DC),1165,992,784,648,136,344,208,0,-173,14.849785407725323,222,120,120,120,0,0,0,0,-102,45.945945945945944,100.0,100.0,0.0,79.03225806451613,65.32258064516128,13.709677419354847,Production
1574,0,2019-05-16,105287,DANET MOUS CHOC LIEG 80gx4 Lidl,0,0,0,DANETTE,1,Ochsenfurt(ALL),0079,0024 FR PARIS SUD (DC),1165,992,784,648,136,344,208,0,-173,14.849785407725323,102,272,272,136,136,136,0,0,170,-166.66666666666666,100.0,50.0,50.0,79.03225806451613,65.32258064516128,13.709677419354847,Production
1575,0,2019-05-16,105287,DANET MOUS CHOC LIEG 80gx4 Lidl,0,0,0,DANETTE,1,Ochsenfurt(ALL),0078,0024 FR PARIS NORD (DC),1165,992,784,648,136,344,208,0,-173,14.849785407725323,206,120,120,120,0,0,0,0,-86,41.74757281553398,100.0,100.0,0.0,79.03225806451613,65.32258064516128,13.709677419354847,Production
1576,0,2019-05-16,113944,ACTIVIA NATURE 125X12,0,0,0,ACTIVIA,0,Bailleul(FR),0084,0024 FR AIX (DC),5093,5169,5169,5078,91,91,0,0,76,-1.4922442568230905,414,509,509,509,0,0,0,0,95,-22.946859903381643,100.0,100.0,0.0,100.0,98.23950473979494,1.7604952602050616,Déploiement/Quarantaine
1577,0,2019-05-16,113944,ACTIVIA NATURE 125X12,0,0,0,ACTIVIA,0,Bailleul(FR),0080,0024 FR METZ (DC),5093,5169,5169,5078,91,91,0,0,76,-1.4922442568230905,372,362,362,331,31,31,0,0,-10,2.6881720430107525,100.0,91.4364640883978,8.563535911602202,100.0,98.23950473979494,1.7604952602050616,Déploiement/Quarantaine
1578,0,2019-05-16,113944,ACTIVIA NATURE 125X12,0,0,0,ACTIVIA,0,Bailleul(FR),0081,0024 FR TOURS (DC),5093,5169,5169,5078,91,91,0,0,76,-1.4922442568230905,940,544,544,544,0,0,0,0,-396,42.12765957446808,100.0,100.0,0.0,100.0,98.23950473979494,1.7604952602050616,Déploiement/Quarantaine
1579,0,2019-05-16,113944,ACTIVIA NATURE 125X12,0,0,0,ACTIVIA,0,Bailleul(FR),0082,0024 FR VALLET (DC),5093,5169,5169,5078,91,91,0,0,76,-1.4922442568230905,357,353,353,293,60,60,0,0,-4,1.1204481792717087,100.0,83.0028328611898,16.997167138810198,100.0,98.23950473979494,1.7604952602050616,Déploiement/Quarantaine
1580,0,2019-05-16,113944,ACTIVIA NATURE 125X12,0,0,0,ACTIVIA,0,Bailleul(FR),0077,0024 FR LILPARK (DC),5093,5169,5169,5078,91,91,0,0,76,-1.4922442568230905,313,294,294,294,0,0,0,0,-19,6.0702875399361025,100.0,100.0,0.0,100.0,98.23950473979494,1.7604952602050616,Déploiement/Quarantaine
1581,0,2019-05-16,113944,ACTIVIA NATURE 125X12,0,0,0,ACTIVIA,0,Bailleul(FR),0085,0024 FR TOULOUSE (DC),5093,5169,5169,5078,91,91,0,0,76,-1.4922442568230905,670,752,752,752,0,0,0,0,82,-12.238805970149254,100.0,100.0,0.0,100.0,98.23950473979494,1.7604952602050616,Déploiement/Quarantaine
1582,0,2019-05-16,113944,ACTIVIA NATURE 125X12,0,0,0,ACTIVIA,0,Bailleul(FR),0083,0024 FR CHAPONNAY (DC),5093,5169,5169,5078,91,91,0,0,76,-1.4922442568230905,859,1010,1010,1010,0,0,0,0,151,-17.57857974388824,100.0,100.0,0.0,100.0,98.23950473979494,1.7604952602050616,Déploiement/Quarantaine
1583,0,2019-05-16,113944,ACTIVIA NATURE 125X12,0,0,0,ACTIVIA,0,Bailleul(FR),0079,0024 FR PARIS SUD (DC),5093,5169,5169,5078,91,91,0,0,76,-1.4922442568230905,689,654,654,654,0,0,0,0,-35,5.079825834542816,100.0,100.0,0.0,100.0,98.23950473979494,1.7604952602050616,Déploiement/Quarantaine
1584,0,2019-05-16,113944,ACTIVIA NATURE 125X12,0,0,0,ACTIVIA,0,Bailleul(FR),0078,0024 FR PARIS NORD (DC),5093,5169,5169,5078,91,91,0,0,76,-1.4922442568230905,479,691,691,691,0,0,0,0,212,-44.258872651356995,100.0,100.0,0.0,100.0,98.23950473979494,1.7604952602050616,Déploiement/Quarantaine
1585,1,2019-05-16,143412,DANET CHOCO NOISET 125X8 PC,0,0,0,DANETTE,0,StJust(FR),0079,0024 FR PARIS SUD (DC),55,371,371,324,47,47,0,0,316,-574.5454545454545,55,68,68,21,47,47,0,0,13,-23.636363636363637,100.0,30.88235294117647,69.11764705882354,100.0,87.33153638814017,12.668463611859835,A Creuser
1586,0,2019-05-17,61398,JOCKEY STRACCIATELLA 120X4,0,0,0,JOCKEY,0,Ferrières(FR),0084,0024 FR AIX (DC),5711,5306,4760,4760,0,546,546,0,-405,7.091577657152863,690,719,719,719,0,0,0,0,29,-4.202898550724638,100.0,100.0,0.0,89.70976253298153,89.70976253298153,0.0,Qualité
1587,0,2019-05-17,61398,JOCKEY STRACCIATELLA 120X4,0,0,0,JOCKEY,0,Ferrières(FR),0080,0024 FR METZ (DC),5711,5306,4760,4760,0,546,546,0,-405,7.091577657152863,455,312,312,312,0,0,0,0,-143,31.428571428571427,100.0,100.0,0.0,89.70976253298153,89.70976253298153,0.0,Qualité
1588,0,2019-05-17,61398,JOCKEY STRACCIATELLA 120X4,0,0,0,JOCKEY,0,Ferrières(FR),0081,0024 FR TOURS (DC),5711,5306,4760,4760,0,546,546,0,-405,7.091577657152863,744,629,83,83,0,546,546,0,-115,15.456989247311828,13.195548489666137,13.195548489666137,0.0,89.70976253298153,89.70976253298153,0.0,Qualité
1589,0,2019-05-17,61398,JOCKEY STRACCIATELLA 120X4,0,0,0,JOCKEY,0,Ferrières(FR),0082,0024 FR VALLET (DC),5711,5306,4760,4760,0,546,546,0,-405,7.091577657152863,580,519,519,519,0,0,0,0,-61,10.517241379310345,100.0,100.0,0.0,89.70976253298153,89.70976253298153,0.0,Qualité
1590,0,2019-05-17,61398,JOCKEY STRACCIATELLA 120X4,0,0,0,JOCKEY,0,Ferrières(FR),0077,0024 FR LILPARK (DC),5711,5306,4760,4760,0,546,546,0,-405,7.091577657152863,505,533,533,533,0,0,0,0,28,-5.544554455445544,100.0,100.0,0.0,89.70976253298153,89.70976253298153,0.0,Qualité
1591,0,2019-05-17,61398,JOCKEY STRACCIATELLA 120X4,0,0,0,JOCKEY,0,Ferrières(FR),0085,0024 FR TOULOUSE (DC),5711,5306,4760,4760,0,546,546,0,-405,7.091577657152863,614,590,590,590,0,0,0,0,-24,3.9087947882736156,100.0,100.0,0.0,89.70976253298153,89.70976253298153,0.0,Qualité
1592,0,2019-05-17,61398,JOCKEY STRACCIATELLA 120X4,0,0,0,JOCKEY,0,Ferrières(FR),0083,0024 FR CHAPONNAY (DC),5711,5306,4760,4760,0,546,546,0,-405,7.091577657152863,753,643,643,643,0,0,0,0,-110,14.608233731739707,100.0,100.0,0.0,89.70976253298153,89.70976253298153,0.0,Qualité
1593,0,2019-05-17,61398,JOCKEY STRACCIATELLA 120X4,0,0,0,JOCKEY,0,Ferrières(FR),0079,0024 FR PARIS SUD (DC),5711,5306,4760,4760,0,546,546,0,-405,7.091577657152863,769,801,801,801,0,0,0,0,32,-4.161248374512354,100.0,100.0,0.0,89.70976253298153,89.70976253298153,0.0,Qualité
1594,0,2019-05-17,61398,JOCKEY STRACCIATELLA 120X4,0,0,0,JOCKEY,0,Ferrières(FR),0078,0024 FR PARIS NORD (DC),5711,5306,4760,4760,0,546,546,0,-405,7.091577657152863,601,560,560,560,0,0,0,0,-41,6.821963394342762,100.0,100.0,0.0,89.70976253298153,89.70976253298153,0.0,Qualité
1595,0,2019-05-17,106828,TAILLEFINE FROMAGE NAT 100X8,0,0,0,TAILLEFINE,0,Ferrières(FR),0084,0024 FR AIX (DC),2304,2196,2141,1404,737,792,55,0,-108,4.6875,276,371,371,265,106,106,0,0,95,-34.42028985507246,100.0,71.42857142857143,28.57142857142857,97.49544626593807,63.934426229508205,33.561020036429866,Qualité
1596,0,2019-05-17,106828,TAILLEFINE FROMAGE NAT 100X8,0,0,0,TAILLEFINE,0,Ferrières(FR),0080,0024 FR METZ (DC),2304,2196,2141,1404,737,792,55,0,-108,4.6875,156,139,139,139,0,0,0,0,-17,10.897435897435898,100.0,100.0,0.0,97.49544626593807,63.934426229508205,33.561020036429866,Qualité
1597,0,2019-05-17,106828,TAILLEFINE FROMAGE NAT 100X8,0,0,0,TAILLEFINE,0,Ferrières(FR),0081,0024 FR TOURS (DC),2304,2196,2141,1404,737,792,55,0,-108,4.6875,338,295,295,248,47,47,0,0,-43,12.721893491124261,100.0,84.06779661016948,15.93220338983052,97.49544626593807,63.934426229508205,33.561020036429866,Qualité
1598,0,2019-05-17,106828,TAILLEFINE FROMAGE NAT 100X8,0,0,0,TAILLEFINE,0,Ferrières(FR),0082,0024 FR VALLET (DC),2304,2196,2141,1404,737,792,55,0,-108,4.6875,178,190,190,37,153,153,0,0,12,-6.741573033707865,100.0,19.473684210526315,80.52631578947368,97.49544626593807,63.934426229508205,33.561020036429866,Qualité
1599,0,2019-05-17,106828,TAILLEFINE FROMAGE NAT 100X8,0,0,0,TAILLEFINE,0,Ferrières(FR),0077,0024 FR LILPARK (DC),2304,2196,2141,1404,737,792,55,0,-108,4.6875,183,194,194,100,94,94,0,0,11,-6.0109289617486334,100.0,51.546391752577314,48.453608247422686,97.49544626593807,63.934426229508205,33.561020036429866,Qualité
1600,0,2019-05-17,106828,TAILLEFINE FROMAGE NAT 100X8,0,0,0,TAILLEFINE,0,Ferrières(FR),0085,0024 FR TOULOUSE (DC),2304,2196,2141,1404,737,792,55,0,-108,4.6875,272,196,196,182,14,14,0,0,-76,27.941176470588236,100.0,92.85714285714286,7.142857142857139,97.49544626593807,63.934426229508205,33.561020036429866,Qualité
1601,0,2019-05-17,106828,TAILLEFINE FROMAGE NAT 100X8,0,0,0,TAILLEFINE,0,Ferrières(FR),0083,0024 FR CHAPONNAY (DC),2304,2196,2141,1404,737,792,55,0,-108,4.6875,249,218,218,144,74,74,0,0,-31,12.449799196787149,100.0,66.05504587155964,33.94495412844036,97.49544626593807,63.934426229508205,33.561020036429866,Qualité
1602,0,2019-05-17,106828,TAILLEFINE FROMAGE NAT 100X8,0,0,0,TAILLEFINE,0,Ferrières(FR),0079,0024 FR PARIS SUD (DC),2304,2196,2141,1404,737,792,55,0,-108,4.6875,344,363,308,111,197,252,55,0,19,-5.523255813953488,84.84848484848484,30.57851239669421,54.269972451790636,97.49544626593807,63.934426229508205,33.561020036429866,Qualité
1603,0,2019-05-17,106828,TAILLEFINE FROMAGE NAT 100X8,0,0,0,TAILLEFINE,0,Ferrières(FR),0078,0024 FR PARIS NORD (DC),2304,2196,2141,1404,737,792,55,0,-108,4.6875,308,230,230,178,52,52,0,0,-78,25.324675324675326,100.0,77.39130434782608,22.60869565217392,97.49544626593807,63.934426229508205,33.561020036429866,Qualité
1604,0,2019-05-17,122529,DANONINO PAIL FT RG PE AB 100X6,0,0,0,DANONINO,0,LeMolay(FR),0084,0024 FR AIX (DC),1095,1309,1251,1106,145,203,58,0,214,-19.54337899543379,144,225,192,192,0,33,33,0,81,-56.25,85.33333333333334,85.33333333333334,0.0,95.56913674560732,84.49197860962568,11.077158135981648,Previsions
1605,0,2019-05-17,122529,DANONINO PAIL FT RG PE AB 100X6,0,0,0,DANONINO,0,LeMolay(FR),0080,0024 FR METZ (DC),1095,1309,1251,1106,145,203,58,0,214,-19.54337899543379,82,63,63,63,0,0,0,0,-19,23.170731707317074,100.0,100.0,0.0,95.56913674560732,84.49197860962568,11.077158135981648,Previsions
1606,0,2019-05-17,122529,DANONINO PAIL FT RG PE AB 100X6,0,0,0,DANONINO,0,LeMolay(FR),0081,0024 FR TOURS (DC),1095,1309,1251,1106,145,203,58,0,214,-19.54337899543379,111,105,105,105,0,0,0,0,-6,5.405405405405405,100.0,100.0,0.0,95.56913674560732,84.49197860962568,11.077158135981648,Previsions
1607,0,2019-05-17,122529,DANONINO PAIL FT RG PE AB 100X6,0,0,0,DANONINO,0,LeMolay(FR),0082,0024 FR VALLET (DC),1095,1309,1251,1106,145,203,58,0,214,-19.54337899543379,65,53,53,53,0,0,0,0,-12,18.46153846153846,100.0,100.0,0.0,95.56913674560732,84.49197860962568,11.077158135981648,Previsions
1608,0,2019-05-17,122529,DANONINO PAIL FT RG PE AB 100X6,0,0,0,DANONINO,0,LeMolay(FR),0077,0024 FR LILPARK (DC),1095,1309,1251,1106,145,203,58,0,214,-19.54337899543379,105,144,144,0,144,144,0,0,39,-37.142857142857146,100.0,0.0,100.0,95.56913674560732,84.49197860962568,11.077158135981648,Previsions
1609,0,2019-05-17,122529,DANONINO PAIL FT RG PE AB 100X6,0,0,0,DANONINO,0,LeMolay(FR),0085,0024 FR TOULOUSE (DC),1095,1309,1251,1106,145,203,58,0,214,-19.54337899543379,106,149,124,123,1,26,25,0,43,-40.56603773584906,83.22147651006712,82.5503355704698,0.671140939597322,95.56913674560732,84.49197860962568,11.077158135981648,Previsions
1610,0,2019-05-17,122529,DANONINO PAIL FT RG PE AB 100X6,0,0,0,DANONINO,0,LeMolay(FR),0083,0024 FR CHAPONNAY (DC),1095,1309,1251,1106,145,203,58,0,214,-19.54337899543379,175,161,161,161,0,0,0,0,-14,8.0,100.0,100.0,0.0,95.56913674560732,84.49197860962568,11.077158135981648,Previsions
1611,0,2019-05-17,122529,DANONINO PAIL FT RG PE AB 100X6,0,0,0,DANONINO,0,LeMolay(FR),0079,0024 FR PARIS SUD (DC),1095,1309,1251,1106,145,203,58,0,214,-19.54337899543379,197,275,275,275,0,0,0,0,78,-39.59390862944162,100.0,100.0,0.0,95.56913674560732,84.49197860962568,11.077158135981648,Previsions
1612,0,2019-05-17,122529,DANONINO PAIL FT RG PE AB 100X6,0,0,0,DANONINO,0,LeMolay(FR),0078,0024 FR PARIS NORD (DC),1095,1309,1251,1106,145,203,58,0,214,-19.54337899543379,110,134,134,134,0,0,0,0,24,-21.818181818181817,100.0,100.0,0.0,95.56913674560732,84.49197860962568,11.077158135981648,Previsions
1613,1,2019-05-17,131422,ACTIVIA ANA RHU FIG PRU 125X8 OD,1,0,0,ACTIVIA,0,Villecomtal(FR),0082,0024 FR VALLET (DC),26,297,297,271,26,26,0,0,271,-1042.3076923076924,26,26,26,0,26,26,0,0,0,0.0,100.0,0.0,100.0,100.0,91.24579124579124,8.754208754208761,Déploiement/Quarantaine
1614,1,2019-05-17,137696,DANET CHOC POIRE ECLAT CHO 115X2,0,0,0,DANETTE,0,StJust(FR),0079,0024 FR PARIS SUD (DC),154,855,855,814,41,41,0,0,701,-455.1948051948052,154,106,106,65,41,41,0,0,-48,31.16883116883117,100.0,61.32075471698113,38.67924528301887,100.0,95.2046783625731,4.795321637426895,Déploiement/Quarantaine
1615,0,2019-05-17,146376,L2V BRASS VAN 115X4,0,1,0,LES 2 VACHES,0,LeMolay(FR),0084,0024 FR AIX (DC),5770,5824,5647,5647,0,177,177,0,54,-0.9358752166377816,547,537,537,537,0,0,0,0,-10,1.8281535648994516,100.0,100.0,0.0,96.96085164835165,96.96085164835165,0.0,Production
1616,0,2019-05-17,146376,L2V BRASS VAN 115X4,0,1,0,LES 2 VACHES,0,LeMolay(FR),0080,0024 FR METZ (DC),5770,5824,5647,5647,0,177,177,0,54,-0.9358752166377816,298,363,363,363,0,0,0,0,65,-21.812080536912752,100.0,100.0,0.0,96.96085164835165,96.96085164835165,0.0,Production
1617,0,2019-05-17,146376,L2V BRASS VAN 115X4,0,1,0,LES 2 VACHES,0,LeMolay(FR),0081,0024 FR TOURS (DC),5770,5824,5647,5647,0,177,177,0,54,-0.9358752166377816,838,643,643,643,0,0,0,0,-195,23.269689737470166,100.0,100.0,0.0,96.96085164835165,96.96085164835165,0.0,Production
1618,0,2019-05-17,146376,L2V BRASS VAN 115X4,0,1,0,LES 2 VACHES,0,LeMolay(FR),0082,0024 FR VALLET (DC),5770,5824,5647,5647,0,177,177,0,54,-0.9358752166377816,629,615,615,615,0,0,0,0,-14,2.2257551669316373,100.0,100.0,0.0,96.96085164835165,96.96085164835165,0.0,Production
1619,0,2019-05-17,146376,L2V BRASS VAN 115X4,0,1,0,LES 2 VACHES,0,LeMolay(FR),0077,0024 FR LILPARK (DC),5770,5824,5647,5647,0,177,177,0,54,-0.9358752166377816,285,465,343,343,0,122,122,0,180,-63.1578947368421,73.76344086021506,73.76344086021506,0.0,96.96085164835165,96.96085164835165,0.0,Production
1620,0,2019-05-17,146376,L2V BRASS VAN 115X4,0,1,0,LES 2 VACHES,0,LeMolay(FR),0085,0024 FR TOULOUSE (DC),5770,5824,5647,5647,0,177,177,0,54,-0.9358752166377816,775,725,725,725,0,0,0,0,-50,6.451612903225806,100.0,100.0,0.0,96.96085164835165,96.96085164835165,0.0,Production
1621,0,2019-05-17,146376,L2V BRASS VAN 115X4,0,1,0,LES 2 VACHES,0,LeMolay(FR),0083,0024 FR CHAPONNAY (DC),5770,5824,5647,5647,0,177,177,0,54,-0.9358752166377816,742,727,727,727,0,0,0,0,-15,2.0215633423180592,100.0,100.0,0.0,96.96085164835165,96.96085164835165,0.0,Production
1622,0,2019-05-17,146376,L2V BRASS VAN 115X4,0,1,0,LES 2 VACHES,0,LeMolay(FR),0079,0024 FR PARIS SUD (DC),5770,5824,5647,5647,0,177,177,0,54,-0.9358752166377816,1116,935,880,880,0,55,55,0,-181,16.218637992831543,94.11764705882352,94.11764705882352,0.0,96.96085164835165,96.96085164835165,0.0,Production
1623,0,2019-05-17,146376,L2V BRASS VAN 115X4,0,1,0,LES 2 VACHES,0,LeMolay(FR),0078,0024 FR PARIS NORD (DC),5770,5824,5647,5647,0,177,177,0,54,-0.9358752166377816,540,814,814,814,0,0,0,0,274,-50.74074074074074,100.0,100.0,0.0,96.96085164835165,96.96085164835165,0.0,Production
1624,0,2019-05-17,146531,L2V BRASS NAT 115X4,0,1,0,LES 2 VACHES,0,LeMolay(FR),0084,0024 FR AIX (DC),4791,6223,6192,5251,941,972,31,0,1432,-29.88937591317053,365,786,761,707,54,79,25,0,421,-115.34246575342466,96.81933842239185,89.94910941475827,6.870229007633583,99.5018479832878,84.38052386308854,15.121324120199262,Production
1625,0,2019-05-17,146531,L2V BRASS NAT 115X4,0,1,0,LES 2 VACHES,0,LeMolay(FR),0080,0024 FR METZ (DC),4791,6223,6192,5251,941,972,31,0,1432,-29.88937591317053,338,746,746,658,88,88,0,0,408,-120.71005917159763,100.0,88.20375335120644,11.796246648793556,99.5018479832878,84.38052386308854,15.121324120199262,Production
1626,0,2019-05-17,146531,L2V BRASS NAT 115X4,0,1,0,LES 2 VACHES,0,LeMolay(FR),0081,0024 FR TOURS (DC),4791,6223,6192,5251,941,972,31,0,1432,-29.88937591317053,572,817,817,692,125,125,0,0,245,-42.83216783216783,100.0,84.7001223990208,15.299877600979201,99.5018479832878,84.38052386308854,15.121324120199262,Production
1627,0,2019-05-17,146531,L2V BRASS NAT 115X4,0,1,0,LES 2 VACHES,0,LeMolay(FR),0082,0024 FR VALLET (DC),4791,6223,6192,5251,941,972,31,0,1432,-29.88937591317053,460,420,420,420,0,0,0,0,-40,8.695652173913043,100.0,100.0,0.0,99.5018479832878,84.38052386308854,15.121324120199262,Production
1628,0,2019-05-17,146531,L2V BRASS NAT 115X4,0,1,0,LES 2 VACHES,0,LeMolay(FR),0077,0024 FR LILPARK (DC),4791,6223,6192,5251,941,972,31,0,1432,-29.88937591317053,261,397,391,0,391,397,6,0,136,-52.10727969348659,98.48866498740554,0.0,98.48866498740554,99.5018479832878,84.38052386308854,15.121324120199262,Production
1629,0,2019-05-17,146531,L2V BRASS NAT 115X4,0,1,0,LES 2 VACHES,0,LeMolay(FR),0085,0024 FR TOULOUSE (DC),4791,6223,6192,5251,941,972,31,0,1432,-29.88937591317053,677,598,598,435,163,163,0,0,-79,11.669128508124077,100.0,72.74247491638796,27.257525083612038,99.5018479832878,84.38052386308854,15.121324120199262,Production
1630,0,2019-05-17,146531,L2V BRASS NAT 115X4,0,1,0,LES 2 VACHES,0,LeMolay(FR),0083,0024 FR CHAPONNAY (DC),4791,6223,6192,5251,941,972,31,0,1432,-29.88937591317053,847,826,826,785,41,41,0,0,-21,2.479338842975207,100.0,95.0363196125908,4.963680387409198,99.5018479832878,84.38052386308854,15.121324120199262,Production
1631,0,2019-05-17,146531,L2V BRASS NAT 115X4,0,1,0,LES 2 VACHES,0,LeMolay(FR),0079,0024 FR PARIS SUD (DC),4791,6223,6192,5251,941,972,31,0,1432,-29.88937591317053,806,1017,1017,938,79,79,0,0,211,-26.17866004962779,100.0,92.23205506391348,7.767944936086522,99.5018479832878,84.38052386308854,15.121324120199262,Production
1632,0,2019-05-17,146531,L2V BRASS NAT 115X4,0,1,0,LES 2 VACHES,0,LeMolay(FR),0078,0024 FR PARIS NORD (DC),4791,6223,6192,5251,941,972,31,0,1432,-29.88937591317053,465,616,616,616,0,0,0,0,151,-32.473118279569896,100.0,100.0,0.0,99.5018479832878,84.38052386308854,15.121324120199262,Production
1633,0,2019-05-18,61398,JOCKEY STRACCIATELLA 120X4,0,0,0,JOCKEY,0,Ferrières(FR),0084,0024 FR AIX (DC),4652,4133,3976,3397,579,736,157,0,-519,11.156491831470335,404,455,455,455,0,0,0,0,51,-12.623762376237623,100.0,100.0,0.0,96.2013065569804,82.19211226711832,14.00919428986208,Qualité
1634,0,2019-05-18,61398,JOCKEY STRACCIATELLA 120X4,0,0,0,JOCKEY,0,Ferrières(FR),0080,0024 FR METZ (DC),4652,4133,3976,3397,579,736,157,0,-519,11.156491831470335,231,231,231,231,0,0,0,0,0,0.0,100.0,100.0,0.0,96.2013065569804,82.19211226711832,14.00919428986208,Qualité
1635,0,2019-05-18,61398,JOCKEY STRACCIATELLA 120X4,0,0,0,JOCKEY,0,Ferrières(FR),0081,0024 FR TOURS (DC),4652,4133,3976,3397,579,736,157,0,-519,11.156491831470335,670,563,545,9,536,554,18,0,-107,15.970149253731343,96.80284191829485,1.5985790408525755,95.20426287744228,96.2013065569804,82.19211226711832,14.00919428986208,Qualité
1636,0,2019-05-18,61398,JOCKEY STRACCIATELLA 120X4,0,0,0,JOCKEY,0,Ferrières(FR),0082,0024 FR VALLET (DC),4652,4133,3976,3397,579,736,157,0,-519,11.156491831470335,359,341,341,341,0,0,0,0,-18,5.013927576601671,100.0,100.0,0.0,96.2013065569804,82.19211226711832,14.00919428986208,Qualité
1637,0,2019-05-18,61398,JOCKEY STRACCIATELLA 120X4,0,0,0,JOCKEY,0,Ferrières(FR),0077,0024 FR LILPARK (DC),4652,4133,3976,3397,579,736,157,0,-519,11.156491831470335,399,360,360,360,0,0,0,0,-39,9.774436090225564,100.0,100.0,0.0,96.2013065569804,82.19211226711832,14.00919428986208,Qualité
1638,0,2019-05-18,61398,JOCKEY STRACCIATELLA 120X4,0,0,0,JOCKEY,0,Ferrières(FR),0085,0024 FR TOULOUSE (DC),4652,4133,3976,3397,579,736,157,0,-519,11.156491831470335,628,651,651,651,0,0,0,0,23,-3.662420382165605,100.0,100.0,0.0,96.2013065569804,82.19211226711832,14.00919428986208,Qualité
1639,0,2019-05-18,61398,JOCKEY STRACCIATELLA 120X4,0,0,0,JOCKEY,0,Ferrières(FR),0083,0024 FR CHAPONNAY (DC),4652,4133,3976,3397,579,736,157,0,-519,11.156491831470335,544,437,375,375,0,62,62,0,-107,19.669117647058822,85.81235697940504,85.81235697940504,0.0,96.2013065569804,82.19211226711832,14.00919428986208,Qualité
1640,0,2019-05-18,61398,JOCKEY STRACCIATELLA 120X4,0,0,0,JOCKEY,0,Ferrières(FR),0079,0024 FR PARIS SUD (DC),4652,4133,3976,3397,579,736,157,0,-519,11.156491831470335,946,676,619,576,43,100,57,0,-270,28.54122621564482,91.5680473372781,85.20710059171599,6.360946745562117,96.2013065569804,82.19211226711832,14.00919428986208,Qualité
1641,0,2019-05-18,61398,JOCKEY STRACCIATELLA 120X4,0,0,0,JOCKEY,0,Ferrières(FR),0078,0024 FR PARIS NORD (DC),4652,4133,3976,3397,579,736,157,0,-519,11.156491831470335,471,419,399,399,0,20,20,0,-52,11.040339702760084,95.22673031026252,95.22673031026252,0.0,96.2013065569804,82.19211226711832,14.00919428986208,Qualité
1642,0,2019-05-18,101199,DANETTE POP CHOCO MAGIX 120X4,0,0,0,DANETTE,0,LeMolay(FR),0084,0024 FR AIX (DC),5631,5703,5146,5140,6,563,557,0,72,-1.2786361214704316,172,178,178,178,0,0,0,0,6,-3.488372093023256,100.0,100.0,0.0,90.23321059091705,90.12800280554094,0.10520778537610909,A Creuser
1643,0,2019-05-18,101199,DANETTE POP CHOCO MAGIX 120X4,0,0,0,DANETTE,0,LeMolay(FR),0080,0024 FR METZ (DC),5631,5703,5146,5140,6,563,557,0,72,-1.2786361214704316,300,248,193,193,0,55,55,0,-52,17.333333333333332,77.82258064516128,77.82258064516128,0.0,90.23321059091705,90.12800280554094,0.10520778537610909,A Creuser
1644,0,2019-05-18,101199,DANETTE POP CHOCO MAGIX 120X4,0,0,0,DANETTE,0,LeMolay(FR),0081,0024 FR TOURS (DC),5631,5703,5146,5140,6,563,557,0,72,-1.2786361214704316,1306,1310,1310,1310,0,0,0,0,4,-0.30627871362940273,100.0,100.0,0.0,90.23321059091705,90.12800280554094,0.10520778537610909,A Creuser
1645,0,2019-05-18,101199,DANETTE POP CHOCO MAGIX 120X4,0,0,0,DANETTE,0,LeMolay(FR),0082,0024 FR VALLET (DC),5631,5703,5146,5140,6,563,557,0,72,-1.2786361214704316,202,193,166,166,0,27,27,0,-9,4.455445544554456,86.01036269430051,86.01036269430051,0.0,90.23321059091705,90.12800280554094,0.10520778537610909,A Creuser
1646,0,2019-05-18,101199,DANETTE POP CHOCO MAGIX 120X4,0,0,0,DANETTE,0,LeMolay(FR),0077,0024 FR LILPARK (DC),5631,5703,5146,5140,6,563,557,0,72,-1.2786361214704316,527,443,390,390,0,53,53,0,-84,15.939278937381404,88.03611738148985,88.03611738148985,0.0,90.23321059091705,90.12800280554094,0.10520778537610909,A Creuser
1647,0,2019-05-18,101199,DANETTE POP CHOCO MAGIX 120X4,0,0,0,DANETTE,0,LeMolay(FR),0085,0024 FR TOULOUSE (DC),5631,5703,5146,5140,6,563,557,0,72,-1.2786361214704316,835,860,837,837,0,23,23,0,25,-2.9940119760479043,97.32558139534883,97.32558139534883,0.0,90.23321059091705,90.12800280554094,0.10520778537610909,A Creuser
1648,0,2019-05-18,101199,DANETTE POP CHOCO MAGIX 120X4,0,0,0,DANETTE,0,LeMolay(FR),0083,0024 FR CHAPONNAY (DC),5631,5703,5146,5140,6,563,557,0,72,-1.2786361214704316,1082,1138,1138,1138,0,0,0,0,56,-5.175600739371534,100.0,100.0,0.0,90.23321059091705,90.12800280554094,0.10520778537610909,A Creuser
1649,0,2019-05-18,101199,DANETTE POP CHOCO MAGIX 120X4,0,0,0,DANETTE,0,LeMolay(FR),0079,0024 FR PARIS SUD (DC),5631,5703,5146,5140,6,563,557,0,72,-1.2786361214704316,555,678,304,304,0,374,374,0,123,-22.16216216216216,44.83775811209439,44.83775811209439,0.0,90.23321059091705,90.12800280554094,0.10520778537610909,A Creuser
1650,0,2019-05-18,101199,DANETTE POP CHOCO MAGIX 120X4,0,0,0,DANETTE,0,LeMolay(FR),0078,0024 FR PARIS NORD (DC),5631,5703,5146,5140,6,563,557,0,72,-1.2786361214704316,652,655,630,624,6,31,25,0,3,-0.4601226993865031,96.18320610687023,95.26717557251908,0.916030534351151,90.23321059091705,90.12800280554094,0.10520778537610909,A Creuser
1651,0,2019-05-18,101200,DANETTE POP SAV VA 3 CHO 117X4,0,0,0,DANETTE,0,LeMolay(FR),0084,0024 FR AIX (DC),6196,4873,4278,4271,7,602,595,0,-1323,21.352485474499677,94,111,111,111,0,0,0,0,17,-18.085106382978722,100.0,100.0,0.0,87.78986250769546,87.64621383131541,0.14364867638005308,A Creuser
1652,0,2019-05-18,101200,DANETTE POP SAV VA 3 CHO 117X4,0,0,0,DANETTE,0,LeMolay(FR),0080,0024 FR METZ (DC),6196,4873,4278,4271,7,602,595,0,-1323,21.352485474499677,184,210,210,210,0,0,0,0,26,-14.130434782608695,100.0,100.0,0.0,87.78986250769546,87.64621383131541,0.14364867638005308,A Creuser
1653,0,2019-05-18,101200,DANETTE POP SAV VA 3 CHO 117X4,0,0,0,DANETTE,0,LeMolay(FR),0081,0024 FR TOURS (DC),6196,4873,4278,4271,7,602,595,0,-1323,21.352485474499677,1066,1148,906,906,0,242,242,0,82,-7.6923076923076925,78.9198606271777,78.9198606271777,0.0,87.78986250769546,87.64621383131541,0.14364867638005308,A Creuser
1654,1,2019-05-18,101200,DANETTE POP SAV VA 3 CHO 117X4,0,0,0,DANETTE,0,LeMolay(FR),0081,0024 FR TOURS (DC),6196,4873,4278,4271,7,602,595,0,-1323,21.352485474499677,1066,1148,906,906,0,242,242,0,82,-7.6923076923076925,78.9198606271777,78.9198606271777,0.0,87.78986250769546,87.64621383131541,0.14364867638005308,A Creuser
1655,0,2019-05-18,101200,DANETTE POP SAV VA 3 CHO 117X4,0,0,0,DANETTE,0,LeMolay(FR),0082,0024 FR VALLET (DC),6196,4873,4278,4271,7,602,595,0,-1323,21.352485474499677,100,116,35,35,0,81,81,0,16,-16.0,30.17241379310345,30.17241379310345,0.0,87.78986250769546,87.64621383131541,0.14364867638005308,A Creuser
1656,0,2019-05-18,101200,DANETTE POP SAV VA 3 CHO 117X4,0,0,0,DANETTE,0,LeMolay(FR),0077,0024 FR LILPARK (DC),6196,4873,4278,4271,7,602,595,0,-1323,21.352485474499677,433,374,374,374,0,0,0,0,-59,13.625866050808314,100.0,100.0,0.0,87.78986250769546,87.64621383131541,0.14364867638005308,A Creuser
1657,0,2019-05-18,101200,DANETTE POP SAV VA 3 CHO 117X4,0,0,0,DANETTE,0,LeMolay(FR),0085,0024 FR TOULOUSE (DC),6196,4873,4278,4271,7,602,595,0,-1323,21.352485474499677,665,725,654,654,0,71,71,0,60,-9.022556390977444,90.20689655172414,90.20689655172414,0.0,87.78986250769546,87.64621383131541,0.14364867638005308,A Creuser
1658,0,2019-05-18,101200,DANETTE POP SAV VA 3 CHO 117X4,0,0,0,DANETTE,0,LeMolay(FR),0083,0024 FR CHAPONNAY (DC),6196,4873,4278,4271,7,602,595,0,-1323,21.352485474499677,932,1026,990,990,0,36,36,0,94,-10.085836909871245,96.49122807017544,96.49122807017544,0.0,87.78986250769546,87.64621383131541,0.14364867638005308,A Creuser
1659,0,2019-05-18,101200,DANETTE POP SAV VA 3 CHO 117X4,0,0,0,DANETTE,0,LeMolay(FR),0079,0024 FR PARIS SUD (DC),6196,4873,4278,4271,7,602,595,0,-1323,21.352485474499677,436,529,435,435,0,94,94,0,93,-21.3302752293578,82.23062381852552,82.23062381852552,0.0,87.78986250769546,87.64621383131541,0.14364867638005308,A Creuser
1660,0,2019-05-18,101200,DANETTE POP SAV VA 3 CHO 117X4,0,0,0,DANETTE,0,LeMolay(FR),0078,0024 FR PARIS NORD (DC),6196,4873,4278,4271,7,602,595,0,-1323,21.352485474499677,610,634,563,556,7,78,71,0,24,-3.9344262295081966,88.801261829653,87.69716088328076,1.1041009463722418,87.78986250769546,87.64621383131541,0.14364867638005308,A Creuser
1661,1,2019-05-18,101200,DANETTE POP SAV VA 3 CHO 117X4,0,0,0,DANETTE,0,LeMolay(FR),0078,0024 FR PARIS NORD (DC),6196,4873,4278,4271,7,602,595,0,-1323,21.352485474499677,610,634,563,556,7,78,71,0,24,-3.9344262295081966,88.801261829653,87.69716088328076,1.1041009463722418,87.78986250769546,87.64621383131541,0.14364867638005308,A Creuser
1662,0,2019-05-18,101202,DANETTE POP CHOC 3 CHOCO 117X4,0,0,0,DANETTE,0,LeMolay(FR),0084,0024 FR AIX (DC),6909,6196,5578,5577,1,619,618,0,-713,10.319872629903026,191,216,216,216,0,0,0,0,25,-13.089005235602095,100.0,100.0,0.0,90.02582311168496,90.00968366688186,0.01613944480310181,A Creuser
1663,0,2019-05-18,101202,DANETTE POP CHOC 3 CHOCO 117X4,0,0,0,DANETTE,0,LeMolay(FR),0080,0024 FR METZ (DC),6909,6196,5578,5577,1,619,618,0,-713,10.319872629903026,306,262,262,262,0,0,0,0,-44,14.379084967320262,100.0,100.0,0.0,90.02582311168496,90.00968366688186,0.01613944480310181,A Creuser
1664,0,2019-05-18,101202,DANETTE POP CHOC 3 CHOCO 117X4,0,0,0,DANETTE,0,LeMolay(FR),0081,0024 FR TOURS (DC),6909,6196,5578,5577,1,619,618,0,-713,10.319872629903026,1328,1359,1357,1357,0,2,2,0,31,-2.3343373493975905,99.85283296541574,99.85283296541574,0.0,90.02582311168496,90.00968366688186,0.01613944480310181,A Creuser
1665,0,2019-05-18,101202,DANETTE POP CHOC 3 CHOCO 117X4,0,0,0,DANETTE,0,LeMolay(FR),0082,0024 FR VALLET (DC),6909,6196,5578,5577,1,619,618,0,-713,10.319872629903026,228,211,211,211,0,0,0,0,-17,7.456140350877193,100.0,100.0,0.0,90.02582311168496,90.00968366688186,0.01613944480310181,A Creuser
1666,0,2019-05-18,101202,DANETTE POP CHOC 3 CHOCO 117X4,0,0,0,DANETTE,0,LeMolay(FR),0077,0024 FR LILPARK (DC),6909,6196,5578,5577,1,619,618,0,-713,10.319872629903026,617,502,475,475,0,27,27,0,-115,18.638573743922205,94.62151394422311,94.62151394422311,0.0,90.02582311168496,90.00968366688186,0.01613944480310181,A Creuser
1667,0,2019-05-18,101202,DANETTE POP CHOC 3 CHOCO 117X4,0,0,0,DANETTE,0,LeMolay(FR),0085,0024 FR TOULOUSE (DC),6909,6196,5578,5577,1,619,618,0,-713,10.319872629903026,830,822,822,822,0,0,0,0,-8,0.963855421686747,100.0,100.0,0.0,90.02582311168496,90.00968366688186,0.01613944480310181,A Creuser
1668,0,2019-05-18,101202,DANETTE POP CHOC 3 CHOCO 117X4,0,0,0,DANETTE,0,LeMolay(FR),0083,0024 FR CHAPONNAY (DC),6909,6196,5578,5577,1,619,618,0,-713,10.319872629903026,1082,1146,1146,1145,1,1,0,0,64,-5.914972273567468,100.0,99.91273996509598,0.08726003490401979,90.02582311168496,90.00968366688186,0.01613944480310181,A Creuser
1669,0,2019-05-18,101202,DANETTE POP CHOC 3 CHOCO 117X4,0,0,0,DANETTE,0,LeMolay(FR),0079,0024 FR PARIS SUD (DC),6909,6196,5578,5577,1,619,618,0,-713,10.319872629903026,744,913,324,324,0,589,589,0,169,-22.71505376344086,35.48740416210296,35.48740416210296,0.0,90.02582311168496,90.00968366688186,0.01613944480310181,A Creuser
1670,1,2019-05-18,101202,DANETTE POP CHOC 3 CHOCO 117X4,0,0,0,DANETTE,0,LeMolay(FR),0079,0024 FR PARIS SUD (DC),6909,6196,5578,5577,1,619,618,0,-713,10.319872629903026,744,913,324,324,0,589,589,0,169,-22.71505376344086,35.48740416210296,35.48740416210296,0.0,90.02582311168496,90.00968366688186,0.01613944480310181,A Creuser
1671,0,2019-05-18,101202,DANETTE POP CHOC 3 CHOCO 117X4,0,0,0,DANETTE,0,LeMolay(FR),0078,0024 FR PARIS NORD (DC),6909,6196,5578,5577,1,619,618,0,-713,10.319872629903026,839,765,765,765,0,0,0,0,-74,8.820023837902264,100.0,100.0,0.0,90.02582311168496,90.00968366688186,0.01613944480310181,A Creuser
1672,0,2019-05-18,113631,GERVITA NATURE 100X8 OPL,0,0,0,GERVITA,0,Ferrières(FR),0084,0024 FR AIX (DC),4189,3564,3564,3308,256,256,0,0,-625,14.920028646455002,506,504,504,504,0,0,0,0,-2,0.3952569169960474,100.0,100.0,0.0,100.0,92.81705948372615,7.182940516273845,A Creuser
1673,0,2019-05-18,113631,GERVITA NATURE 100X8 OPL,0,0,0,GERVITA,0,Ferrières(FR),0080,0024 FR METZ (DC),4189,3564,3564,3308,256,256,0,0,-625,14.920028646455002,257,258,258,258,0,0,0,0,1,-0.38910505836575876,100.0,100.0,0.0,100.0,92.81705948372615,7.182940516273845,A Creuser
1674,0,2019-05-18,113631,GERVITA NATURE 100X8 OPL,0,0,0,GERVITA,0,Ferrières(FR),0081,0024 FR TOURS (DC),4189,3564,3564,3308,256,256,0,0,-625,14.920028646455002,241,240,240,240,0,0,0,0,-1,0.4149377593360996,100.0,100.0,0.0,100.0,92.81705948372615,7.182940516273845,A Creuser
1675,0,2019-05-18,113631,GERVITA NATURE 100X8 OPL,0,0,0,GERVITA,0,Ferrières(FR),0082,0024 FR VALLET (DC),4189,3564,3564,3308,256,256,0,0,-625,14.920028646455002,6,4,4,4,0,0,0,0,-2,33.333333333333336,100.0,100.0,0.0,100.0,92.81705948372615,7.182940516273845,A Creuser
1676,0,2019-05-18,113631,GERVITA NATURE 100X8 OPL,0,0,0,GERVITA,0,Ferrières(FR),0077,0024 FR LILPARK (DC),4189,3564,3564,3308,256,256,0,0,-625,14.920028646455002,624,622,622,366,256,256,0,0,-2,0.32051282051282054,100.0,58.842443729903536,41.157556270096464,100.0,92.81705948372615,7.182940516273845,A Creuser
1677,1,2019-05-18,113631,GERVITA NATURE 100X8 OPL,0,0,0,GERVITA,0,Ferrières(FR),0077,0024 FR LILPARK (DC),4189,3564,3564,3308,256,256,0,0,-625,14.920028646455002,624,622,622,366,256,256,0,0,-2,0.32051282051282054,100.0,58.842443729903536,41.157556270096464,100.0,92.81705948372615,7.182940516273845,A Creuser
1678,0,2019-05-18,113631,GERVITA NATURE 100X8 OPL,0,0,0,GERVITA,0,Ferrières(FR),0085,0024 FR TOULOUSE (DC),4189,3564,3564,3308,256,256,0,0,-625,14.920028646455002,287,285,285,285,0,0,0,0,-2,0.6968641114982579,100.0,100.0,0.0,100.0,92.81705948372615,7.182940516273845,A Creuser
1679,0,2019-05-18,113631,GERVITA NATURE 100X8 OPL,0,0,0,GERVITA,0,Ferrières(FR),0083,0024 FR CHAPONNAY (DC),4189,3564,3564,3308,256,256,0,0,-625,14.920028646455002,549,547,547,547,0,0,0,0,-2,0.36429872495446264,100.0,100.0,0.0,100.0,92.81705948372615,7.182940516273845,A Creuser
1680,0,2019-05-18,113631,GERVITA NATURE 100X8 OPL,0,0,0,GERVITA,0,Ferrières(FR),0079,0024 FR PARIS SUD (DC),4189,3564,3564,3308,256,256,0,0,-625,14.920028646455002,648,646,646,646,0,0,0,0,-2,0.30864197530864196,100.0,100.0,0.0,100.0,92.81705948372615,7.182940516273845,A Creuser
1681,0,2019-05-18,113631,GERVITA NATURE 100X8 OPL,0,0,0,GERVITA,0,Ferrières(FR),0078,0024 FR PARIS NORD (DC),4189,3564,3564,3308,256,256,0,0,-625,14.920028646455002,447,458,458,458,0,0,0,0,11,-2.460850111856823,100.0,100.0,0.0,100.0,92.81705948372615,7.182940516273845,A Creuser
1682,1,2019-05-18,113650,GERVITA FRAISE MELBA 100X8 OPL,0,0,0,GERVITA,0,Ferrières(FR),0077,0024 FR LILPARK (DC),537,2657,2657,2528,129,129,0,0,2120,-394.7858472998138,537,537,537,409,128,128,0,0,0,0.0,100.0,76.16387337057728,23.836126629422722,100.0,95.14490026345503,4.855099736544972,A Creuser
1683,1,2019-05-18,115026,FJORD NATURE 125GX8 OPL,1,0,0,FJORD,0,LeMolay(FR),0078,0024 FR PARIS NORD (DC),346,3034,3034,2886,148,148,0,0,2688,-776.878612716763,346,358,358,338,20,20,0,0,12,-3.468208092485549,100.0,94.41340782122904,5.586592178770957,100.0,95.1219512195122,4.878048780487802,A Creuser
1684,1,2019-05-18,127970,DANET CHOCO 125X8,0,0,0,DANETTE,0,StJust(FR),0078,0024 FR PARIS NORD (DC),306,2279,2279,2259,20,20,0,0,1973,-644.7712418300654,306,274,274,254,20,20,0,0,-32,10.457516339869281,100.0,92.7007299270073,7.299270072992698,100.0,99.1224221149627,0.8775778850372973,A Creuser
1685,1,2019-05-18,137716,DANET LIEG VAN CHOCO 100X8,0,0,0,DANETTE,0,StJust(FR),0078,0024 FR PARIS NORD (DC),286,2246,2246,2214,32,32,0,0,1960,-685.3146853146853,286,293,293,261,32,32,0,0,7,-2.4475524475524475,100.0,89.07849829351537,10.921501706484634,100.0,98.57524487978628,1.4247551202137174,A Creuser
1686,1,2019-05-18,142612,VELOUTE FRUIX FRT PAN 125X8 OD,0,0,0,VELOUTE,0,Villecomtal(FR),0078,0024 FR PARIS NORD (DC),474,3175,3175,3158,17,17,0,0,2701,-569.831223628692,474,464,464,447,17,17,0,0,-10,2.109704641350211,100.0,96.33620689655173,3.6637931034482705,100.0,99.46456692913385,0.5354330708661479,A Creuser
1687,1,2019-05-18,143274,DANET VAN CHOCO 115X12,0,0,0,DANETTE,0,StJust(FR),0078,0024 FR PARIS NORD (DC),455,5139,5000,4975,25,164,139,0,4684,-1029.4505494505495,455,494,494,469,25,25,0,0,39,-8.571428571428571,100.0,94.93927125506073,5.060728744939269,97.29519361743529,96.80871764934813,0.48647596808716287,A Creuser
1688,0,2019-05-18,146531,L2V BRASS NAT 115X4,0,1,0,LES 2 VACHES,0,LeMolay(FR),0084,0024 FR AIX (DC),3039,3771,3179,3178,1,593,592,0,732,-24.086870681145115,304,519,229,229,0,290,290,0,215,-70.72368421052632,44.1233140655106,44.1233140655106,0.0,84.30124635375232,84.27472818880933,0.026518164942984868,Production
1689,0,2019-05-18,146531,L2V BRASS NAT 115X4,0,1,0,LES 2 VACHES,0,LeMolay(FR),0080,0024 FR METZ (DC),3039,3771,3179,3178,1,593,592,0,732,-24.086870681145115,166,170,62,62,0,108,108,0,4,-2.4096385542168677,36.470588235294116,36.470588235294116,0.0,84.30124635375232,84.27472818880933,0.026518164942984868,Production
1690,0,2019-05-18,146531,L2V BRASS NAT 115X4,0,1,0,LES 2 VACHES,0,LeMolay(FR),0081,0024 FR TOURS (DC),3039,3771,3179,3178,1,593,592,0,732,-24.086870681145115,371,433,433,433,0,0,0,0,62,-16.711590296495956,100.0,100.0,0.0,84.30124635375232,84.27472818880933,0.026518164942984868,Production
1691,0,2019-05-18,146531,L2V BRASS NAT 115X4,0,1,0,LES 2 VACHES,0,LeMolay(FR),0082,0024 FR VALLET (DC),3039,3771,3179,3178,1,593,592,0,732,-24.086870681145115,329,258,258,258,0,0,0,0,-71,21.580547112462007,100.0,100.0,0.0,84.30124635375232,84.27472818880933,0.026518164942984868,Production
1692,0,2019-05-18,146531,L2V BRASS NAT 115X4,0,1,0,LES 2 VACHES,0,LeMolay(FR),0077,0024 FR LILPARK (DC),3039,3771,3179,3178,1,593,592,0,732,-24.086870681145115,83,101,101,101,0,0,0,0,18,-21.686746987951807,100.0,100.0,0.0,84.30124635375232,84.27472818880933,0.026518164942984868,Production
1693,0,2019-05-18,146531,L2V BRASS NAT 115X4,0,1,0,LES 2 VACHES,0,LeMolay(FR),0085,0024 FR TOULOUSE (DC),3039,3771,3179,3178,1,593,592,0,732,-24.086870681145115,223,336,336,336,0,0,0,0,113,-50.672645739910315,100.0,100.0,0.0,84.30124635375232,84.27472818880933,0.026518164942984868,Production
1694,0,2019-05-18,146531,L2V BRASS NAT 115X4,0,1,0,LES 2 VACHES,0,LeMolay(FR),0083,0024 FR CHAPONNAY (DC),3039,3771,3179,3178,1,593,592,0,732,-24.086870681145115,438,599,599,599,0,0,0,0,161,-36.757990867579906,100.0,100.0,0.0,84.30124635375232,84.27472818880933,0.026518164942984868,Production
1695,0,2019-05-18,146531,L2V BRASS NAT 115X4,0,1,0,LES 2 VACHES,0,LeMolay(FR),0079,0024 FR PARIS SUD (DC),3039,3771,3179,3178,1,593,592,0,732,-24.086870681145115,650,606,606,606,0,0,0,0,-44,6.769230769230769,100.0,100.0,0.0,84.30124635375232,84.27472818880933,0.026518164942984868,Production
1696,0,2019-05-18,146531,L2V BRASS NAT 115X4,0,1,0,LES 2 VACHES,0,LeMolay(FR),0078,0024 FR PARIS NORD (DC),3039,3771,3179,3178,1,593,592,0,732,-24.086870681145115,475,749,555,554,1,195,194,0,274,-57.68421052631579,74.09879839786382,73.9652870493992,0.13351134846462287,84.30124635375232,84.27472818880933,0.026518164942984868,Production
1697,0,2019-05-18,146534,L2V BRASS CIT 115X4,0,1,0,LES 2 VACHES,0,LeMolay(FR),0084,0024 FR AIX (DC),908,850,619,615,4,235,231,0,-58,6.387665198237886,115,120,38,38,0,82,82,0,5,-4.3478260869565215,31.666666666666664,31.666666666666664,0.0,72.82352941176471,72.35294117647058,0.4705882352941302,Production
1698,0,2019-05-18,146534,L2V BRASS CIT 115X4,0,1,0,LES 2 VACHES,0,LeMolay(FR),0080,0024 FR METZ (DC),908,850,619,615,4,235,231,0,-58,6.387665198237886,39,52,52,52,0,0,0,0,13,-33.333333333333336,100.0,100.0,0.0,72.82352941176471,72.35294117647058,0.4705882352941302,Production
1699,0,2019-05-18,146534,L2V BRASS CIT 115X4,0,1,0,LES 2 VACHES,0,LeMolay(FR),0081,0024 FR TOURS (DC),908,850,619,615,4,235,231,0,-58,6.387665198237886,167,168,129,125,4,43,39,0,1,-0.5988023952095808,76.78571428571429,74.40476190476191,2.3809523809523796,72.82352941176471,72.35294117647058,0.4705882352941302,Production
1700,0,2019-05-18,146534,L2V BRASS CIT 115X4,0,1,0,LES 2 VACHES,0,LeMolay(FR),0082,0024 FR VALLET (DC),908,850,619,615,4,235,231,0,-58,6.387665198237886,144,110,92,92,0,18,18,0,-34,23.61111111111111,83.63636363636363,83.63636363636363,0.0,72.82352941176471,72.35294117647058,0.4705882352941302,Production
1701,0,2019-05-18,146534,L2V BRASS CIT 115X4,0,1,0,LES 2 VACHES,0,LeMolay(FR),0077,0024 FR LILPARK (DC),908,850,619,615,4,235,231,0,-58,6.387665198237886,23,17,17,17,0,0,0,0,-6,26.08695652173913,100.0,100.0,0.0,72.82352941176471,72.35294117647058,0.4705882352941302,Production
1702,0,2019-05-18,146534,L2V BRASS CIT 115X4,0,1,0,LES 2 VACHES,0,LeMolay(FR),0085,0024 FR TOULOUSE (DC),908,850,619,615,4,235,231,0,-58,6.387665198237886,77,116,41,41,0,75,75,0,39,-50.64935064935065,35.3448275862069,35.3448275862069,0.0,72.82352941176471,72.35294117647058,0.4705882352941302,Production
1703,0,2019-05-18,146534,L2V BRASS CIT 115X4,0,1,0,LES 2 VACHES,0,LeMolay(FR),0083,0024 FR CHAPONNAY (DC),908,850,619,615,4,235,231,0,-58,6.387665198237886,222,171,154,154,0,17,17,0,-51,22.972972972972972,90.05847953216374,90.05847953216374,0.0,72.82352941176471,72.35294117647058,0.4705882352941302,Production
1704,0,2019-05-18,146534,L2V BRASS CIT 115X4,0,1,0,LES 2 VACHES,0,LeMolay(FR),0078,0024 FR PARIS NORD (DC),908,850,619,615,4,235,231,0,-58,6.387665198237886,121,96,96,96,0,0,0,0,-25,20.66115702479339,100.0,100.0,0.0,72.82352941176471,72.35294117647058,0.4705882352941302,Production
1705,0,2019-05-20,61398,JOCKEY STRACCIATELLA 120X4,0,0,0,JOCKEY,0,Ferrières(FR),0084,0024 FR AIX (DC),4879,4872,4170,3815,355,1057,702,0,-7,0.14347202295552366,539,551,551,551,0,0,0,0,12,-2.226345083487941,100.0,100.0,0.0,85.5911330049261,78.30459770114942,7.286535303776688,Qualité
1706,0,2019-05-20,61398,JOCKEY STRACCIATELLA 120X4,0,0,0,JOCKEY,0,Ferrières(FR),0080,0024 FR METZ (DC),4879,4872,4170,3815,355,1057,702,0,-7,0.14347202295552366,324,435,435,435,0,0,0,0,111,-34.25925925925926,100.0,100.0,0.0,85.5911330049261,78.30459770114942,7.286535303776688,Qualité
1707,0,2019-05-20,61398,JOCKEY STRACCIATELLA 120X4,0,0,0,JOCKEY,0,Ferrières(FR),0081,0024 FR TOURS (DC),4879,4872,4170,3815,355,1057,702,0,-7,0.14347202295552366,537,766,64,0,64,766,702,0,229,-42.64432029795158,8.355091383812011,0.0,8.355091383812011,85.5911330049261,78.30459770114942,7.286535303776688,Qualité
1708,0,2019-05-20,61398,JOCKEY STRACCIATELLA 120X4,0,0,0,JOCKEY,0,Ferrières(FR),0082,0024 FR VALLET (DC),4879,4872,4170,3815,355,1057,702,0,-7,0.14347202295552366,458,457,457,457,0,0,0,0,-1,0.2183406113537118,100.0,100.0,0.0,85.5911330049261,78.30459770114942,7.286535303776688,Qualité
1709,0,2019-05-20,61398,JOCKEY STRACCIATELLA 120X4,0,0,0,JOCKEY,0,Ferrières(FR),0077,0024 FR LILPARK (DC),4879,4872,4170,3815,355,1057,702,0,-7,0.14347202295552366,375,238,238,238,0,0,0,0,-137,36.53333333333333,100.0,100.0,0.0,85.5911330049261,78.30459770114942,7.286535303776688,Qualité
1710,0,2019-05-20,61398,JOCKEY STRACCIATELLA 120X4,0,0,0,JOCKEY,0,Ferrières(FR),0085,0024 FR TOULOUSE (DC),4879,4872,4170,3815,355,1057,702,0,-7,0.14347202295552366,632,625,625,625,0,0,0,0,-7,1.1075949367088607,100.0,100.0,0.0,85.5911330049261,78.30459770114942,7.286535303776688,Qualité
1711,0,2019-05-20,61398,JOCKEY STRACCIATELLA 120X4,0,0,0,JOCKEY,0,Ferrières(FR),0083,0024 FR CHAPONNAY (DC),4879,4872,4170,3815,355,1057,702,0,-7,0.14347202295552366,519,534,534,482,52,52,0,0,15,-2.8901734104046244,100.0,90.2621722846442,9.737827715355806,85.5911330049261,78.30459770114942,7.286535303776688,Qualité
1712,0,2019-05-20,61398,JOCKEY STRACCIATELLA 120X4,0,0,0,JOCKEY,0,Ferrières(FR),0079,0024 FR PARIS SUD (DC),4879,4872,4170,3815,355,1057,702,0,-7,0.14347202295552366,628,596,596,357,239,239,0,0,-32,5.095541401273885,100.0,59.89932885906041,40.10067114093959,85.5911330049261,78.30459770114942,7.286535303776688,Qualité
1713,0,2019-05-20,61398,JOCKEY STRACCIATELLA 120X4,0,0,0,JOCKEY,0,Ferrières(FR),0078,0024 FR PARIS NORD (DC),4879,4872,4170,3815,355,1057,702,0,-7,0.14347202295552366,867,670,670,670,0,0,0,0,-197,22.722029988465973,100.0,100.0,0.0,85.5911330049261,78.30459770114942,7.286535303776688,Qualité
1714,1,2019-05-20,101199,DANETTE POP CHOCO MAGIX 120X4,0,0,0,DANETTE,0,LeMolay(FR),0077,0024 FR LILPARK (DC),1427,3859,3859,3709,150,150,0,0,2432,-170.42747021723898,1427,1451,1451,1301,150,150,0,0,24,-1.6818500350385424,100.0,89.66230186078566,10.33769813921434,100.0,96.11298263798912,3.88701736201088,A Creuser
1715,0,2019-05-20,101202,DANETTE POP CHOC 3 CHOCO 117X4,0,0,0,DANETTE,0,LeMolay(FR),0084,0024 FR AIX (DC),4909,4929,4271,4267,4,662,658,0,20,-0.4074149521287431,260,232,205,205,0,27,27,0,-28,10.76923076923077,88.36206896551724,88.36206896551724,0.0,86.65043619395415,86.56928383039157,0.08115236356258038,A Creuser
1716,0,2019-05-20,101202,DANETTE POP CHOC 3 CHOCO 117X4,0,0,0,DANETTE,0,LeMolay(FR),0080,0024 FR METZ (DC),4909,4929,4271,4267,4,662,658,0,20,-0.4074149521287431,281,226,212,211,1,15,14,0,-55,19.572953736654803,93.80530973451327,93.36283185840708,0.4424778761061958,86.65043619395415,86.56928383039157,0.08115236356258038,A Creuser
1717,0,2019-05-20,101202,DANETTE POP CHOC 3 CHOCO 117X4,0,0,0,DANETTE,0,LeMolay(FR),0081,0024 FR TOURS (DC),4909,4929,4271,4267,4,662,658,0,20,-0.4074149521287431,433,348,348,348,0,0,0,0,-85,19.630484988452658,100.0,100.0,0.0,86.65043619395415,86.56928383039157,0.08115236356258038,A Creuser
1718,0,2019-05-20,101202,DANETTE POP CHOC 3 CHOCO 117X4,0,0,0,DANETTE,0,LeMolay(FR),0082,0024 FR VALLET (DC),4909,4929,4271,4267,4,662,658,0,20,-0.4074149521287431,496,470,470,470,0,0,0,0,-26,5.241935483870968,100.0,100.0,0.0,86.65043619395415,86.56928383039157,0.08115236356258038,A Creuser
1719,0,2019-05-20,101202,DANETTE POP CHOC 3 CHOCO 117X4,0,0,0,DANETTE,0,LeMolay(FR),0077,0024 FR LILPARK (DC),4909,4929,4271,4267,4,662,658,0,20,-0.4074149521287431,1694,1737,1668,1668,0,69,69,0,43,-2.538370720188902,96.02763385146805,96.02763385146805,0.0,86.65043619395415,86.56928383039157,0.08115236356258038,A Creuser
1720,0,2019-05-20,101202,DANETTE POP CHOC 3 CHOCO 117X4,0,0,0,DANETTE,0,LeMolay(FR),0085,0024 FR TOULOUSE (DC),4909,4929,4271,4267,4,662,658,0,20,-0.4074149521287431,457,420,416,416,0,4,4,0,-37,8.096280087527353,99.04761904761905,99.04761904761905,0.0,86.65043619395415,86.56928383039157,0.08115236356258038,A Creuser
1721,0,2019-05-20,101202,DANETTE POP CHOC 3 CHOCO 117X4,0,0,0,DANETTE,0,LeMolay(FR),0083,0024 FR CHAPONNAY (DC),4909,4929,4271,4267,4,662,658,0,20,-0.4074149521287431,431,450,329,327,2,123,121,0,19,-4.408352668213457,73.11111111111111,72.66666666666667,0.44444444444444287,86.65043619395415,86.56928383039157,0.08115236356258038,A Creuser
1722,0,2019-05-20,101202,DANETTE POP CHOC 3 CHOCO 117X4,0,0,0,DANETTE,0,LeMolay(FR),0079,0024 FR PARIS SUD (DC),4909,4929,4271,4267,4,662,658,0,20,-0.4074149521287431,503,583,208,207,1,376,375,0,80,-15.904572564612327,35.67753001715266,35.506003430531734,0.1715265866209279,86.65043619395415,86.56928383039157,0.08115236356258038,A Creuser
1723,0,2019-05-20,101202,DANETTE POP CHOC 3 CHOCO 117X4,0,0,0,DANETTE,0,LeMolay(FR),0078,0024 FR PARIS NORD (DC),4909,4929,4271,4267,4,662,658,0,20,-0.4074149521287431,354,463,415,415,0,48,48,0,109,-30.7909604519774,89.6328293736501,89.6328293736501,0.0,86.65043619395415,86.56928383039157,0.08115236356258038,A Creuser
1724,0,2019-05-20,102483,JOCKEY FROM NATURE 100X8 3%,0,0,0,JOCKEY,0,Ferrières(FR),0084,0024 FR AIX (DC),1600,1524,1372,1257,115,267,152,0,-76,4.75,217,183,183,183,0,0,0,0,-34,15.668202764976959,100.0,100.0,0.0,90.02624671916011,82.48031496062993,7.5459317585301875,Qualité
1725,0,2019-05-20,102483,JOCKEY FROM NATURE 100X8 3%,0,0,0,JOCKEY,0,Ferrières(FR),0080,0024 FR METZ (DC),1600,1524,1372,1257,115,267,152,0,-76,4.75,137,177,177,177,0,0,0,0,40,-29.197080291970803,100.0,100.0,0.0,90.02624671916011,82.48031496062993,7.5459317585301875,Qualité
1726,0,2019-05-20,102483,JOCKEY FROM NATURE 100X8 3%,0,0,0,JOCKEY,0,Ferrières(FR),0082,0024 FR VALLET (DC),1600,1524,1372,1257,115,267,152,0,-76,4.75,210,191,191,191,0,0,0,0,-19,9.047619047619047,100.0,100.0,0.0,90.02624671916011,82.48031496062993,7.5459317585301875,Qualité
1727,0,2019-05-20,102483,JOCKEY FROM NATURE 100X8 3%,0,0,0,JOCKEY,0,Ferrières(FR),0077,0024 FR LILPARK (DC),1600,1524,1372,1257,115,267,152,0,-76,4.75,99,67,67,67,0,0,0,0,-32,32.323232323232325,100.0,100.0,0.0,90.02624671916011,82.48031496062993,7.5459317585301875,Qualité
1728,0,2019-05-20,102483,JOCKEY FROM NATURE 100X8 3%,0,0,0,JOCKEY,0,Ferrières(FR),0085,0024 FR TOULOUSE (DC),1600,1524,1372,1257,115,267,152,0,-76,4.75,222,313,313,313,0,0,0,0,91,-40.990990990990994,100.0,100.0,0.0,90.02624671916011,82.48031496062993,7.5459317585301875,Qualité
1729,0,2019-05-20,102483,JOCKEY FROM NATURE 100X8 3%,0,0,0,JOCKEY,0,Ferrières(FR),0083,0024 FR CHAPONNAY (DC),1600,1524,1372,1257,115,267,152,0,-76,4.75,176,148,148,148,0,0,0,0,-28,15.909090909090908,100.0,100.0,0.0,90.02624671916011,82.48031496062993,7.5459317585301875,Qualité
1730,0,2019-05-20,102483,JOCKEY FROM NATURE 100X8 3%,0,0,0,JOCKEY,0,Ferrières(FR),0079,0024 FR PARIS SUD (DC),1600,1524,1372,1257,115,267,152,0,-76,4.75,323,296,144,144,0,152,152,0,-27,8.359133126934985,48.64864864864865,48.64864864864865,0.0,90.02624671916011,82.48031496062993,7.5459317585301875,Qualité
1731,0,2019-05-20,102483,JOCKEY FROM NATURE 100X8 3%,0,0,0,JOCKEY,0,Ferrières(FR),0078,0024 FR PARIS NORD (DC),1600,1524,1372,1257,115,267,152,0,-76,4.75,216,149,149,34,115,115,0,0,-67,31.01851851851852,100.0,22.818791946308725,77.18120805369128,90.02624671916011,82.48031496062993,7.5459317585301875,Qualité
1732,0,2019-05-20,127750,DANIO 0% FRAISE 150X1,0,0,0,DANIO,0,Ferrières(FR),0084,0024 FR AIX (DC),294,468,468,246,222,222,0,0,174,-59.183673469387756,33,57,57,57,0,0,0,0,24,-72.72727272727273,100.0,100.0,0.0,100.0,52.56410256410257,47.43589743589743,Qualité
1733,0,2019-05-20,127750,DANIO 0% FRAISE 150X1,0,0,0,DANIO,0,Ferrières(FR),0080,0024 FR METZ (DC),294,468,468,246,222,222,0,0,174,-59.183673469387756,23,33,33,33,0,0,0,0,10,-43.47826086956522,100.0,100.0,0.0,100.0,52.56410256410257,47.43589743589743,Qualité
1734,0,2019-05-20,127750,DANIO 0% FRAISE 150X1,0,0,0,DANIO,0,Ferrières(FR),0081,0024 FR TOURS (DC),294,468,468,246,222,222,0,0,174,-59.183673469387756,34,44,44,44,0,0,0,0,10,-29.41176470588235,100.0,100.0,0.0,100.0,52.56410256410257,47.43589743589743,Qualité
1735,0,2019-05-20,127750,DANIO 0% FRAISE 150X1,0,0,0,DANIO,0,Ferrières(FR),0082,0024 FR VALLET (DC),294,468,468,246,222,222,0,0,174,-59.183673469387756,27,33,33,33,0,0,0,0,6,-22.22222222222222,100.0,100.0,0.0,100.0,52.56410256410257,47.43589743589743,Qualité
1736,0,2019-05-20,127750,DANIO 0% FRAISE 150X1,0,0,0,DANIO,0,Ferrières(FR),0077,0024 FR LILPARK (DC),294,468,468,246,222,222,0,0,174,-59.183673469387756,52,58,58,32,26,26,0,0,6,-11.538461538461538,100.0,55.172413793103445,44.827586206896555,100.0,52.56410256410257,47.43589743589743,Qualité
1737,0,2019-05-20,127750,DANIO 0% FRAISE 150X1,0,0,0,DANIO,0,Ferrières(FR),0085,0024 FR TOULOUSE (DC),294,468,468,246,222,222,0,0,174,-59.183673469387756,38,53,53,0,53,53,0,0,15,-39.473684210526315,100.0,0.0,100.0,100.0,52.56410256410257,47.43589743589743,Qualité
1738,0,2019-05-20,127750,DANIO 0% FRAISE 150X1,0,0,0,DANIO,0,Ferrières(FR),0083,0024 FR CHAPONNAY (DC),294,468,468,246,222,222,0,0,174,-59.183673469387756,34,40,40,40,0,0,0,0,6,-17.647058823529413,100.0,100.0,0.0,100.0,52.56410256410257,47.43589743589743,Qualité
1739,0,2019-05-20,127750,DANIO 0% FRAISE 150X1,0,0,0,DANIO,0,Ferrières(FR),0078,0024 FR PARIS NORD (DC),294,468,468,246,222,222,0,0,174,-59.183673469387756,53,150,150,7,143,143,0,0,97,-183.0188679245283,100.0,4.666666666666667,95.33333333333333,100.0,52.56410256410257,47.43589743589743,Qualité
1740,1,2019-05-20,137032,ACTIVIA BRASSE NATURE 125X16 OD,0,0,0,ACTIVIA,0,StJust(FR),0083,0024 FR CHAPONNAY (DC),207,896,896,832,64,64,0,0,689,-332.8502415458937,207,207,207,143,64,64,0,0,0,0.0,100.0,69.08212560386472,30.917874396135275,100.0,92.85714285714286,7.142857142857139,Qualité
1741,0,2019-05-20,147230,L2V GOURMEUH MARRON VAN 115X2,0,1,0,LES 2 VACHES,0,LeMolay(FR),0084,0024 FR AIX (DC),119,271,156,153,3,118,115,0,152,-127.73109243697479,8,22,3,1,2,21,19,0,14,-175.0,13.636363636363635,4.545454545454546,9.09090909090909,57.564575645756456,56.457564575645755,1.1070110701107012,Production
1742,0,2019-05-20,147230,L2V GOURMEUH MARRON VAN 115X2,0,1,0,LES 2 VACHES,0,LeMolay(FR),0080,0024 FR METZ (DC),119,271,156,153,3,118,115,0,152,-127.73109243697479,74,81,66,66,0,15,15,0,7,-9.45945945945946,81.48148148148148,81.48148148148148,0.0,57.564575645756456,56.457564575645755,1.1070110701107012,Production
1743,0,2019-05-20,147230,L2V GOURMEUH MARRON VAN 115X2,0,1,0,LES 2 VACHES,0,LeMolay(FR),0081,0024 FR TOURS (DC),119,271,156,153,3,118,115,0,152,-127.73109243697479,8,12,12,12,0,0,0,0,4,-50.0,100.0,100.0,0.0,57.564575645756456,56.457564575645755,1.1070110701107012,Production
1744,0,2019-05-20,147230,L2V GOURMEUH MARRON VAN 115X2,0,1,0,LES 2 VACHES,0,LeMolay(FR),0082,0024 FR VALLET (DC),119,271,156,153,3,118,115,0,152,-127.73109243697479,10,65,35,35,0,30,30,0,55,-550.0,53.84615384615385,53.84615384615385,0.0,57.564575645756456,56.457564575645755,1.1070110701107012,Production
1745,0,2019-05-20,147230,L2V GOURMEUH MARRON VAN 115X2,0,1,0,LES 2 VACHES,0,LeMolay(FR),0083,0024 FR CHAPONNAY (DC),119,271,156,153,3,118,115,0,152,-127.73109243697479,10,49,20,19,1,30,29,0,39,-390.0,40.816326530612244,38.775510204081634,2.04081632653061,57.564575645756456,56.457564575645755,1.1070110701107012,Production
1746,0,2019-05-20,147230,L2V GOURMEUH MARRON VAN 115X2,0,1,0,LES 2 VACHES,0,LeMolay(FR),0079,0024 FR PARIS SUD (DC),119,271,156,153,3,118,115,0,152,-127.73109243697479,9,42,20,20,0,22,22,0,33,-366.6666666666667,47.61904761904761,47.61904761904761,0.0,57.564575645756456,56.457564575645755,1.1070110701107012,Production
1747,0,2019-05-21,5385,FJORD NATURE 125 x 4,0,0,0,FJORD,0,LeMolay(FR),0084,0024 FR AIX (DC),2904,2381,2381,1847,534,534,0,0,-523,18.009641873278238,268,304,304,287,17,17,0,0,36,-13.432835820895523,100.0,94.4078947368421,5.5921052631579045,100.0,77.57244855102898,22.427551448971016,Production
1748,1,2019-05-21,5385,FJORD NATURE 125 x 4,0,0,0,FJORD,0,LeMolay(FR),0084,0024 FR AIX (DC),2904,2381,2381,1847,534,534,0,0,-523,18.009641873278238,268,304,304,287,17,17,0,0,36,-13.432835820895523,100.0,94.4078947368421,5.5921052631579045,100.0,77.57244855102898,22.427551448971016,Production
1749,0,2019-05-21,5385,FJORD NATURE 125 x 4,0,0,0,FJORD,0,LeMolay(FR),0080,0024 FR METZ (DC),2904,2381,2381,1847,534,534,0,0,-523,18.009641873278238,132,101,101,101,0,0,0,0,-31,23.484848484848484,100.0,100.0,0.0,100.0,77.57244855102898,22.427551448971016,Production
1750,0,2019-05-21,5385,FJORD NATURE 125 x 4,0,0,0,FJORD,0,LeMolay(FR),0081,0024 FR TOURS (DC),2904,2381,2381,1847,534,534,0,0,-523,18.009641873278238,257,229,229,217,12,12,0,0,-28,10.894941634241246,100.0,94.75982532751091,5.24017467248909,100.0,77.57244855102898,22.427551448971016,Production
1751,0,2019-05-21,5385,FJORD NATURE 125 x 4,0,0,0,FJORD,0,LeMolay(FR),0082,0024 FR VALLET (DC),2904,2381,2381,1847,534,534,0,0,-523,18.009641873278238,161,135,135,111,24,24,0,0,-26,16.149068322981368,100.0,82.22222222222221,17.777777777777786,100.0,77.57244855102898,22.427551448971016,Production
1752,0,2019-05-21,5385,FJORD NATURE 125 x 4,0,0,0,FJORD,0,LeMolay(FR),0077,0024 FR LILPARK (DC),2904,2381,2381,1847,534,534,0,0,-523,18.009641873278238,93,126,126,85,41,41,0,0,33,-35.483870967741936,100.0,67.46031746031747,32.53968253968253,100.0,77.57244855102898,22.427551448971016,Production
1753,0,2019-05-21,5385,FJORD NATURE 125 x 4,0,0,0,FJORD,0,LeMolay(FR),0085,0024 FR TOULOUSE (DC),2904,2381,2381,1847,534,534,0,0,-523,18.009641873278238,245,275,275,154,121,121,0,0,30,-12.244897959183673,100.0,56.00000000000001,43.99999999999999,100.0,77.57244855102898,22.427551448971016,Production
1754,0,2019-05-21,5385,FJORD NATURE 125 x 4,0,0,0,FJORD,0,LeMolay(FR),0083,0024 FR CHAPONNAY (DC),2904,2381,2381,1847,534,534,0,0,-523,18.009641873278238,362,404,404,317,87,87,0,0,42,-11.602209944751381,100.0,78.46534653465346,21.534653465346537,100.0,77.57244855102898,22.427551448971016,Production
1755,1,2019-05-21,5385,FJORD NATURE 125 x 4,0,0,0,FJORD,0,LeMolay(FR),0083,0024 FR CHAPONNAY (DC),2904,2381,2381,1847,534,534,0,0,-523,18.009641873278238,362,404,404,317,87,87,0,0,42,-11.602209944751381,100.0,78.46534653465346,21.534653465346537,100.0,77.57244855102898,22.427551448971016,Production
1756,0,2019-05-21,5385,FJORD NATURE 125 x 4,0,0,0,FJORD,0,LeMolay(FR),0079,0024 FR PARIS SUD (DC),2904,2381,2381,1847,534,534,0,0,-523,18.009641873278238,487,487,487,406,81,81,0,0,0,0.0,100.0,83.3675564681725,16.632443531827505,100.0,77.57244855102898,22.427551448971016,Production
1757,0,2019-05-21,5385,FJORD NATURE 125 x 4,0,0,0,FJORD,0,LeMolay(FR),0078,0024 FR PARIS NORD (DC),2904,2381,2381,1847,534,534,0,0,-523,18.009641873278238,269,320,320,169,151,151,0,0,51,-18.95910780669145,100.0,52.81249999999999,47.18750000000001,100.0,77.57244855102898,22.427551448971016,Production
1758,0,2019-05-21,127750,DANIO 0% FRAISE 150X1,0,0,0,DANIO,0,Ferrières(FR),0084,0024 FR AIX (DC),368,635,222,132,90,503,413,0,267,-72.55434782608695,39,48,21,7,14,41,27,0,9,-23.076923076923077,43.75,14.583333333333334,29.166666666666664,34.960629921259844,20.787401574803148,14.173228346456696,Qualité
1759,0,2019-05-21,127750,DANIO 0% FRAISE 150X1,0,0,0,DANIO,0,Ferrières(FR),0080,0024 FR METZ (DC),368,635,222,132,90,503,413,0,267,-72.55434782608695,13,23,23,23,0,0,0,0,10,-76.92307692307692,100.0,100.0,0.0,34.960629921259844,20.787401574803148,14.173228346456696,Qualité
1760,0,2019-05-21,127750,DANIO 0% FRAISE 150X1,0,0,0,DANIO,0,Ferrières(FR),0081,0024 FR TOURS (DC),368,635,222,132,90,503,413,0,267,-72.55434782608695,55,46,30,30,0,16,16,0,-9,16.363636363636363,65.21739130434783,65.21739130434783,0.0,34.960629921259844,20.787401574803148,14.173228346456696,Qualité
1761,0,2019-05-21,127750,DANIO 0% FRAISE 150X1,0,0,0,DANIO,0,Ferrières(FR),0082,0024 FR VALLET (DC),368,635,222,132,90,503,413,0,267,-72.55434782608695,29,23,23,23,0,0,0,0,-6,20.689655172413794,100.0,100.0,0.0,34.960629921259844,20.787401574803148,14.173228346456696,Qualité
1762,0,2019-05-21,127750,DANIO 0% FRAISE 150X1,0,0,0,DANIO,0,Ferrières(FR),0077,0024 FR LILPARK (DC),368,635,222,132,90,503,413,0,267,-72.55434782608695,25,64,34,0,34,64,30,0,39,-156.0,53.125,0.0,53.125,34.960629921259844,20.787401574803148,14.173228346456696,Qualité
1763,0,2019-05-21,127750,DANIO 0% FRAISE 150X1,0,0,0,DANIO,0,Ferrières(FR),0085,0024 FR TOULOUSE (DC),368,635,222,132,90,503,413,0,267,-72.55434782608695,33,39,16,0,16,39,23,0,6,-18.181818181818183,41.02564102564102,0.0,41.02564102564102,34.960629921259844,20.787401574803148,14.173228346456696,Qualité
1764,0,2019-05-21,127750,DANIO 0% FRAISE 150X1,0,0,0,DANIO,0,Ferrières(FR),0083,0024 FR CHAPONNAY (DC),368,635,222,132,90,503,413,0,267,-72.55434782608695,42,49,49,49,0,0,0,0,7,-16.666666666666668,100.0,100.0,0.0,34.960629921259844,20.787401574803148,14.173228346456696,Qualité
1765,0,2019-05-21,127750,DANIO 0% FRAISE 150X1,0,0,0,DANIO,0,Ferrières(FR),0079,0024 FR PARIS SUD (DC),368,635,222,132,90,503,413,0,267,-72.55434782608695,85,196,7,0,7,196,189,0,111,-130.58823529411765,3.571428571428571,0.0,3.571428571428571,34.960629921259844,20.787401574803148,14.173228346456696,Qualité
1766,0,2019-05-21,127750,DANIO 0% FRAISE 150X1,0,0,0,DANIO,0,Ferrières(FR),0078,0024 FR PARIS NORD (DC),368,635,222,132,90,503,413,0,267,-72.55434782608695,47,147,19,0,19,147,128,0,100,-212.7659574468085,12.925170068027212,0.0,12.925170068027212,34.960629921259844,20.787401574803148,14.173228346456696,Qualité
1767,1,2019-05-21,137032,ACTIVIA BRASSE NATURE 125X16 OD,0,0,0,ACTIVIA,0,StJust(FR),0085,0024 FR TOULOUSE (DC),108,476,476,463,13,13,0,0,368,-340.74074074074076,108,108,108,95,13,13,0,0,0,0.0,100.0,87.96296296296296,12.037037037037038,100.0,97.26890756302521,2.731092436974791,Qualité
1768,0,2019-05-21,140838,ACTIVIA BIO NATURE 125X4,0,0,0,ACTIVIA,0,Bailleul(FR),0084,0024 FR AIX (DC),597,804,529,434,95,370,275,0,207,-34.67336683417086,71,91,72,72,0,19,19,0,20,-28.169014084507044,79.12087912087912,79.12087912087912,0.0,65.79601990049751,53.98009950248757,11.815920398009943,Qualité
1769,0,2019-05-21,140838,ACTIVIA BIO NATURE 125X4,0,0,0,ACTIVIA,0,Bailleul(FR),0080,0024 FR METZ (DC),597,804,529,434,95,370,275,0,207,-34.67336683417086,37,47,20,14,6,33,27,0,10,-27.027027027027028,42.5531914893617,29.78723404255319,12.76595744680851,65.79601990049751,53.98009950248757,11.815920398009943,Qualité
1770,0,2019-05-21,140838,ACTIVIA BIO NATURE 125X4,0,0,0,ACTIVIA,0,Bailleul(FR),0081,0024 FR TOURS (DC),597,804,529,434,95,370,275,0,207,-34.67336683417086,60,78,78,78,0,0,0,0,18,-30.0,100.0,100.0,0.0,65.79601990049751,53.98009950248757,11.815920398009943,Qualité
1771,0,2019-05-21,140838,ACTIVIA BIO NATURE 125X4,0,0,0,ACTIVIA,0,Bailleul(FR),0082,0024 FR VALLET (DC),597,804,529,434,95,370,275,0,207,-34.67336683417086,54,46,28,28,0,18,18,0,-8,14.814814814814815,60.86956521739131,60.86956521739131,0.0,65.79601990049751,53.98009950248757,11.815920398009943,Qualité
1772,0,2019-05-21,140838,ACTIVIA BIO NATURE 125X4,0,0,0,ACTIVIA,0,Bailleul(FR),0077,0024 FR LILPARK (DC),597,804,529,434,95,370,275,0,207,-34.67336683417086,32,31,31,31,0,0,0,0,-1,3.125,100.0,100.0,0.0,65.79601990049751,53.98009950248757,11.815920398009943,Qualité
1773,0,2019-05-21,140838,ACTIVIA BIO NATURE 125X4,0,0,0,ACTIVIA,0,Bailleul(FR),0085,0024 FR TOULOUSE (DC),597,804,529,434,95,370,275,0,207,-34.67336683417086,61,98,89,13,76,85,9,0,37,-60.65573770491803,90.81632653061224,13.26530612244898,77.55102040816327,65.79601990049751,53.98009950248757,11.815920398009943,Qualité
1774,0,2019-05-21,140838,ACTIVIA BIO NATURE 125X4,0,0,0,ACTIVIA,0,Bailleul(FR),0083,0024 FR CHAPONNAY (DC),597,804,529,434,95,370,275,0,207,-34.67336683417086,75,91,91,91,0,0,0,0,16,-21.333333333333332,100.0,100.0,0.0,65.79601990049751,53.98009950248757,11.815920398009943,Qualité
1775,0,2019-05-21,140838,ACTIVIA BIO NATURE 125X4,0,0,0,ACTIVIA,0,Bailleul(FR),0079,0024 FR PARIS SUD (DC),597,804,529,434,95,370,275,0,207,-34.67336683417086,153,160,104,103,1,57,56,0,7,-4.57516339869281,65.0,64.375,0.625,65.79601990049751,53.98009950248757,11.815920398009943,Qualité
1776,0,2019-05-21,140838,ACTIVIA BIO NATURE 125X4,0,0,0,ACTIVIA,0,Bailleul(FR),0078,0024 FR PARIS NORD (DC),597,804,529,434,95,370,275,0,207,-34.67336683417086,54,162,16,4,12,158,146,0,108,-200.0,9.876543209876543,2.4691358024691357,7.4074074074074066,65.79601990049751,53.98009950248757,11.815920398009943,Qualité
1777,0,2019-05-22,101200,DANETTE POP SAV VA 3 CHO 117X4,0,0,0,DANETTE,0,LeMolay(FR),0084,0024 FR AIX (DC),1467,1409,1235,1235,0,174,174,0,-58,3.9536468984321744,140,105,100,100,0,5,5,0,-35,25.0,95.23809523809523,95.23809523809523,0.0,87.65081618168914,87.65081618168914,0.0,A Creuser
1778,0,2019-05-22,101200,DANETTE POP SAV VA 3 CHO 117X4,0,0,0,DANETTE,0,LeMolay(FR),0080,0024 FR METZ (DC),1467,1409,1235,1235,0,174,174,0,-58,3.9536468984321744,132,150,113,113,0,37,37,0,18,-13.636363636363637,75.33333333333333,75.33333333333333,0.0,87.65081618168914,87.65081618168914,0.0,A Creuser
1779,0,2019-05-22,101200,DANETTE POP SAV VA 3 CHO 117X4,0,0,0,DANETTE,0,LeMolay(FR),0081,0024 FR TOURS (DC),1467,1409,1235,1235,0,174,174,0,-58,3.9536468984321744,140,146,135,135,0,11,11,0,6,-4.285714285714286,92.46575342465754,92.46575342465754,0.0,87.65081618168914,87.65081618168914,0.0,A Creuser
1780,0,2019-05-22,101200,DANETTE POP SAV VA 3 CHO 117X4,0,0,0,DANETTE,0,LeMolay(FR),0082,0024 FR VALLET (DC),1467,1409,1235,1235,0,174,174,0,-58,3.9536468984321744,183,261,149,149,0,112,112,0,78,-42.622950819672134,57.08812260536399,57.08812260536399,0.0,87.65081618168914,87.65081618168914,0.0,A Creuser
1781,0,2019-05-22,101200,DANETTE POP SAV VA 3 CHO 117X4,0,0,0,DANETTE,0,LeMolay(FR),0077,0024 FR LILPARK (DC),1467,1409,1235,1235,0,174,174,0,-58,3.9536468984321744,159,125,125,125,0,0,0,0,-34,21.38364779874214,100.0,100.0,0.0,87.65081618168914,87.65081618168914,0.0,A Creuser
1782,0,2019-05-22,101200,DANETTE POP SAV VA 3 CHO 117X4,0,0,0,DANETTE,0,LeMolay(FR),0085,0024 FR TOULOUSE (DC),1467,1409,1235,1235,0,174,174,0,-58,3.9536468984321744,219,204,195,195,0,9,9,0,-15,6.8493150684931505,95.58823529411765,95.58823529411765,0.0,87.65081618168914,87.65081618168914,0.0,A Creuser
1783,0,2019-05-22,101200,DANETTE POP SAV VA 3 CHO 117X4,0,0,0,DANETTE,0,LeMolay(FR),0083,0024 FR CHAPONNAY (DC),1467,1409,1235,1235,0,174,174,0,-58,3.9536468984321744,189,160,160,160,0,0,0,0,-29,15.343915343915343,100.0,100.0,0.0,87.65081618168914,87.65081618168914,0.0,A Creuser
1784,0,2019-05-22,101200,DANETTE POP SAV VA 3 CHO 117X4,0,0,0,DANETTE,0,LeMolay(FR),0079,0024 FR PARIS SUD (DC),1467,1409,1235,1235,0,174,174,0,-58,3.9536468984321744,182,127,127,127,0,0,0,0,-55,30.21978021978022,100.0,100.0,0.0,87.65081618168914,87.65081618168914,0.0,A Creuser
1785,0,2019-05-22,101200,DANETTE POP SAV VA 3 CHO 117X4,0,0,0,DANETTE,0,LeMolay(FR),0078,0024 FR PARIS NORD (DC),1467,1409,1235,1235,0,174,174,0,-58,3.9536468984321744,123,131,131,131,0,0,0,0,8,-6.504065040650406,100.0,100.0,0.0,87.65081618168914,87.65081618168914,0.0,A Creuser
1786,0,2019-05-22,113943,ACTIVIA NATURE 125X16 OD,1,0,0,ACTIVIA,0,Bailleul(FR),0080,0024 FR METZ (DC),620,569,489,424,65,145,80,0,-51,8.225806451612904,50,50,50,40,10,10,0,0,0,0.0,100.0,80.0,20.0,85.9402460456942,74.51669595782073,11.423550087873465,Qualité
1787,0,2019-05-22,113943,ACTIVIA NATURE 125X16 OD,1,0,0,ACTIVIA,0,Bailleul(FR),0081,0024 FR TOURS (DC),620,569,489,424,65,145,80,0,-51,8.225806451612904,147,147,147,93,54,54,0,0,0,0.0,100.0,63.26530612244898,36.73469387755102,85.9402460456942,74.51669595782073,11.423550087873465,Qualité
1788,1,2019-05-22,113943,ACTIVIA NATURE 125X16 OD,1,0,0,ACTIVIA,0,Bailleul(FR),0081,0024 FR TOURS (DC),620,569,489,424,65,145,80,0,-51,8.225806451612904,147,147,147,93,54,54,0,0,0,0.0,100.0,63.26530612244898,36.73469387755102,85.9402460456942,74.51669595782073,11.423550087873465,Qualité
1789,0,2019-05-22,113943,ACTIVIA NATURE 125X16 OD,1,0,0,ACTIVIA,0,Bailleul(FR),0082,0024 FR VALLET (DC),620,569,489,424,65,145,80,0,-51,8.225806451612904,68,56,56,56,0,0,0,0,-12,17.647058823529413,100.0,100.0,0.0,85.9402460456942,74.51669595782073,11.423550087873465,Qualité
1790,0,2019-05-22,113943,ACTIVIA NATURE 125X16 OD,1,0,0,ACTIVIA,0,Bailleul(FR),0085,0024 FR TOULOUSE (DC),620,569,489,424,65,145,80,0,-51,8.225806451612904,60,60,60,60,0,0,0,0,0,0.0,100.0,100.0,0.0,85.9402460456942,74.51669595782073,11.423550087873465,Qualité
1791,0,2019-05-22,113943,ACTIVIA NATURE 125X16 OD,1,0,0,ACTIVIA,0,Bailleul(FR),0083,0024 FR CHAPONNAY (DC),620,569,489,424,65,145,80,0,-51,8.225806451612904,88,88,88,88,0,0,0,0,0,0.0,100.0,100.0,0.0,85.9402460456942,74.51669595782073,11.423550087873465,Qualité
1792,0,2019-05-22,113943,ACTIVIA NATURE 125X16 OD,1,0,0,ACTIVIA,0,Bailleul(FR),0079,0024 FR PARIS SUD (DC),620,569,489,424,65,145,80,0,-51,8.225806451612904,0,108,28,27,1,81,80,1,108,10000.0,25.925925925925924,25.0,0.9259259259259238,85.9402460456942,74.51669595782073,11.423550087873465,Qualité
1793,0,2019-05-22,113943,ACTIVIA NATURE 125X16 OD,1,0,0,ACTIVIA,0,Bailleul(FR),0078,0024 FR PARIS NORD (DC),620,569,489,424,65,145,80,0,-51,8.225806451612904,60,60,60,60,0,0,0,0,0,0.0,100.0,100.0,0.0,85.9402460456942,74.51669595782073,11.423550087873465,Qualité
1794,0,2019-05-22,134010,VELOUTE FRUIX PANACHE 125X16 OD,1,0,0,VELOUTE,0,Villecomtal(FR),0084,0024 FR AIX (DC),443,3545,2550,2231,319,1314,995,0,3102,-700.2257336343115,442,442,442,442,0,0,0,0,0,0.0,100.0,100.0,0.0,71.93229901269393,62.933709449929474,8.998589562764458,A Creuser
1795,0,2019-05-22,134010,VELOUTE FRUIX PANACHE 125X16 OD,1,0,0,VELOUTE,0,Villecomtal(FR),0077,0024 FR LILPARK (DC),443,3545,2550,2231,319,1314,995,0,3102,-700.2257336343115,0,633,633,324,309,309,0,1,633,10000.0,100.0,51.18483412322274,48.81516587677726,71.93229901269393,62.933709449929474,8.998589562764458,A Creuser
1796,0,2019-05-22,134010,VELOUTE FRUIX PANACHE 125X16 OD,1,0,0,VELOUTE,0,Villecomtal(FR),0085,0024 FR TOULOUSE (DC),443,3545,2550,2231,319,1314,995,0,3102,-700.2257336343115,0,219,46,45,1,174,173,1,219,10000.0,21.00456621004566,20.54794520547945,0.4566210045662089,71.93229901269393,62.933709449929474,8.998589562764458,A Creuser
1797,0,2019-05-22,134010,VELOUTE FRUIX PANACHE 125X16 OD,1,0,0,VELOUTE,0,Villecomtal(FR),0083,0024 FR CHAPONNAY (DC),443,3545,2550,2231,319,1314,995,0,3102,-700.2257336343115,1,667,513,509,4,158,154,0,666,-66600.0,76.91154422788605,76.31184407796103,0.5997001499250274,71.93229901269393,62.933709449929474,8.998589562764458,A Creuser
1798,0,2019-05-22,134010,VELOUTE FRUIX PANACHE 125X16 OD,1,0,0,VELOUTE,0,Villecomtal(FR),0079,0024 FR PARIS SUD (DC),443,3545,2550,2231,319,1314,995,0,3102,-700.2257336343115,0,1112,444,439,5,673,668,1,1112,10000.0,39.92805755395683,39.47841726618705,0.4496402877697818,71.93229901269393,62.933709449929474,8.998589562764458,A Creuser
1799,0,2019-05-22,134010,VELOUTE FRUIX PANACHE 125X16 OD,1,0,0,VELOUTE,0,Villecomtal(FR),0078,0024 FR PARIS NORD (DC),443,3545,2550,2231,319,1314,995,0,3102,-700.2257336343115,0,472,472,472,0,0,0,1,472,10000.0,100.0,100.0,0.0,71.93229901269393,62.933709449929474,8.998589562764458,A Creuser
1800,1,2019-05-22,137032,ACTIVIA BRASSE NATURE 125X16 OD,0,0,0,ACTIVIA,0,StJust(FR),0081,0024 FR TOURS (DC),118,319,255,212,43,107,64,0,201,-170.33898305084745,87,87,87,57,30,30,0,0,0,0.0,100.0,65.51724137931035,34.48275862068965,79.9373040752351,66.4576802507837,13.479623824451409,Qualité
1801,1,2019-05-22,137032,ACTIVIA BRASSE NATURE 125X16 OD,0,0,0,ACTIVIA,0,StJust(FR),0085,0024 FR TOULOUSE (DC),118,319,255,212,43,107,64,0,201,-170.33898305084745,31,31,31,18,13,13,0,0,0,0.0,100.0,58.06451612903226,41.93548387096774,79.9373040752351,66.4576802507837,13.479623824451409,Qualité
1802,0,2019-05-22,139555,FJORD FRT FRAM CRAN 125X4,0,0,0,FJORD,0,LeMolay(FR),0080,0024 FR METZ (DC),125,116,42,41,1,75,74,0,-9,7.2,18,21,2,2,0,19,19,0,3,-16.666666666666668,9.523809523809524,9.523809523809524,0.0,36.206896551724135,35.3448275862069,0.8620689655172384,Production
1803,0,2019-05-22,139555,FJORD FRT FRAM CRAN 125X4,0,0,0,FJORD,0,LeMolay(FR),0077,0024 FR LILPARK (DC),125,116,42,41,1,75,74,0,-9,7.2,17,17,3,3,0,14,14,0,0,0.0,17.647058823529413,17.647058823529413,0.0,36.206896551724135,35.3448275862069,0.8620689655172384,Production
1804,0,2019-05-22,139555,FJORD FRT FRAM CRAN 125X4,0,0,0,FJORD,0,LeMolay(FR),0083,0024 FR CHAPONNAY (DC),125,116,42,41,1,75,74,0,-9,7.2,43,38,10,9,1,29,28,0,-5,11.627906976744185,26.31578947368421,23.684210526315788,2.6315789473684212,36.206896551724135,35.3448275862069,0.8620689655172384,Production
1805,0,2019-05-22,139555,FJORD FRT FRAM CRAN 125X4,0,0,0,FJORD,0,LeMolay(FR),0079,0024 FR PARIS SUD (DC),125,116,42,41,1,75,74,0,-9,7.2,47,40,27,27,0,13,13,0,-7,14.893617021276595,67.5,67.5,0.0,36.206896551724135,35.3448275862069,0.8620689655172384,Production
1806,0,2019-05-22,140280,Activia chia/raspb/muesli 170g FR-copack,0,0,0,ACTIVIA,1,Roumanie(RO),0080,0024 FR METZ (DC),195,307,132,73,59,234,175,0,112,-57.43589743589744,72,85,38,0,38,85,47,0,13,-18.055555555555557,44.70588235294118,0.0,44.70588235294118,42.99674267100978,23.778501628664493,19.218241042345284,Transport
1807,0,2019-05-22,140280,Activia chia/raspb/muesli 170g FR-copack,0,0,0,ACTIVIA,1,Roumanie(RO),0082,0024 FR VALLET (DC),195,307,132,73,59,234,175,0,112,-57.43589743589744,88,159,31,10,21,149,128,0,71,-80.68181818181819,19.49685534591195,6.289308176100629,13.20754716981132,42.99674267100978,23.778501628664493,19.218241042345284,Transport
1808,0,2019-05-22,140280,Activia chia/raspb/muesli 170g FR-copack,0,0,0,ACTIVIA,1,Roumanie(RO),0077,0024 FR LILPARK (DC),195,307,132,73,59,234,175,0,112,-57.43589743589744,35,63,63,63,0,0,0,0,28,-80.0,100.0,100.0,0.0,42.99674267100978,23.778501628664493,19.218241042345284,Transport
1809,0,2019-05-23,101202,DANETTE POP CHOC 3 CHOCO 117X4,0,0,0,DANETTE,0,LeMolay(FR),0084,0024 FR AIX (DC),3427,2938,2367,2362,5,576,571,0,-489,14.269039976655968,277,169,127,127,0,42,42,0,-108,38.98916967509025,75.14792899408283,75.14792899408283,0.0,80.56501021102791,80.39482641252553,0.17018379850237864,A Creuser
1810,0,2019-05-23,101202,DANETTE POP CHOC 3 CHOCO 117X4,0,0,0,DANETTE,0,LeMolay(FR),0080,0024 FR METZ (DC),3427,2938,2367,2362,5,576,571,0,-489,14.269039976655968,241,108,99,99,0,9,9,0,-133,55.18672199170125,91.66666666666666,91.66666666666666,0.0,80.56501021102791,80.39482641252553,0.17018379850237864,A Creuser
1811,0,2019-05-23,101202,DANETTE POP CHOC 3 CHOCO 117X4,0,0,0,DANETTE,0,LeMolay(FR),0081,0024 FR TOURS (DC),3427,2938,2367,2362,5,576,571,0,-489,14.269039976655968,517,447,447,447,0,0,0,0,-70,13.539651837524177,100.0,100.0,0.0,80.56501021102791,80.39482641252553,0.17018379850237864,A Creuser
1812,0,2019-05-23,101202,DANETTE POP CHOC 3 CHOCO 117X4,0,0,0,DANETTE,0,LeMolay(FR),0082,0024 FR VALLET (DC),3427,2938,2367,2362,5,576,571,0,-489,14.269039976655968,146,124,118,118,0,6,6,0,-22,15.068493150684931,95.16129032258065,95.16129032258065,0.0,80.56501021102791,80.39482641252553,0.17018379850237864,A Creuser
1813,0,2019-05-23,101202,DANETTE POP CHOC 3 CHOCO 117X4,0,0,0,DANETTE,0,LeMolay(FR),0077,0024 FR LILPARK (DC),3427,2938,2367,2362,5,576,571,0,-489,14.269039976655968,392,274,274,274,0,0,0,0,-118,30.102040816326532,100.0,100.0,0.0,80.56501021102791,80.39482641252553,0.17018379850237864,A Creuser
1814,0,2019-05-23,101202,DANETTE POP CHOC 3 CHOCO 117X4,0,0,0,DANETTE,0,LeMolay(FR),0085,0024 FR TOULOUSE (DC),3427,2938,2367,2362,5,576,571,0,-489,14.269039976655968,574,455,395,395,0,60,60,0,-119,20.73170731707317,86.81318681318682,86.81318681318682,0.0,80.56501021102791,80.39482641252553,0.17018379850237864,A Creuser
1815,0,2019-05-23,101202,DANETTE POP CHOC 3 CHOCO 117X4,0,0,0,DANETTE,0,LeMolay(FR),0083,0024 FR CHAPONNAY (DC),3427,2938,2367,2362,5,576,571,0,-489,14.269039976655968,505,415,415,415,0,0,0,0,-90,17.821782178217823,100.0,100.0,0.0,80.56501021102791,80.39482641252553,0.17018379850237864,A Creuser
1816,0,2019-05-23,101202,DANETTE POP CHOC 3 CHOCO 117X4,0,0,0,DANETTE,0,LeMolay(FR),0079,0024 FR PARIS SUD (DC),3427,2938,2367,2362,5,576,571,0,-489,14.269039976655968,491,760,318,313,5,447,442,0,269,-54.78615071283096,41.8421052631579,41.18421052631579,0.6578947368421098,80.56501021102791,80.39482641252553,0.17018379850237864,A Creuser
1817,0,2019-05-23,101202,DANETTE POP CHOC 3 CHOCO 117X4,0,0,0,DANETTE,0,LeMolay(FR),0078,0024 FR PARIS NORD (DC),3427,2938,2367,2362,5,576,571,0,-489,14.269039976655968,284,186,174,174,0,12,12,0,-98,34.50704225352113,93.54838709677419,93.54838709677419,0.0,80.56501021102791,80.39482641252553,0.17018379850237864,A Creuser
1818,0,2019-05-23,134010,VELOUTE FRUIX PANACHE 125X16 OD,1,0,0,VELOUTE,0,Villecomtal(FR),0084,0024 FR AIX (DC),825,1481,874,865,9,616,607,0,656,-79.51515151515152,78,78,78,77,1,1,0,0,0,0.0,100.0,98.71794871794873,1.2820512820512704,59.01417960837272,58.40648210668468,0.6076975016880439,A Creuser
1819,0,2019-05-23,134010,VELOUTE FRUIX PANACHE 125X16 OD,1,0,0,VELOUTE,0,Villecomtal(FR),0082,0024 FR VALLET (DC),825,1481,874,865,9,616,607,0,656,-79.51515151515152,179,561,9,1,8,560,552,0,382,-213.40782122905028,1.6042780748663104,0.17825311942959002,1.4260249554367204,59.01417960837272,58.40648210668468,0.6076975016880439,A Creuser
1820,0,2019-05-23,134010,VELOUTE FRUIX PANACHE 125X16 OD,1,0,0,VELOUTE,0,Villecomtal(FR),0085,0024 FR TOULOUSE (DC),825,1481,874,865,9,616,607,0,656,-79.51515151515152,158,322,267,267,0,55,55,0,164,-103.79746835443038,82.91925465838509,82.91925465838509,0.0,59.01417960837272,58.40648210668468,0.6076975016880439,A Creuser
1821,0,2019-05-23,134010,VELOUTE FRUIX PANACHE 125X16 OD,1,0,0,VELOUTE,0,Villecomtal(FR),0078,0024 FR PARIS NORD (DC),825,1481,874,865,9,616,607,0,656,-79.51515151515152,410,520,520,520,0,0,0,0,110,-26.829268292682926,100.0,100.0,0.0,59.01417960837272,58.40648210668468,0.6076975016880439,A Creuser
1822,1,2019-05-23,139547,FJORD MYRTILLES SAUVAGES 125X4,0,0,0,FJORD,0,LeMolay(FR),0079,0024 FR PARIS SUD (DC),68,194,107,91,16,103,87,0,126,-185.2941176470588,68,63,34,34,0,29,29,0,-5,7.352941176470588,53.96825396825397,53.96825396825397,0.0,55.154639175257735,46.90721649484536,8.247422680412377,Production
1823,0,2019-05-23,146531,L2V BRASS NAT 115X4,0,1,0,LES 2 VACHES,0,LeMolay(FR),0084,0024 FR AIX (DC),3081,3673,3173,3169,4,504,500,0,592,-19.214540733528075,855,985,822,818,4,167,163,0,130,-15.2046783625731,83.4517766497462,83.04568527918782,0.4060913705583715,86.38714946909883,86.27824666485162,0.108902804247208,Production
1824,0,2019-05-23,146531,L2V BRASS NAT 115X4,0,1,0,LES 2 VACHES,0,LeMolay(FR),0080,0024 FR METZ (DC),3081,3673,3173,3169,4,504,500,0,592,-19.214540733528075,166,121,121,121,0,0,0,0,-45,27.10843373493976,100.0,100.0,0.0,86.38714946909883,86.27824666485162,0.108902804247208,Production
1825,0,2019-05-23,146531,L2V BRASS NAT 115X4,0,1,0,LES 2 VACHES,0,LeMolay(FR),0081,0024 FR TOURS (DC),3081,3673,3173,3169,4,504,500,0,592,-19.214540733528075,317,315,315,315,0,0,0,0,-2,0.6309148264984227,100.0,100.0,0.0,86.38714946909883,86.27824666485162,0.108902804247208,Production
1826,0,2019-05-23,146531,L2V BRASS NAT 115X4,0,1,0,LES 2 VACHES,0,LeMolay(FR),0082,0024 FR VALLET (DC),3081,3673,3173,3169,4,504,500,0,592,-19.214540733528075,257,236,236,236,0,0,0,0,-21,8.171206225680933,100.0,100.0,0.0,86.38714946909883,86.27824666485162,0.108902804247208,Production
1827,0,2019-05-23,146531,L2V BRASS NAT 115X4,0,1,0,LES 2 VACHES,0,LeMolay(FR),0077,0024 FR LILPARK (DC),3081,3673,3173,3169,4,504,500,0,592,-19.214540733528075,133,181,171,171,0,10,10,0,48,-36.090225563909776,94.47513812154696,94.47513812154696,0.0,86.38714946909883,86.27824666485162,0.108902804247208,Production
1828,0,2019-05-23,146531,L2V BRASS NAT 115X4,0,1,0,LES 2 VACHES,0,LeMolay(FR),0085,0024 FR TOULOUSE (DC),3081,3673,3173,3169,4,504,500,0,592,-19.214540733528075,292,333,333,333,0,0,0,0,41,-14.04109589041096,100.0,100.0,0.0,86.38714946909883,86.27824666485162,0.108902804247208,Production
1829,0,2019-05-23,146531,L2V BRASS NAT 115X4,0,1,0,LES 2 VACHES,0,LeMolay(FR),0083,0024 FR CHAPONNAY (DC),3081,3673,3173,3169,4,504,500,0,592,-19.214540733528075,405,440,440,440,0,0,0,0,35,-8.641975308641975,100.0,100.0,0.0,86.38714946909883,86.27824666485162,0.108902804247208,Production
1830,0,2019-05-23,146531,L2V BRASS NAT 115X4,0,1,0,LES 2 VACHES,0,LeMolay(FR),0079,0024 FR PARIS SUD (DC),3081,3673,3173,3169,4,504,500,0,592,-19.214540733528075,419,858,532,532,0,326,326,0,439,-104.77326968973748,62.004662004662,62.004662004662,0.0,86.38714946909883,86.27824666485162,0.108902804247208,Production
1831,0,2019-05-23,146531,L2V BRASS NAT 115X4,0,1,0,LES 2 VACHES,0,LeMolay(FR),0078,0024 FR PARIS NORD (DC),3081,3673,3173,3169,4,504,500,0,592,-19.214540733528075,237,204,203,203,0,1,1,0,-33,13.924050632911392,99.50980392156863,99.50980392156863,0.0,86.38714946909883,86.27824666485162,0.108902804247208,Production
1832,0,2019-05-23,146543,L2V BRASS MYRT 115X4,0,1,0,LES 2 VACHES,0,LeMolay(FR),0084,0024 FR AIX (DC),4864,5718,5405,5405,0,313,313,0,854,-17.557565789473685,418,399,399,399,0,0,0,0,-19,4.545454545454546,100.0,100.0,0.0,94.52605806225954,94.52605806225954,0.0,Production
1833,0,2019-05-23,146543,L2V BRASS MYRT 115X4,0,1,0,LES 2 VACHES,0,LeMolay(FR),0080,0024 FR METZ (DC),4864,5718,5405,5405,0,313,313,0,854,-17.557565789473685,198,176,99,99,0,77,77,0,-22,11.11111111111111,56.25,56.25,0.0,94.52605806225954,94.52605806225954,0.0,Production
1834,0,2019-05-23,146543,L2V BRASS MYRT 115X4,0,1,0,LES 2 VACHES,0,LeMolay(FR),0081,0024 FR TOURS (DC),4864,5718,5405,5405,0,313,313,0,854,-17.557565789473685,421,891,758,758,0,133,133,0,470,-111.63895486935867,85.0729517396184,85.0729517396184,0.0,94.52605806225954,94.52605806225954,0.0,Production
1835,0,2019-05-23,146543,L2V BRASS MYRT 115X4,0,1,0,LES 2 VACHES,0,LeMolay(FR),0082,0024 FR VALLET (DC),4864,5718,5405,5405,0,313,313,0,854,-17.557565789473685,315,406,406,406,0,0,0,0,91,-28.88888888888889,100.0,100.0,0.0,94.52605806225954,94.52605806225954,0.0,Production
1836,0,2019-05-23,146543,L2V BRASS MYRT 115X4,0,1,0,LES 2 VACHES,0,LeMolay(FR),0077,0024 FR LILPARK (DC),4864,5718,5405,5405,0,313,313,0,854,-17.557565789473685,705,618,618,618,0,0,0,0,-87,12.340425531914894,100.0,100.0,0.0,94.52605806225954,94.52605806225954,0.0,Production
1837,0,2019-05-23,146543,L2V BRASS MYRT 115X4,0,1,0,LES 2 VACHES,0,LeMolay(FR),0085,0024 FR TOULOUSE (DC),4864,5718,5405,5405,0,313,313,0,854,-17.557565789473685,476,606,606,606,0,0,0,0,130,-27.310924369747898,100.0,100.0,0.0,94.52605806225954,94.52605806225954,0.0,Production
1838,0,2019-05-23,146543,L2V BRASS MYRT 115X4,0,1,0,LES 2 VACHES,0,LeMolay(FR),0083,0024 FR CHAPONNAY (DC),4864,5718,5405,5405,0,313,313,0,854,-17.557565789473685,924,899,899,899,0,0,0,0,-25,2.705627705627706,100.0,100.0,0.0,94.52605806225954,94.52605806225954,0.0,Production
1839,0,2019-05-23,146543,L2V BRASS MYRT 115X4,0,1,0,LES 2 VACHES,0,LeMolay(FR),0079,0024 FR PARIS SUD (DC),4864,5718,5405,5405,0,313,313,0,854,-17.557565789473685,773,1063,966,966,0,97,97,0,290,-37.51617076326003,90.87488240827845,90.87488240827845,0.0,94.52605806225954,94.52605806225954,0.0,Production
1840,0,2019-05-23,146543,L2V BRASS MYRT 115X4,0,1,0,LES 2 VACHES,0,LeMolay(FR),0078,0024 FR PARIS NORD (DC),4864,5718,5405,5405,0,313,313,0,854,-17.557565789473685,634,660,654,654,0,6,6,0,26,-4.100946372239748,99.0909090909091,99.0909090909091,0.0,94.52605806225954,94.52605806225954,0.0,Production
1841,0,2019-05-24,25528,DANACOL DR PLAIN 0% 100GX4 FR,0,0,0,DANACOL,1,Aldaya(ES),0082,0024 FR VALLET (DC),96,91,66,13,53,78,25,0,-5,5.208333333333333,36,46,46,0,46,46,0,0,10,-27.77777777777778,100.0,0.0,100.0,72.52747252747253,14.285714285714285,58.24175824175824,Production
1842,0,2019-05-24,25528,DANACOL DR PLAIN 0% 100GX4 FR,0,0,0,DANACOL,1,Aldaya(ES),0077,0024 FR LILPARK (DC),96,91,66,13,53,78,25,0,-5,5.208333333333333,18,13,8,6,2,7,5,0,-5,27.77777777777778,61.53846153846154,46.15384615384615,15.384615384615387,72.52747252747253,14.285714285714285,58.24175824175824,Production
1843,0,2019-05-24,25528,DANACOL DR PLAIN 0% 100GX4 FR,0,0,0,DANACOL,1,Aldaya(ES),0085,0024 FR TOULOUSE (DC),96,91,66,13,53,78,25,0,-5,5.208333333333333,42,32,12,7,5,25,20,0,-10,23.80952380952381,37.5,21.875,15.625,72.52747252747253,14.285714285714285,58.24175824175824,Production
1844,1,2019-05-24,136436,ACTIVIA FRT CERISE 125X4 OD,1,0,0,ACTIVIA,0,Villecomtal(FR),0077,0024 FR LILPARK (DC),263,618,618,543,75,75,0,0,355,-134.9809885931559,263,225,225,150,75,75,0,0,-38,14.448669201520913,100.0,66.66666666666666,33.33333333333334,100.0,87.86407766990291,12.135922330097088,A Creuser
1845,0,2019-05-24,146531,L2V BRASS NAT 115X4,0,1,0,LES 2 VACHES,0,LeMolay(FR),0080,0024 FR METZ (DC),1975,1980,911,901,10,1079,1069,0,5,-0.25316455696202533,188,344,198,190,8,154,146,0,156,-82.97872340425532,57.55813953488372,55.23255813953488,2.3255813953488413,46.01010101010101,45.505050505050505,0.5050505050505052,Production
1846,0,2019-05-24,146531,L2V BRASS NAT 115X4,0,1,0,LES 2 VACHES,0,LeMolay(FR),0081,0024 FR TOURS (DC),1975,1980,911,901,10,1079,1069,0,5,-0.25316455696202533,308,326,326,326,0,0,0,0,18,-5.8441558441558445,100.0,100.0,0.0,46.01010101010101,45.505050505050505,0.5050505050505052,Production
1847,0,2019-05-24,146531,L2V BRASS NAT 115X4,0,1,0,LES 2 VACHES,0,LeMolay(FR),0082,0024 FR VALLET (DC),1975,1980,911,901,10,1079,1069,0,5,-0.25316455696202533,262,232,204,204,0,28,28,0,-30,11.450381679389313,87.93103448275862,87.93103448275862,0.0,46.01010101010101,45.505050505050505,0.5050505050505052,Production
1848,0,2019-05-24,146531,L2V BRASS NAT 115X4,0,1,0,LES 2 VACHES,0,LeMolay(FR),0077,0024 FR LILPARK (DC),1975,1980,911,901,10,1079,1069,0,5,-0.25316455696202533,126,164,2,0,2,164,162,0,38,-30.158730158730158,1.2195121951219512,0.0,1.2195121951219512,46.01010101010101,45.505050505050505,0.5050505050505052,Production
1849,0,2019-05-24,146531,L2V BRASS NAT 115X4,0,1,0,LES 2 VACHES,0,LeMolay(FR),0085,0024 FR TOULOUSE (DC),1975,1980,911,901,10,1079,1069,0,5,-0.25316455696202533,367,311,98,98,0,213,213,0,-56,15.258855585831062,31.511254019292608,31.511254019292608,0.0,46.01010101010101,45.505050505050505,0.5050505050505052,Production
1850,0,2019-05-24,146531,L2V BRASS NAT 115X4,0,1,0,LES 2 VACHES,0,LeMolay(FR),0083,0024 FR CHAPONNAY (DC),1975,1980,911,901,10,1079,1069,0,5,-0.25316455696202533,436,326,52,52,0,274,274,0,-110,25.229357798165136,15.950920245398773,15.950920245398773,0.0,46.01010101010101,45.505050505050505,0.5050505050505052,Production
1851,0,2019-05-24,146531,L2V BRASS NAT 115X4,0,1,0,LES 2 VACHES,0,LeMolay(FR),0078,0024 FR PARIS NORD (DC),1975,1980,911,901,10,1079,1069,0,5,-0.25316455696202533,288,277,31,31,0,246,246,0,-11,3.8194444444444446,11.191335740072201,11.191335740072201,0.0,46.01010101010101,45.505050505050505,0.5050505050505052,Production
1852,0,2019-05-25,25528,DANACOL DR PLAIN 0% 100GX4 FR,0,0,0,DANACOL,1,Aldaya(ES),0082,0024 FR VALLET (DC),97,187,133,83,50,104,54,0,90,-92.78350515463917,20,46,46,0,46,46,0,0,26,-130.0,100.0,0.0,100.0,71.12299465240642,44.38502673796791,26.737967914438507,Production
1853,0,2019-05-25,25528,DANACOL DR PLAIN 0% 100GX4 FR,0,0,0,DANACOL,1,Aldaya(ES),0077,0024 FR LILPARK (DC),97,187,133,83,50,104,54,0,90,-92.78350515463917,21,57,4,0,4,57,53,0,36,-171.42857142857142,7.017543859649122,0.0,7.017543859649122,71.12299465240642,44.38502673796791,26.737967914438507,Production
1854,0,2019-05-25,25528,DANACOL DR PLAIN 0% 100GX4 FR,0,0,0,DANACOL,1,Aldaya(ES),0085,0024 FR TOULOUSE (DC),97,187,133,83,50,104,54,0,90,-92.78350515463917,56,84,83,83,0,1,1,0,28,-50.0,98.80952380952381,98.80952380952381,0.0,71.12299465240642,44.38502673796791,26.737967914438507,Production
1855,0,2019-05-25,127763,DANIO 0% FRAMBOISE 150X1,0,0,0,DANIO,0,Ferrières(FR),0084,0024 FR AIX (DC),221,190,35,34,1,156,155,0,-31,14.027149321266968,22,32,5,4,1,28,27,0,10,-45.45454545454545,15.625,12.5,3.125,18.421052631578945,17.894736842105264,0.5263157894736814,Qualité
1856,0,2019-05-25,127763,DANIO 0% FRAMBOISE 150X1,0,0,0,DANIO,0,Ferrières(FR),0080,0024 FR METZ (DC),221,190,35,34,1,156,155,0,-31,14.027149321266968,14,8,8,8,0,0,0,0,-6,42.857142857142854,100.0,100.0,0.0,18.421052631578945,17.894736842105264,0.5263157894736814,Qualité
1857,0,2019-05-25,127763,DANIO 0% FRAMBOISE 150X1,0,0,0,DANIO,0,Ferrières(FR),0083,0024 FR CHAPONNAY (DC),221,190,35,34,1,156,155,0,-31,14.027149321266968,53,18,9,9,0,9,9,0,-35,66.0377358490566,50.0,50.0,0.0,18.421052631578945,17.894736842105264,0.5263157894736814,Qualité
1858,0,2019-05-25,127763,DANIO 0% FRAMBOISE 150X1,0,0,0,DANIO,0,Ferrières(FR),0079,0024 FR PARIS SUD (DC),221,190,35,34,1,156,155,0,-31,14.027149321266968,132,132,13,13,0,119,119,0,0,0.0,9.848484848484848,9.848484848484848,0.0,18.421052631578945,17.894736842105264,0.5263157894736814,Qualité
1859,0,2019-05-25,139408,ALPRO COCO DRINK CHOCOLATE 1LX8,0,0,0,ALPRO,1,Wevelgem(BE),0081,0024 FR TOURS (DC),363,188,171,1,170,187,17,0,-175,48.209366391184574,4,5,4,0,4,5,1,0,1,-25.0,80.0,0.0,80.0,90.95744680851064,0.5319148936170213,90.42553191489361,A Creuser
1860,0,2019-05-25,139408,ALPRO COCO DRINK CHOCOLATE 1LX8,0,0,0,ALPRO,1,Wevelgem(BE),0085,0024 FR TOULOUSE (DC),363,188,171,1,170,187,17,0,-175,48.209366391184574,161,142,142,0,142,142,0,0,-19,11.801242236024844,100.0,0.0,100.0,90.95744680851064,0.5319148936170213,90.42553191489361,A Creuser
1861,1,2019-05-25,139408,ALPRO COCO DRINK CHOCOLATE 1LX8,0,0,0,ALPRO,1,Wevelgem(BE),0085,0024 FR TOULOUSE (DC),363,188,171,1,170,187,17,0,-175,48.209366391184574,161,142,142,0,142,142,0,0,-19,11.801242236024844,100.0,0.0,100.0,90.95744680851064,0.5319148936170213,90.42553191489361,A Creuser
1862,0,2019-05-25,139408,ALPRO COCO DRINK CHOCOLATE 1LX8,0,0,0,ALPRO,1,Wevelgem(BE),0083,0024 FR CHAPONNAY (DC),363,188,171,1,170,187,17,0,-175,48.209366391184574,10,1,1,1,0,0,0,0,-9,90.0,100.0,100.0,0.0,90.95744680851064,0.5319148936170213,90.42553191489361,A Creuser
1863,0,2019-05-25,139408,ALPRO COCO DRINK CHOCOLATE 1LX8,0,0,0,ALPRO,1,Wevelgem(BE),0079,0024 FR PARIS SUD (DC),363,188,171,1,170,187,17,0,-175,48.209366391184574,3,15,2,0,2,15,13,0,12,-400.0,13.333333333333334,0.0,13.333333333333334,90.95744680851064,0.5319148936170213,90.42553191489361,A Creuser
1864,0,2019-05-25,139408,ALPRO COCO DRINK CHOCOLATE 1LX8,0,0,0,ALPRO,1,Wevelgem(BE),0078,0024 FR PARIS NORD (DC),363,188,171,1,170,187,17,0,-175,48.209366391184574,24,25,22,0,22,25,3,0,1,-4.166666666666667,88.0,0.0,88.0,90.95744680851064,0.5319148936170213,90.42553191489361,A Creuser
1865,0,2019-05-25,146376,L2V BRASS VAN 115X4,0,1,0,LES 2 VACHES,0,LeMolay(FR),0084,0024 FR AIX (DC),3438,4707,4353,4319,34,388,354,0,1269,-36.910994764397905,383,505,505,505,0,0,0,0,122,-31.85378590078329,100.0,100.0,0.0,92.47928616953473,91.7569577225409,0.7223284469938278,Production
1866,0,2019-05-25,146376,L2V BRASS VAN 115X4,0,1,0,LES 2 VACHES,0,LeMolay(FR),0080,0024 FR METZ (DC),3438,4707,4353,4319,34,388,354,0,1269,-36.910994764397905,137,208,208,208,0,0,0,0,71,-51.824817518248175,100.0,100.0,0.0,92.47928616953473,91.7569577225409,0.7223284469938278,Production
1867,0,2019-05-25,146376,L2V BRASS VAN 115X4,0,1,0,LES 2 VACHES,0,LeMolay(FR),0081,0024 FR TOURS (DC),3438,4707,4353,4319,34,388,354,0,1269,-36.910994764397905,435,492,492,492,0,0,0,0,57,-13.10344827586207,100.0,100.0,0.0,92.47928616953473,91.7569577225409,0.7223284469938278,Production
1868,0,2019-05-25,146376,L2V BRASS VAN 115X4,0,1,0,LES 2 VACHES,0,LeMolay(FR),0082,0024 FR VALLET (DC),3438,4707,4353,4319,34,388,354,0,1269,-36.910994764397905,323,543,543,543,0,0,0,0,220,-68.11145510835914,100.0,100.0,0.0,92.47928616953473,91.7569577225409,0.7223284469938278,Production
1869,0,2019-05-25,146376,L2V BRASS VAN 115X4,0,1,0,LES 2 VACHES,0,LeMolay(FR),0077,0024 FR LILPARK (DC),3438,4707,4353,4319,34,388,354,0,1269,-36.910994764397905,93,159,135,133,2,26,24,0,66,-70.96774193548387,84.90566037735849,83.64779874213836,1.2578616352201237,92.47928616953473,91.7569577225409,0.7223284469938278,Production
1870,0,2019-05-25,146376,L2V BRASS VAN 115X4,0,1,0,LES 2 VACHES,0,LeMolay(FR),0085,0024 FR TOULOUSE (DC),3438,4707,4353,4319,34,388,354,0,1269,-36.910994764397905,256,370,370,370,0,0,0,0,114,-44.53125,100.0,100.0,0.0,92.47928616953473,91.7569577225409,0.7223284469938278,Production
1871,0,2019-05-25,146376,L2V BRASS VAN 115X4,0,1,0,LES 2 VACHES,0,LeMolay(FR),0083,0024 FR CHAPONNAY (DC),3438,4707,4353,4319,34,388,354,0,1269,-36.910994764397905,480,691,679,679,0,12,12,0,211,-43.958333333333336,98.26338639652677,98.26338639652677,0.0,92.47928616953473,91.7569577225409,0.7223284469938278,Production
1872,0,2019-05-25,146376,L2V BRASS VAN 115X4,0,1,0,LES 2 VACHES,0,LeMolay(FR),0079,0024 FR PARIS SUD (DC),3438,4707,4353,4319,34,388,354,0,1269,-36.910994764397905,567,1012,694,662,32,350,318,0,445,-78.48324514991182,68.57707509881423,65.41501976284584,3.1620553359683896,92.47928616953473,91.7569577225409,0.7223284469938278,Production
1873,0,2019-05-25,146376,L2V BRASS VAN 115X4,0,1,0,LES 2 VACHES,0,LeMolay(FR),0078,0024 FR PARIS NORD (DC),3438,4707,4353,4319,34,388,354,0,1269,-36.910994764397905,764,727,727,727,0,0,0,0,-37,4.842931937172775,100.0,100.0,0.0,92.47928616953473,91.7569577225409,0.7223284469938278,Production
1874,0,2019-05-25,146534,L2V BRASS CIT 115X4,0,1,0,LES 2 VACHES,0,LeMolay(FR),0084,0024 FR AIX (DC),1642,1685,793,792,1,893,892,0,43,-2.6187576126674785,245,228,116,116,0,112,112,0,-17,6.938775510204081,50.877192982456144,50.877192982456144,0.0,47.06231454005935,47.002967359050444,0.059347181008902794,Production
1875,0,2019-05-25,146534,L2V BRASS CIT 115X4,0,1,0,LES 2 VACHES,0,LeMolay(FR),0080,0024 FR METZ (DC),1642,1685,793,792,1,893,892,0,43,-2.6187576126674785,36,71,2,2,0,69,69,0,35,-97.22222222222223,2.8169014084507045,2.8169014084507045,0.0,47.06231454005935,47.002967359050444,0.059347181008902794,Production
1876,0,2019-05-25,146534,L2V BRASS CIT 115X4,0,1,0,LES 2 VACHES,0,LeMolay(FR),0081,0024 FR TOURS (DC),1642,1685,793,792,1,893,892,0,43,-2.6187576126674785,197,217,47,47,0,170,170,0,20,-10.152284263959391,21.658986175115206,21.658986175115206,0.0,47.06231454005935,47.002967359050444,0.059347181008902794,Production
1877,0,2019-05-25,146534,L2V BRASS CIT 115X4,0,1,0,LES 2 VACHES,0,LeMolay(FR),0082,0024 FR VALLET (DC),1642,1685,793,792,1,893,892,0,43,-2.6187576126674785,303,313,120,120,0,193,193,0,10,-3.3003300330033003,38.33865814696485,38.33865814696485,0.0,47.06231454005935,47.002967359050444,0.059347181008902794,Production
1878,0,2019-05-25,146534,L2V BRASS CIT 115X4,0,1,0,LES 2 VACHES,0,LeMolay(FR),0077,0024 FR LILPARK (DC),1642,1685,793,792,1,893,892,0,43,-2.6187576126674785,114,110,94,93,1,17,16,0,-4,3.508771929824561,85.45454545454545,84.54545454545455,0.9090909090909065,47.06231454005935,47.002967359050444,0.059347181008902794,Production
1879,0,2019-05-25,146534,L2V BRASS CIT 115X4,0,1,0,LES 2 VACHES,0,LeMolay(FR),0085,0024 FR TOULOUSE (DC),1642,1685,793,792,1,893,892,0,43,-2.6187576126674785,83,115,21,21,0,94,94,0,32,-38.55421686746988,18.26086956521739,18.26086956521739,0.0,47.06231454005935,47.002967359050444,0.059347181008902794,Production
1880,0,2019-05-25,146534,L2V BRASS CIT 115X4,0,1,0,LES 2 VACHES,0,LeMolay(FR),0083,0024 FR CHAPONNAY (DC),1642,1685,793,792,1,893,892,0,43,-2.6187576126674785,340,342,236,236,0,106,106,0,2,-0.5882352941176471,69.00584795321637,69.00584795321637,0.0,47.06231454005935,47.002967359050444,0.059347181008902794,Production
1881,0,2019-05-25,146534,L2V BRASS CIT 115X4,0,1,0,LES 2 VACHES,0,LeMolay(FR),0079,0024 FR PARIS SUD (DC),1642,1685,793,792,1,893,892,0,43,-2.6187576126674785,163,201,92,92,0,109,109,0,38,-23.312883435582823,45.77114427860697,45.77114427860697,0.0,47.06231454005935,47.002967359050444,0.059347181008902794,Production
1882,0,2019-05-25,146534,L2V BRASS CIT 115X4,0,1,0,LES 2 VACHES,0,LeMolay(FR),0078,0024 FR PARIS NORD (DC),1642,1685,793,792,1,893,892,0,43,-2.6187576126674785,161,88,65,65,0,23,23,0,-73,45.3416149068323,73.86363636363636,73.86363636363636,0.0,47.06231454005935,47.002967359050444,0.059347181008902794,Production
1883,0,2019-05-25,146543,L2V BRASS MYRT 115X4,0,1,0,LES 2 VACHES,0,LeMolay(FR),0084,0024 FR AIX (DC),2815,3175,926,924,2,2251,2249,0,360,-12.788632326820604,343,360,17,17,0,343,343,0,17,-4.956268221574344,4.722222222222222,4.722222222222222,0.0,29.16535433070866,29.102362204724407,0.06299212598425186,Production
1884,1,2019-05-25,146543,L2V BRASS MYRT 115X4,0,1,0,LES 2 VACHES,0,LeMolay(FR),0084,0024 FR AIX (DC),2815,3175,926,924,2,2251,2249,0,360,-12.788632326820604,343,360,17,17,0,343,343,0,17,-4.956268221574344,4.722222222222222,4.722222222222222,0.0,29.16535433070866,29.102362204724407,0.06299212598425186,Production
1885,0,2019-05-25,146543,L2V BRASS MYRT 115X4,0,1,0,LES 2 VACHES,0,LeMolay(FR),0080,0024 FR METZ (DC),2815,3175,926,924,2,2251,2249,0,360,-12.788632326820604,97,185,1,0,1,185,184,0,88,-90.72164948453609,0.5405405405405406,0.0,0.5405405405405406,29.16535433070866,29.102362204724407,0.06299212598425186,Production
1886,0,2019-05-25,146543,L2V BRASS MYRT 115X4,0,1,0,LES 2 VACHES,0,LeMolay(FR),0081,0024 FR TOURS (DC),2815,3175,926,924,2,2251,2249,0,360,-12.788632326820604,301,401,65,65,0,336,336,0,100,-33.222591362126245,16.209476309226932,16.209476309226932,0.0,29.16535433070866,29.102362204724407,0.06299212598425186,Production
1887,0,2019-05-25,146543,L2V BRASS MYRT 115X4,0,1,0,LES 2 VACHES,0,LeMolay(FR),0082,0024 FR VALLET (DC),2815,3175,926,924,2,2251,2249,0,360,-12.788632326820604,384,408,156,156,0,252,252,0,24,-6.25,38.23529411764706,38.23529411764706,0.0,29.16535433070866,29.102362204724407,0.06299212598425186,Production
1888,0,2019-05-25,146543,L2V BRASS MYRT 115X4,0,1,0,LES 2 VACHES,0,LeMolay(FR),0077,0024 FR LILPARK (DC),2815,3175,926,924,2,2251,2249,0,360,-12.788632326820604,213,265,157,157,0,108,108,0,52,-24.413145539906104,59.24528301886792,59.24528301886792,0.0,29.16535433070866,29.102362204724407,0.06299212598425186,Production
1889,0,2019-05-25,146543,L2V BRASS MYRT 115X4,0,1,0,LES 2 VACHES,0,LeMolay(FR),0085,0024 FR TOULOUSE (DC),2815,3175,926,924,2,2251,2249,0,360,-12.788632326820604,143,173,26,26,0,147,147,0,30,-20.97902097902098,15.028901734104046,15.028901734104046,0.0,29.16535433070866,29.102362204724407,0.06299212598425186,Production
1890,0,2019-05-25,146543,L2V BRASS MYRT 115X4,0,1,0,LES 2 VACHES,0,LeMolay(FR),0083,0024 FR CHAPONNAY (DC),2815,3175,926,924,2,2251,2249,0,360,-12.788632326820604,416,540,151,151,0,389,389,0,124,-29.807692307692307,27.962962962962962,27.962962962962962,0.0,29.16535433070866,29.102362204724407,0.06299212598425186,Production
1891,0,2019-05-25,146543,L2V BRASS MYRT 115X4,0,1,0,LES 2 VACHES,0,LeMolay(FR),0079,0024 FR PARIS SUD (DC),2815,3175,926,924,2,2251,2249,0,360,-12.788632326820604,349,563,142,142,0,421,421,0,214,-61.31805157593123,25.22202486678508,25.22202486678508,0.0,29.16535433070866,29.102362204724407,0.06299212598425186,Production
1892,0,2019-05-25,146543,L2V BRASS MYRT 115X4,0,1,0,LES 2 VACHES,0,LeMolay(FR),0078,0024 FR PARIS NORD (DC),2815,3175,926,924,2,2251,2249,0,360,-12.788632326820604,226,280,211,210,1,70,69,0,54,-23.893805309734514,75.35714285714286,75.0,0.3571428571428612,29.16535433070866,29.102362204724407,0.06299212598425186,Production
1893,0,2019-05-27,69190,FJORD NATURE 125GX8,0,0,0,FJORD,0,LeMolay(FR),0081,0024 FR TOURS (DC),3489,3217,1911,1850,61,1367,1306,0,-272,7.795930065921468,862,705,180,175,5,530,525,0,-157,18.213457076566126,25.53191489361702,24.822695035460992,0.709219858156029,59.40317065589058,57.50699409387629,1.8961765620142899,Production
1894,0,2019-05-27,69190,FJORD NATURE 125GX8,0,0,0,FJORD,0,LeMolay(FR),0082,0024 FR VALLET (DC),3489,3217,1911,1850,61,1367,1306,0,-272,7.795930065921468,341,222,151,151,0,71,71,0,-119,34.89736070381232,68.01801801801803,68.01801801801803,0.0,59.40317065589058,57.50699409387629,1.8961765620142899,Production
1895,0,2019-05-27,69190,FJORD NATURE 125GX8,0,0,0,FJORD,0,LeMolay(FR),0083,0024 FR CHAPONNAY (DC),3489,3217,1911,1850,61,1367,1306,0,-272,7.795930065921468,906,993,986,930,56,63,7,0,87,-9.602649006622517,99.29506545820746,93.65558912386706,5.639476334340401,59.40317065589058,57.50699409387629,1.8961765620142899,Production
1896,0,2019-05-27,69190,FJORD NATURE 125GX8,0,0,0,FJORD,0,LeMolay(FR),0079,0024 FR PARIS SUD (DC),3489,3217,1911,1850,61,1367,1306,0,-272,7.795930065921468,702,722,313,313,0,409,409,0,20,-2.849002849002849,43.35180055401662,43.35180055401662,0.0,59.40317065589058,57.50699409387629,1.8961765620142899,Production
1897,0,2019-05-27,69190,FJORD NATURE 125GX8,0,0,0,FJORD,0,LeMolay(FR),0078,0024 FR PARIS NORD (DC),3489,3217,1911,1850,61,1367,1306,0,-272,7.795930065921468,678,575,281,281,0,294,294,0,-103,15.191740412979351,48.869565217391305,48.869565217391305,0.0,59.40317065589058,57.50699409387629,1.8961765620142899,Production
1898,1,2019-05-27,101199,DANETTE POP CHOCO MAGIX 120X4,0,0,0,DANETTE,0,LeMolay(FR),0085,0024 FR TOULOUSE (DC),433,2772,2772,2706,66,66,0,0,2339,-540.1847575057736,433,421,421,355,66,66,0,0,-12,2.771362586605081,100.0,84.32304038004752,15.676959619952484,100.0,97.61904761904762,2.3809523809523796,A Creuser
1899,0,2019-05-27,120163,DANONE FERME NATURE 125X16,0,0,0,DANONE,0,Bailleul(FR),0084,0024 FR AIX (DC),8091,9557,7535,7391,144,2166,2022,0,1466,-18.11889754047707,732,730,730,730,0,0,0,0,-2,0.273224043715847,100.0,100.0,0.0,78.84273307523281,77.33598409542743,1.50674897980538,Qualité
1900,0,2019-05-27,120163,DANONE FERME NATURE 125X16,0,0,0,DANONE,0,Bailleul(FR),0080,0024 FR METZ (DC),8091,9557,7535,7391,144,2166,2022,0,1466,-18.11889754047707,788,781,745,745,0,36,36,0,-7,0.8883248730964467,95.39052496798975,95.39052496798975,0.0,78.84273307523281,77.33598409542743,1.50674897980538,Qualité
1901,0,2019-05-27,120163,DANONE FERME NATURE 125X16,0,0,0,DANONE,0,Bailleul(FR),0081,0024 FR TOURS (DC),8091,9557,7535,7391,144,2166,2022,0,1466,-18.11889754047707,1512,1554,1451,1451,0,103,103,0,42,-2.7777777777777777,93.37194337194336,93.37194337194336,0.0,78.84273307523281,77.33598409542743,1.50674897980538,Qualité
1902,0,2019-05-27,120163,DANONE FERME NATURE 125X16,0,0,0,DANONE,0,Bailleul(FR),0082,0024 FR VALLET (DC),8091,9557,7535,7391,144,2166,2022,0,1466,-18.11889754047707,463,436,96,96,0,340,340,0,-27,5.831533477321814,22.018348623853214,22.018348623853214,0.0,78.84273307523281,77.33598409542743,1.50674897980538,Qualité
1903,0,2019-05-27,120163,DANONE FERME NATURE 125X16,0,0,0,DANONE,0,Bailleul(FR),0077,0024 FR LILPARK (DC),8091,9557,7535,7391,144,2166,2022,0,1466,-18.11889754047707,513,490,490,346,144,144,0,0,-23,4.483430799220273,100.0,70.61224489795919,29.387755102040813,78.84273307523281,77.33598409542743,1.50674897980538,Qualité
1904,0,2019-05-27,120163,DANONE FERME NATURE 125X16,0,0,0,DANONE,0,Bailleul(FR),0085,0024 FR TOULOUSE (DC),8091,9557,7535,7391,144,2166,2022,0,1466,-18.11889754047707,855,1487,703,703,0,784,784,0,632,-73.91812865497076,47.276395427034295,47.276395427034295,0.0,78.84273307523281,77.33598409542743,1.50674897980538,Qualité
1905,0,2019-05-27,120163,DANONE FERME NATURE 125X16,0,0,0,DANONE,0,Bailleul(FR),0083,0024 FR CHAPONNAY (DC),8091,9557,7535,7391,144,2166,2022,0,1466,-18.11889754047707,1340,1744,1744,1744,0,0,0,0,404,-30.149253731343283,100.0,100.0,0.0,78.84273307523281,77.33598409542743,1.50674897980538,Qualité
1906,0,2019-05-27,120163,DANONE FERME NATURE 125X16,0,0,0,DANONE,0,Bailleul(FR),0079,0024 FR PARIS SUD (DC),8091,9557,7535,7391,144,2166,2022,0,1466,-18.11889754047707,1131,1439,1193,1193,0,246,246,0,308,-27.232537577365164,82.90479499652537,82.90479499652537,0.0,78.84273307523281,77.33598409542743,1.50674897980538,Qualité
1907,0,2019-05-27,120163,DANONE FERME NATURE 125X16,0,0,0,DANONE,0,Bailleul(FR),0078,0024 FR PARIS NORD (DC),8091,9557,7535,7391,144,2166,2022,0,1466,-18.11889754047707,757,896,383,383,0,513,513,0,139,-18.361955085865258,42.745535714285715,42.745535714285715,0.0,78.84273307523281,77.33598409542743,1.50674897980538,Qualité
1908,1,2019-05-27,139139,ALPRO SOJA PEACH 150X1,0,0,0,ALPRO,1,Wevelgem(BE),0077,0024 FR LILPARK (DC),40,60,60,49,11,11,0,0,20,-50.0,40,40,40,29,11,11,0,0,0,0.0,100.0,72.5,27.5,100.0,81.66666666666667,18.33333333333333,A Creuser
1909,1,2019-05-27,139408,ALPRO COCO DRINK CHOCOLATE 1LX8,0,0,0,ALPRO,1,Wevelgem(BE),0077,0024 FR LILPARK (DC),50,172,172,97,75,75,0,0,122,-244.0,50,55,55,2,53,53,0,0,5,-10.0,100.0,3.6363636363636362,96.36363636363636,100.0,56.395348837209305,43.604651162790695,A Creuser
1910,1,2019-05-27,143410,DANET CHOCO LAIT 125X8 PC,0,0,0,DANETTE,0,StJust(FR),0078,0024 FR PARIS NORD (DC),223,702,634,417,217,285,68,0,479,-214.7982062780269,223,183,127,117,10,66,56,0,-40,17.937219730941703,69.39890710382514,63.934426229508205,5.4644808743169335,90.31339031339031,59.401709401709404,30.91168091168091,Previsions
1911,0,2019-05-27,146523,L2V BRASS FRAM 115X4,0,1,0,LES 2 VACHES,0,LeMolay(FR),0084,0024 FR AIX (DC),3391,3472,3469,3175,294,297,3,0,81,-2.38867590681215,198,356,356,356,0,0,0,0,158,-79.79797979797979,100.0,100.0,0.0,99.91359447004609,91.4458525345622,8.467741935483886,Transport
1912,0,2019-05-27,146523,L2V BRASS FRAM 115X4,0,1,0,LES 2 VACHES,0,LeMolay(FR),0080,0024 FR METZ (DC),3391,3472,3469,3175,294,297,3,0,81,-2.38867590681215,329,295,295,295,0,0,0,0,-34,10.33434650455927,100.0,100.0,0.0,99.91359447004609,91.4458525345622,8.467741935483886,Transport
1913,0,2019-05-27,146523,L2V BRASS FRAM 115X4,0,1,0,LES 2 VACHES,0,LeMolay(FR),0081,0024 FR TOURS (DC),3391,3472,3469,3175,294,297,3,0,81,-2.38867590681215,459,590,590,590,0,0,0,0,131,-28.540305010893245,100.0,100.0,0.0,99.91359447004609,91.4458525345622,8.467741935483886,Transport
1914,0,2019-05-27,146523,L2V BRASS FRAM 115X4,0,1,0,LES 2 VACHES,0,LeMolay(FR),0082,0024 FR VALLET (DC),3391,3472,3469,3175,294,297,3,0,81,-2.38867590681215,179,164,164,164,0,0,0,0,-15,8.379888268156424,100.0,100.0,0.0,99.91359447004609,91.4458525345622,8.467741935483886,Transport
1915,0,2019-05-27,146523,L2V BRASS FRAM 115X4,0,1,0,LES 2 VACHES,0,LeMolay(FR),0077,0024 FR LILPARK (DC),3391,3472,3469,3175,294,297,3,0,81,-2.38867590681215,261,349,349,349,0,0,0,0,88,-33.71647509578544,100.0,100.0,0.0,99.91359447004609,91.4458525345622,8.467741935483886,Transport
1916,0,2019-05-27,146523,L2V BRASS FRAM 115X4,0,1,0,LES 2 VACHES,0,LeMolay(FR),0085,0024 FR TOULOUSE (DC),3391,3472,3469,3175,294,297,3,0,81,-2.38867590681215,418,432,432,138,294,294,0,0,14,-3.349282296650718,100.0,31.944444444444443,68.05555555555556,99.91359447004609,91.4458525345622,8.467741935483886,Transport
1917,0,2019-05-27,146523,L2V BRASS FRAM 115X4,0,1,0,LES 2 VACHES,0,LeMolay(FR),0083,0024 FR CHAPONNAY (DC),3391,3472,3469,3175,294,297,3,0,81,-2.38867590681215,563,500,500,500,0,0,0,0,-63,11.190053285968029,100.0,100.0,0.0,99.91359447004609,91.4458525345622,8.467741935483886,Transport
1918,0,2019-05-27,146523,L2V BRASS FRAM 115X4,0,1,0,LES 2 VACHES,0,LeMolay(FR),0079,0024 FR PARIS SUD (DC),3391,3472,3469,3175,294,297,3,0,81,-2.38867590681215,480,405,405,405,0,0,0,0,-75,15.625,100.0,100.0,0.0,99.91359447004609,91.4458525345622,8.467741935483886,Transport
1919,0,2019-05-27,146523,L2V BRASS FRAM 115X4,0,1,0,LES 2 VACHES,0,LeMolay(FR),0078,0024 FR PARIS NORD (DC),3391,3472,3469,3175,294,297,3,0,81,-2.38867590681215,504,381,378,378,0,3,3,0,-123,24.404761904761905,99.21259842519686,99.21259842519686,0.0,99.91359447004609,91.4458525345622,8.467741935483886,Transport
1920,0,2019-05-27,146534,L2V BRASS CIT 115X4,0,1,0,LES 2 VACHES,0,LeMolay(FR),0084,0024 FR AIX (DC),2030,2056,2053,1829,224,227,3,0,26,-1.2807881773399015,142,269,269,269,0,0,0,0,127,-89.43661971830986,100.0,100.0,0.0,99.85408560311284,88.95914396887159,10.894941634241249,Transport
1921,0,2019-05-27,146534,L2V BRASS CIT 115X4,0,1,0,LES 2 VACHES,0,LeMolay(FR),0080,0024 FR METZ (DC),2030,2056,2053,1829,224,227,3,0,26,-1.2807881773399015,166,138,138,138,0,0,0,0,-28,16.867469879518072,100.0,100.0,0.0,99.85408560311284,88.95914396887159,10.894941634241249,Transport
1922,0,2019-05-27,146534,L2V BRASS CIT 115X4,0,1,0,LES 2 VACHES,0,LeMolay(FR),0081,0024 FR TOURS (DC),2030,2056,2053,1829,224,227,3,0,26,-1.2807881773399015,242,429,429,429,0,0,0,0,187,-77.27272727272727,100.0,100.0,0.0,99.85408560311284,88.95914396887159,10.894941634241249,Transport
1923,0,2019-05-27,146534,L2V BRASS CIT 115X4,0,1,0,LES 2 VACHES,0,LeMolay(FR),0082,0024 FR VALLET (DC),2030,2056,2053,1829,224,227,3,0,26,-1.2807881773399015,120,90,90,90,0,0,0,0,-30,25.0,100.0,100.0,0.0,99.85408560311284,88.95914396887159,10.894941634241249,Transport
1924,0,2019-05-27,146534,L2V BRASS CIT 115X4,0,1,0,LES 2 VACHES,0,LeMolay(FR),0077,0024 FR LILPARK (DC),2030,2056,2053,1829,224,227,3,0,26,-1.2807881773399015,138,188,188,188,0,0,0,0,50,-36.231884057971016,100.0,100.0,0.0,99.85408560311284,88.95914396887159,10.894941634241249,Transport
1925,0,2019-05-27,146534,L2V BRASS CIT 115X4,0,1,0,LES 2 VACHES,0,LeMolay(FR),0085,0024 FR TOULOUSE (DC),2030,2056,2053,1829,224,227,3,0,26,-1.2807881773399015,263,267,267,43,224,224,0,0,4,-1.520912547528517,100.0,16.10486891385768,83.89513108614233,99.85408560311284,88.95914396887159,10.894941634241249,Transport
1926,1,2019-05-27,146534,L2V BRASS CIT 115X4,0,1,0,LES 2 VACHES,0,LeMolay(FR),0085,0024 FR TOULOUSE (DC),2030,2056,2053,1829,224,227,3,0,26,-1.2807881773399015,263,267,267,43,224,224,0,0,4,-1.520912547528517,100.0,16.10486891385768,83.89513108614233,99.85408560311284,88.95914396887159,10.894941634241249,Transport
1927,0,2019-05-27,146534,L2V BRASS CIT 115X4,0,1,0,LES 2 VACHES,0,LeMolay(FR),0083,0024 FR CHAPONNAY (DC),2030,2056,2053,1829,224,227,3,0,26,-1.2807881773399015,330,311,311,311,0,0,0,0,-19,5.757575757575758,100.0,100.0,0.0,99.85408560311284,88.95914396887159,10.894941634241249,Transport
1928,0,2019-05-27,146534,L2V BRASS CIT 115X4,0,1,0,LES 2 VACHES,0,LeMolay(FR),0079,0024 FR PARIS SUD (DC),2030,2056,2053,1829,224,227,3,0,26,-1.2807881773399015,196,195,195,195,0,0,0,0,-1,0.5102040816326531,100.0,100.0,0.0,99.85408560311284,88.95914396887159,10.894941634241249,Transport
1929,0,2019-05-27,146534,L2V BRASS CIT 115X4,0,1,0,LES 2 VACHES,0,LeMolay(FR),0078,0024 FR PARIS NORD (DC),2030,2056,2053,1829,224,227,3,0,26,-1.2807881773399015,170,169,166,166,0,3,3,0,-1,0.5882352941176471,98.22485207100591,98.22485207100591,0.0,99.85408560311284,88.95914396887159,10.894941634241249,Transport
1930,0,2019-05-27,146543,L2V BRASS MYRT 115X4,0,1,0,LES 2 VACHES,0,LeMolay(FR),0084,0024 FR AIX (DC),3439,3871,3868,3457,411,414,3,0,432,-12.561791218377435,142,419,419,419,0,0,0,0,277,-195.07042253521126,100.0,100.0,0.0,99.92250064582795,89.3050891242573,10.61741152157066,Transport
1931,0,2019-05-27,146543,L2V BRASS MYRT 115X4,0,1,0,LES 2 VACHES,0,LeMolay(FR),0080,0024 FR METZ (DC),3439,3871,3868,3457,411,414,3,0,432,-12.561791218377435,311,321,321,321,0,0,0,0,10,-3.215434083601286,100.0,100.0,0.0,99.92250064582795,89.3050891242573,10.61741152157066,Transport
1932,0,2019-05-27,146543,L2V BRASS MYRT 115X4,0,1,0,LES 2 VACHES,0,LeMolay(FR),0081,0024 FR TOURS (DC),3439,3871,3868,3457,411,414,3,0,432,-12.561791218377435,432,842,842,842,0,0,0,0,410,-94.9074074074074,100.0,100.0,0.0,99.92250064582795,89.3050891242573,10.61741152157066,Transport
1933,0,2019-05-27,146543,L2V BRASS MYRT 115X4,0,1,0,LES 2 VACHES,0,LeMolay(FR),0082,0024 FR VALLET (DC),3439,3871,3868,3457,411,414,3,0,432,-12.561791218377435,178,132,132,132,0,0,0,0,-46,25.84269662921348,100.0,100.0,0.0,99.92250064582795,89.3050891242573,10.61741152157066,Transport
1934,0,2019-05-27,146543,L2V BRASS MYRT 115X4,0,1,0,LES 2 VACHES,0,LeMolay(FR),0077,0024 FR LILPARK (DC),3439,3871,3868,3457,411,414,3,0,432,-12.561791218377435,371,297,297,297,0,0,0,0,-74,19.946091644204852,100.0,100.0,0.0,99.92250064582795,89.3050891242573,10.61741152157066,Transport
1935,0,2019-05-27,146543,L2V BRASS MYRT 115X4,0,1,0,LES 2 VACHES,0,LeMolay(FR),0085,0024 FR TOULOUSE (DC),3439,3871,3868,3457,411,414,3,0,432,-12.561791218377435,338,487,487,76,411,411,0,0,149,-44.082840236686394,100.0,15.605749486652979,84.39425051334702,99.92250064582795,89.3050891242573,10.61741152157066,Transport
1936,1,2019-05-27,146543,L2V BRASS MYRT 115X4,0,1,0,LES 2 VACHES,0,LeMolay(FR),0085,0024 FR TOULOUSE (DC),3439,3871,3868,3457,411,414,3,0,432,-12.561791218377435,338,487,487,76,411,411,0,0,149,-44.082840236686394,100.0,15.605749486652979,84.39425051334702,99.92250064582795,89.3050891242573,10.61741152157066,Transport
1937,0,2019-05-27,146543,L2V BRASS MYRT 115X4,0,1,0,LES 2 VACHES,0,LeMolay(FR),0083,0024 FR CHAPONNAY (DC),3439,3871,3868,3457,411,414,3,0,432,-12.561791218377435,544,489,489,489,0,0,0,0,-55,10.110294117647058,100.0,100.0,0.0,99.92250064582795,89.3050891242573,10.61741152157066,Transport
1938,0,2019-05-27,146543,L2V BRASS MYRT 115X4,0,1,0,LES 2 VACHES,0,LeMolay(FR),0079,0024 FR PARIS SUD (DC),3439,3871,3868,3457,411,414,3,0,432,-12.561791218377435,390,566,566,566,0,0,0,0,176,-45.12820512820513,100.0,100.0,0.0,99.92250064582795,89.3050891242573,10.61741152157066,Transport
1939,0,2019-05-27,146543,L2V BRASS MYRT 115X4,0,1,0,LES 2 VACHES,0,LeMolay(FR),0078,0024 FR PARIS NORD (DC),3439,3871,3868,3457,411,414,3,0,432,-12.561791218377435,395,318,315,315,0,3,3,0,-77,19.49367088607595,99.05660377358491,99.05660377358491,0.0,99.92250064582795,89.3050891242573,10.61741152157066,Transport
1940,0,2019-05-28,120163,DANONE FERME NATURE 125X16,0,0,0,DANONE,0,Bailleul(FR),0084,0024 FR AIX (DC),8641,9181,8841,8790,51,391,340,0,540,-6.249276704085175,998,988,889,886,3,102,99,0,-10,1.002004008016032,89.97975708502024,89.67611336032388,0.30364372469635725,96.29669970591439,95.74120466180155,0.5554950441128454,Qualité
1941,0,2019-05-28,120163,DANONE FERME NATURE 125X16,0,0,0,DANONE,0,Bailleul(FR),0080,0024 FR METZ (DC),8641,9181,8841,8790,51,391,340,0,540,-6.249276704085175,534,740,549,549,0,191,191,0,206,-38.57677902621723,74.1891891891892,74.1891891891892,0.0,96.29669970591439,95.74120466180155,0.5554950441128454,Qualité
1942,0,2019-05-28,120163,DANONE FERME NATURE 125X16,0,0,0,DANONE,0,Bailleul(FR),0081,0024 FR TOURS (DC),8641,9181,8841,8790,51,391,340,0,540,-6.249276704085175,958,993,993,993,0,0,0,0,35,-3.653444676409186,100.0,100.0,0.0,96.29669970591439,95.74120466180155,0.5554950441128454,Qualité
1943,0,2019-05-28,120163,DANONE FERME NATURE 125X16,0,0,0,DANONE,0,Bailleul(FR),0082,0024 FR VALLET (DC),8641,9181,8841,8790,51,391,340,0,540,-6.249276704085175,773,803,756,708,48,95,47,0,30,-3.8809831824062098,94.14694894146949,88.16936488169364,5.97758405977585,96.29669970591439,95.74120466180155,0.5554950441128454,Qualité
1944,0,2019-05-28,120163,DANONE FERME NATURE 125X16,0,0,0,DANONE,0,Bailleul(FR),0077,0024 FR LILPARK (DC),8641,9181,8841,8790,51,391,340,0,540,-6.249276704085175,365,440,440,440,0,0,0,0,75,-20.54794520547945,100.0,100.0,0.0,96.29669970591439,95.74120466180155,0.5554950441128454,Qualité
1945,0,2019-05-28,120163,DANONE FERME NATURE 125X16,0,0,0,DANONE,0,Bailleul(FR),0085,0024 FR TOULOUSE (DC),8641,9181,8841,8790,51,391,340,0,540,-6.249276704085175,717,905,905,905,0,0,0,0,188,-26.220362622036262,100.0,100.0,0.0,96.29669970591439,95.74120466180155,0.5554950441128454,Qualité
1946,0,2019-05-28,120163,DANONE FERME NATURE 125X16,0,0,0,DANONE,0,Bailleul(FR),0083,0024 FR CHAPONNAY (DC),8641,9181,8841,8790,51,391,340,0,540,-6.249276704085175,1966,2126,2126,2126,0,0,0,0,160,-8.138351983723297,100.0,100.0,0.0,96.29669970591439,95.74120466180155,0.5554950441128454,Qualité
1947,0,2019-05-28,120163,DANONE FERME NATURE 125X16,0,0,0,DANONE,0,Bailleul(FR),0079,0024 FR PARIS SUD (DC),8641,9181,8841,8790,51,391,340,0,540,-6.249276704085175,1629,1334,1334,1334,0,0,0,0,-295,18.10926949048496,100.0,100.0,0.0,96.29669970591439,95.74120466180155,0.5554950441128454,Qualité
1948,0,2019-05-28,120163,DANONE FERME NATURE 125X16,0,0,0,DANONE,0,Bailleul(FR),0078,0024 FR PARIS NORD (DC),8641,9181,8841,8790,51,391,340,0,540,-6.249276704085175,701,852,849,849,0,3,3,0,151,-21.540656205420827,99.64788732394366,99.64788732394366,0.0,96.29669970591439,95.74120466180155,0.5554950441128454,Qualité
1949,0,2019-05-28,127087,DANONE STRAGGISTO 140X2 FR,0,0,0,DANONE,0,Ferrières(FR),0084,0024 FR AIX (DC),930,868,788,317,471,551,80,0,-62,6.666666666666667,91,113,113,21,92,92,0,0,22,-24.175824175824175,100.0,18.58407079646018,81.41592920353982,90.78341013824884,36.52073732718894,54.2626728110599,Production
1950,0,2019-05-28,127087,DANONE STRAGGISTO 140X2 FR,0,0,0,DANONE,0,Ferrières(FR),0080,0024 FR METZ (DC),930,868,788,317,471,551,80,0,-62,6.666666666666667,41,61,61,34,27,27,0,0,20,-48.78048780487805,100.0,55.73770491803278,44.26229508196722,90.78341013824884,36.52073732718894,54.2626728110599,Production
1951,0,2019-05-28,127087,DANONE STRAGGISTO 140X2 FR,0,0,0,DANONE,0,Ferrières(FR),0081,0024 FR TOURS (DC),930,868,788,317,471,551,80,0,-62,6.666666666666667,54,59,59,52,7,7,0,0,5,-9.25925925925926,100.0,88.13559322033898,11.864406779661024,90.78341013824884,36.52073732718894,54.2626728110599,Production
1952,0,2019-05-28,127087,DANONE STRAGGISTO 140X2 FR,0,0,0,DANONE,0,Ferrières(FR),0082,0024 FR VALLET (DC),930,868,788,317,471,551,80,0,-62,6.666666666666667,90,105,105,42,63,63,0,0,15,-16.666666666666668,100.0,40.0,60.0,90.78341013824884,36.52073732718894,54.2626728110599,Production
1953,0,2019-05-28,127087,DANONE STRAGGISTO 140X2 FR,0,0,0,DANONE,0,Ferrières(FR),0077,0024 FR LILPARK (DC),930,868,788,317,471,551,80,0,-62,6.666666666666667,42,52,51,51,0,1,1,0,10,-23.80952380952381,98.07692307692307,98.07692307692307,0.0,90.78341013824884,36.52073732718894,54.2626728110599,Production
1954,0,2019-05-28,127087,DANONE STRAGGISTO 140X2 FR,0,0,0,DANONE,0,Ferrières(FR),0085,0024 FR TOULOUSE (DC),930,868,788,317,471,551,80,0,-62,6.666666666666667,76,86,10,10,0,76,76,0,10,-13.157894736842104,11.627906976744185,11.627906976744185,0.0,90.78341013824884,36.52073732718894,54.2626728110599,Production
1955,0,2019-05-28,127087,DANONE STRAGGISTO 140X2 FR,0,0,0,DANONE,0,Ferrières(FR),0083,0024 FR CHAPONNAY (DC),930,868,788,317,471,551,80,0,-62,6.666666666666667,69,63,63,0,63,63,0,0,-6,8.695652173913043,100.0,0.0,100.0,90.78341013824884,36.52073732718894,54.2626728110599,Production
1956,0,2019-05-28,127087,DANONE STRAGGISTO 140X2 FR,0,0,0,DANONE,0,Ferrières(FR),0079,0024 FR PARIS SUD (DC),930,868,788,317,471,551,80,0,-62,6.666666666666667,194,219,219,0,219,219,0,0,25,-12.88659793814433,100.0,0.0,100.0,90.78341013824884,36.52073732718894,54.2626728110599,Production
1957,1,2019-05-28,127087,DANONE STRAGGISTO 140X2 FR,0,0,0,DANONE,0,Ferrières(FR),0079,0024 FR PARIS SUD (DC),930,868,788,317,471,551,80,0,-62,6.666666666666667,194,219,219,0,219,219,0,0,25,-12.88659793814433,100.0,0.0,100.0,90.78341013824884,36.52073732718894,54.2626728110599,Production
1958,0,2019-05-28,127087,DANONE STRAGGISTO 140X2 FR,0,0,0,DANONE,0,Ferrières(FR),0078,0024 FR PARIS NORD (DC),930,868,788,317,471,551,80,0,-62,6.666666666666667,79,110,107,107,0,3,3,0,31,-39.24050632911393,97.27272727272728,97.27272727272728,0.0,90.78341013824884,36.52073732718894,54.2626728110599,Production
1959,0,2019-05-28,127970,DANET CHOCO 125X8,0,0,0,DANETTE,0,StJust(FR),0084,0024 FR AIX (DC),2333,1930,1930,1462,468,468,0,0,-403,17.273896270895843,79,84,84,84,0,0,0,0,5,-6.329113924050633,100.0,100.0,0.0,100.0,75.75129533678756,24.248704663212436,Production
1960,0,2019-05-28,127970,DANET CHOCO 125X8,0,0,0,DANETTE,0,StJust(FR),0080,0024 FR METZ (DC),2333,1930,1930,1462,468,468,0,0,-403,17.273896270895843,488,496,496,76,420,420,0,0,8,-1.639344262295082,100.0,15.32258064516129,84.6774193548387,100.0,75.75129533678756,24.248704663212436,Production
1961,1,2019-05-28,127970,DANET CHOCO 125X8,0,0,0,DANETTE,0,StJust(FR),0080,0024 FR METZ (DC),2333,1930,1930,1462,468,468,0,0,-403,17.273896270895843,488,496,496,76,420,420,0,0,8,-1.639344262295082,100.0,15.32258064516129,84.6774193548387,100.0,75.75129533678756,24.248704663212436,Production
1962,0,2019-05-28,127970,DANET CHOCO 125X8,0,0,0,DANETTE,0,StJust(FR),0081,0024 FR TOURS (DC),2333,1930,1930,1462,468,468,0,0,-403,17.273896270895843,100,64,64,16,48,48,0,0,-36,36.0,100.0,25.0,75.0,100.0,75.75129533678756,24.248704663212436,Production
1963,0,2019-05-28,127970,DANET CHOCO 125X8,0,0,0,DANETTE,0,StJust(FR),0082,0024 FR VALLET (DC),2333,1930,1930,1462,468,468,0,0,-403,17.273896270895843,402,435,435,435,0,0,0,0,33,-8.208955223880597,100.0,100.0,0.0,100.0,75.75129533678756,24.248704663212436,Production
1964,0,2019-05-28,127970,DANET CHOCO 125X8,0,0,0,DANETTE,0,StJust(FR),0077,0024 FR LILPARK (DC),2333,1930,1930,1462,468,468,0,0,-403,17.273896270895843,178,160,160,160,0,0,0,0,-18,10.112359550561798,100.0,100.0,0.0,100.0,75.75129533678756,24.248704663212436,Production
1965,0,2019-05-28,127970,DANET CHOCO 125X8,0,0,0,DANETTE,0,StJust(FR),0085,0024 FR TOULOUSE (DC),2333,1930,1930,1462,468,468,0,0,-403,17.273896270895843,146,264,264,264,0,0,0,0,118,-80.82191780821918,100.0,100.0,0.0,100.0,75.75129533678756,24.248704663212436,Production
1966,0,2019-05-28,127970,DANET CHOCO 125X8,0,0,0,DANETTE,0,StJust(FR),0083,0024 FR CHAPONNAY (DC),2333,1930,1930,1462,468,468,0,0,-403,17.273896270895843,139,139,139,139,0,0,0,0,0,0.0,100.0,100.0,0.0,100.0,75.75129533678756,24.248704663212436,Production
1967,0,2019-05-28,127970,DANET CHOCO 125X8,0,0,0,DANETTE,0,StJust(FR),0079,0024 FR PARIS SUD (DC),2333,1930,1930,1462,468,468,0,0,-403,17.273896270895843,192,173,173,173,0,0,0,0,-19,9.895833333333334,100.0,100.0,0.0,100.0,75.75129533678756,24.248704663212436,Production
1968,0,2019-05-28,127970,DANET CHOCO 125X8,0,0,0,DANETTE,0,StJust(FR),0078,0024 FR PARIS NORD (DC),2333,1930,1930,1462,468,468,0,0,-403,17.273896270895843,121,115,115,115,0,0,0,0,-6,4.958677685950414,100.0,100.0,0.0,100.0,75.75129533678756,24.248704663212436,Production
1969,0,2019-05-28,135068,ACTIVIA SAV VANILLA 125X12,0,0,0,ACTIVIA,0,Bailleul(FR),0084,0024 FR AIX (DC),3857,3975,3775,3775,0,200,200,0,118,-3.0593725693544207,512,479,479,479,0,0,0,0,-33,6.4453125,100.0,100.0,0.0,94.9685534591195,94.9685534591195,0.0,Production
1970,0,2019-05-28,135068,ACTIVIA SAV VANILLA 125X12,0,0,0,ACTIVIA,0,Bailleul(FR),0080,0024 FR METZ (DC),3857,3975,3775,3775,0,200,200,0,118,-3.0593725693544207,294,326,326,326,0,0,0,0,32,-10.884353741496598,100.0,100.0,0.0,94.9685534591195,94.9685534591195,0.0,Production
1971,0,2019-05-28,135068,ACTIVIA SAV VANILLA 125X12,0,0,0,ACTIVIA,0,Bailleul(FR),0081,0024 FR TOURS (DC),3857,3975,3775,3775,0,200,200,0,118,-3.0593725693544207,440,487,295,295,0,192,192,0,47,-10.681818181818182,60.57494866529775,60.57494866529775,0.0,94.9685534591195,94.9685534591195,0.0,Production
1972,0,2019-05-28,135068,ACTIVIA SAV VANILLA 125X12,0,0,0,ACTIVIA,0,Bailleul(FR),0082,0024 FR VALLET (DC),3857,3975,3775,3775,0,200,200,0,118,-3.0593725693544207,358,378,378,378,0,0,0,0,20,-5.58659217877095,100.0,100.0,0.0,94.9685534591195,94.9685534591195,0.0,Production
1973,0,2019-05-28,135068,ACTIVIA SAV VANILLA 125X12,0,0,0,ACTIVIA,0,Bailleul(FR),0077,0024 FR LILPARK (DC),3857,3975,3775,3775,0,200,200,0,118,-3.0593725693544207,199,163,162,162,0,1,1,0,-36,18.09045226130653,99.38650306748467,99.38650306748467,0.0,94.9685534591195,94.9685534591195,0.0,Production
1974,0,2019-05-28,135068,ACTIVIA SAV VANILLA 125X12,0,0,0,ACTIVIA,0,Bailleul(FR),0085,0024 FR TOULOUSE (DC),3857,3975,3775,3775,0,200,200,0,118,-3.0593725693544207,527,558,558,558,0,0,0,0,31,-5.882352941176471,100.0,100.0,0.0,94.9685534591195,94.9685534591195,0.0,Production
1975,0,2019-05-28,135068,ACTIVIA SAV VANILLA 125X12,0,0,0,ACTIVIA,0,Bailleul(FR),0083,0024 FR CHAPONNAY (DC),3857,3975,3775,3775,0,200,200,0,118,-3.0593725693544207,602,653,653,653,0,0,0,0,51,-8.471760797342192,100.0,100.0,0.0,94.9685534591195,94.9685534591195,0.0,Production
1976,0,2019-05-28,135068,ACTIVIA SAV VANILLA 125X12,0,0,0,ACTIVIA,0,Bailleul(FR),0079,0024 FR PARIS SUD (DC),3857,3975,3775,3775,0,200,200,0,118,-3.0593725693544207,586,600,600,600,0,0,0,0,14,-2.3890784982935154,100.0,100.0,0.0,94.9685534591195,94.9685534591195,0.0,Production
1977,0,2019-05-28,135068,ACTIVIA SAV VANILLA 125X12,0,0,0,ACTIVIA,0,Bailleul(FR),0078,0024 FR PARIS NORD (DC),3857,3975,3775,3775,0,200,200,0,118,-3.0593725693544207,339,331,324,324,0,7,7,0,-8,2.359882005899705,97.88519637462235,97.88519637462235,0.0,94.9685534591195,94.9685534591195,0.0,Production
1978,1,2019-05-28,139408,ALPRO COCO DRINK CHOCOLATE 1LX8,0,0,0,ALPRO,1,Wevelgem(BE),0082,0024 FR VALLET (DC),40,177,177,19,158,158,0,0,137,-342.5,18,18,18,0,18,18,0,0,0,0.0,100.0,0.0,100.0,100.0,10.734463276836157,89.26553672316385,A Creuser
1979,1,2019-05-28,139408,ALPRO COCO DRINK CHOCOLATE 1LX8,0,0,0,ALPRO,1,Wevelgem(BE),0078,0024 FR PARIS NORD (DC),40,177,177,19,158,158,0,0,137,-342.5,22,24,24,0,24,24,0,0,2,-9.090909090909092,100.0,0.0,100.0,100.0,10.734463276836157,89.26553672316385,A Creuser
1980,0,2019-05-28,140280,Activia chia/raspb/muesli 170g FR-copack,0,0,0,ACTIVIA,1,Roumanie(RO),0080,0024 FR METZ (DC),546,943,506,259,247,684,437,0,397,-72.71062271062272,64,106,62,0,62,106,44,0,42,-65.625,58.490566037735846,0.0,58.490566037735846,53.65853658536586,27.465535524920465,26.193001060445393,Transport
1981,0,2019-05-28,140280,Activia chia/raspb/muesli 170g FR-copack,0,0,0,ACTIVIA,1,Roumanie(RO),0082,0024 FR VALLET (DC),546,943,506,259,247,684,437,0,397,-72.71062271062272,90,230,230,46,184,184,0,0,140,-155.55555555555554,100.0,20.0,80.0,53.65853658536586,27.465535524920465,26.193001060445393,Transport
1982,0,2019-05-28,140280,Activia chia/raspb/muesli 170g FR-copack,0,0,0,ACTIVIA,1,Roumanie(RO),0077,0024 FR LILPARK (DC),546,943,506,259,247,684,437,0,397,-72.71062271062272,64,68,68,68,0,0,0,0,4,-6.25,100.0,100.0,0.0,53.65853658536586,27.465535524920465,26.193001060445393,Transport
1983,0,2019-05-28,140280,Activia chia/raspb/muesli 170g FR-copack,0,0,0,ACTIVIA,1,Roumanie(RO),0085,0024 FR TOULOUSE (DC),546,943,506,259,247,684,437,0,397,-72.71062271062272,74,149,25,25,0,124,124,0,75,-101.35135135135135,16.778523489932887,16.778523489932887,0.0,53.65853658536586,27.465535524920465,26.193001060445393,Transport
1984,0,2019-05-28,140280,Activia chia/raspb/muesli 170g FR-copack,0,0,0,ACTIVIA,1,Roumanie(RO),0079,0024 FR PARIS SUD (DC),546,943,506,259,247,684,437,0,397,-72.71062271062272,121,145,98,97,1,48,47,0,24,-19.834710743801654,67.58620689655173,66.89655172413794,0.6896551724137936,53.65853658536586,27.465535524920465,26.193001060445393,Transport
1985,0,2019-05-28,140280,Activia chia/raspb/muesli 170g FR-copack,0,0,0,ACTIVIA,1,Roumanie(RO),0078,0024 FR PARIS NORD (DC),546,943,506,259,247,684,437,0,397,-72.71062271062272,133,245,23,23,0,222,222,0,112,-84.21052631578948,9.387755102040817,9.387755102040817,0.0,53.65853658536586,27.465535524920465,26.193001060445393,Transport
1986,1,2019-06-01,121315,ACTIMEL NATU 4x(10x100g) FR,0,0,0,ACTIMEL,1,Rotselaar(BE),0081,0024 FR TOURS (DC),193,1930,1930,1851,79,79,0,0,1737,-900.0,193,189,189,110,79,79,0,0,-4,2.0725388601036268,100.0,58.201058201058196,41.798941798941804,100.0,95.90673575129533,4.093264248704671,Transport
1987,1,2019-06-01,131388,ACTIVIA MURES FRAMB 125X4 OD,1,0,0,ACTIVIA,0,Villecomtal(FR),0081,0024 FR TOURS (DC),85,671,628,628,0,43,43,0,586,-689.4117647058823,85,114,71,71,0,43,43,0,29,-34.11764705882353,62.28070175438597,62.28070175438597,0.0,93.59165424739196,93.59165424739196,0.0,A Creuser
1988,1,2019-06-01,132457,ACTIVIA SAV COCO 125X4 OD,0,0,0,ACTIVIA,0,Bailleul(FR),0081,0024 FR TOURS (DC),288,425,379,373,6,52,46,0,137,-47.56944444444444,173,173,153,153,0,20,20,0,0,0.0,88.4393063583815,88.4393063583815,0.0,89.17647058823529,87.76470588235294,1.411764705882348,Production
1989,1,2019-06-01,132457,ACTIVIA SAV COCO 125X4 OD,0,0,0,ACTIVIA,0,Bailleul(FR),0082,0024 FR VALLET (DC),288,425,379,373,6,52,46,0,137,-47.56944444444444,102,102,88,88,0,14,14,0,0,0.0,86.27450980392157,86.27450980392157,0.0,89.17647058823529,87.76470588235294,1.411764705882348,Production
1990,1,2019-06-01,132457,ACTIVIA SAV COCO 125X4 OD,0,0,0,ACTIVIA,0,Bailleul(FR),0085,0024 FR TOULOUSE (DC),288,425,379,373,6,52,46,0,137,-47.56944444444444,13,13,4,3,1,10,9,0,0,0.0,30.76923076923077,23.076923076923077,7.692307692307693,89.17647058823529,87.76470588235294,1.411764705882348,Production
1991,0,2019-06-01,148355,ACTIVIA SHOT NAT 80X6,0,1,0,ACTIVIA,1,Benesov(CZ),0084,0024 FR AIX (DC),799,1968,1968,1769,199,199,0,0,1169,-146.30788485607007,165,193,193,192,1,1,0,0,28,-16.96969696969697,100.0,99.48186528497409,0.5181347150259086,100.0,89.88821138211382,10.111788617886177,A Creuser
1992,0,2019-06-01,148355,ACTIVIA SHOT NAT 80X6,0,1,0,ACTIVIA,1,Benesov(CZ),0080,0024 FR METZ (DC),799,1968,1968,1769,199,199,0,0,1169,-146.30788485607007,10,7,7,7,0,0,0,0,-3,30.0,100.0,100.0,0.0,100.0,89.88821138211382,10.111788617886177,A Creuser
1993,0,2019-06-01,148355,ACTIVIA SHOT NAT 80X6,0,1,0,ACTIVIA,1,Benesov(CZ),0081,0024 FR TOURS (DC),799,1968,1968,1769,199,199,0,0,1169,-146.30788485607007,44,124,124,124,0,0,0,0,80,-181.8181818181818,100.0,100.0,0.0,100.0,89.88821138211382,10.111788617886177,A Creuser
1994,0,2019-06-01,148355,ACTIVIA SHOT NAT 80X6,0,1,0,ACTIVIA,1,Benesov(CZ),0082,0024 FR VALLET (DC),799,1968,1968,1769,199,199,0,0,1169,-146.30788485607007,44,63,63,63,0,0,0,0,19,-43.18181818181818,100.0,100.0,0.0,100.0,89.88821138211382,10.111788617886177,A Creuser
1995,0,2019-06-01,148355,ACTIVIA SHOT NAT 80X6,0,1,0,ACTIVIA,1,Benesov(CZ),0077,0024 FR LILPARK (DC),799,1968,1968,1769,199,199,0,0,1169,-146.30788485607007,44,237,237,237,0,0,0,0,193,-438.6363636363636,100.0,100.0,0.0,100.0,89.88821138211382,10.111788617886177,A Creuser
1996,0,2019-06-01,148355,ACTIVIA SHOT NAT 80X6,0,1,0,ACTIVIA,1,Benesov(CZ),0085,0024 FR TOULOUSE (DC),799,1968,1968,1769,199,199,0,0,1169,-146.30788485607007,71,278,278,278,0,0,0,0,207,-291.5492957746479,100.0,100.0,0.0,100.0,89.88821138211382,10.111788617886177,A Creuser
1997,0,2019-06-01,148355,ACTIVIA SHOT NAT 80X6,0,1,0,ACTIVIA,1,Benesov(CZ),0083,0024 FR CHAPONNAY (DC),799,1968,1968,1769,199,199,0,0,1169,-146.30788485607007,144,428,428,428,0,0,0,0,284,-197.22222222222223,100.0,100.0,0.0,100.0,89.88821138211382,10.111788617886177,A Creuser
1998,0,2019-06-01,148355,ACTIVIA SHOT NAT 80X6,0,1,0,ACTIVIA,1,Benesov(CZ),0079,0024 FR PARIS SUD (DC),799,1968,1968,1769,199,199,0,0,1169,-146.30788485607007,221,350,350,154,196,196,0,0,129,-58.3710407239819,100.0,44.0,56.0,100.0,89.88821138211382,10.111788617886177,A Creuser
1999,0,2019-06-01,148355,ACTIVIA SHOT NAT 80X6,0,1,0,ACTIVIA,1,Benesov(CZ),0078,0024 FR PARIS NORD (DC),799,1968,1968,1769,199,199,0,0,1169,-146.30788485607007,56,288,288,286,2,2,0,0,232,-414.2857142857143,100.0,99.30555555555556,0.6944444444444429,100.0,89.88821138211382,10.111788617886177,A Creuser
2000,0,2019-06-03,69190,FJORD NATURE 125GX8,0,0,0,FJORD,0,LeMolay(FR),0084,0024 FR AIX (DC),4671,3934,3538,3537,1,397,396,0,-737,15.778205951616357,753,537,537,536,1,1,0,0,-216,28.685258964143426,100.0,99.81378026070763,0.186219739292369,89.93390950686324,89.90849008642603,0.0254194204372169,Production
2001,0,2019-06-03,69190,FJORD NATURE 125GX8,0,0,0,FJORD,0,LeMolay(FR),0080,0024 FR METZ (DC),4671,3934,3538,3537,1,397,396,0,-737,15.778205951616357,302,316,156,156,0,160,160,0,14,-4.635761589403973,49.36708860759494,49.36708860759494,0.0,89.93390950686324,89.90849008642603,0.0254194204372169,Production
2002,0,2019-06-03,69190,FJORD NATURE 125GX8,0,0,0,FJORD,0,LeMolay(FR),0081,0024 FR TOURS (DC),4671,3934,3538,3537,1,397,396,0,-737,15.778205951616357,503,408,408,408,0,0,0,0,-95,18.88667992047714,100.0,100.0,0.0,89.93390950686324,89.90849008642603,0.0254194204372169,Production
2003,0,2019-06-03,69190,FJORD NATURE 125GX8,0,0,0,FJORD,0,LeMolay(FR),0082,0024 FR VALLET (DC),4671,3934,3538,3537,1,397,396,0,-737,15.778205951616357,297,182,182,182,0,0,0,0,-115,38.72053872053872,100.0,100.0,0.0,89.93390950686324,89.90849008642603,0.0254194204372169,Production
2004,0,2019-06-03,69190,FJORD NATURE 125GX8,0,0,0,FJORD,0,LeMolay(FR),0077,0024 FR LILPARK (DC),4671,3934,3538,3537,1,397,396,0,-737,15.778205951616357,155,117,117,117,0,0,0,0,-38,24.516129032258064,100.0,100.0,0.0,89.93390950686324,89.90849008642603,0.0254194204372169,Production
2005,0,2019-06-03,69190,FJORD NATURE 125GX8,0,0,0,FJORD,0,LeMolay(FR),0085,0024 FR TOULOUSE (DC),4671,3934,3538,3537,1,397,396,0,-737,15.778205951616357,733,511,275,275,0,236,236,0,-222,30.286493860845837,53.8160469667319,53.8160469667319,0.0,89.93390950686324,89.90849008642603,0.0254194204372169,Production
2006,0,2019-06-03,69190,FJORD NATURE 125GX8,0,0,0,FJORD,0,LeMolay(FR),0083,0024 FR CHAPONNAY (DC),4671,3934,3538,3537,1,397,396,0,-737,15.778205951616357,988,1121,1121,1121,0,0,0,0,133,-13.461538461538462,100.0,100.0,0.0,89.93390950686324,89.90849008642603,0.0254194204372169,Production
2007,0,2019-06-03,69190,FJORD NATURE 125GX8,0,0,0,FJORD,0,LeMolay(FR),0079,0024 FR PARIS SUD (DC),4671,3934,3538,3537,1,397,396,0,-737,15.778205951616357,588,470,470,470,0,0,0,0,-118,20.068027210884352,100.0,100.0,0.0,89.93390950686324,89.90849008642603,0.0254194204372169,Production
2008,0,2019-06-03,69190,FJORD NATURE 125GX8,0,0,0,FJORD,0,LeMolay(FR),0078,0024 FR PARIS NORD (DC),4671,3934,3538,3537,1,397,396,0,-737,15.778205951616357,352,272,272,272,0,0,0,0,-80,22.727272727272727,100.0,100.0,0.0,89.93390950686324,89.90849008642603,0.0254194204372169,Production
2009,1,2019-06-03,131388,ACTIVIA MURES FRAMB 125X4 OD,1,0,0,ACTIVIA,0,Villecomtal(FR),0077,0024 FR LILPARK (DC),113,512,419,342,77,170,93,0,399,-353.0973451327434,113,118,118,54,64,64,0,0,5,-4.424778761061947,100.0,45.76271186440678,54.23728813559322,81.8359375,66.796875,15.0390625,A Creuser
2010,1,2019-06-03,131396,ACTIVIA ABRICOT 125X4 OD,1,0,0,ACTIVIA,0,Villecomtal(FR),0077,0024 FR LILPARK (DC),120,520,428,361,67,159,92,0,400,-333.3333333333333,120,127,127,60,67,67,0,0,7,-5.833333333333333,100.0,47.24409448818898,52.75590551181102,82.3076923076923,69.42307692307692,12.884615384615387,A Creuser
2011,1,2019-06-03,131478,ACTIVIA FRT PRUNEAU 125X4 OD,1,0,0,ACTIVIA,0,Villecomtal(FR),0077,0024 FR LILPARK (DC),107,574,458,400,58,174,116,0,467,-436.4485981308411,107,115,115,57,58,58,0,0,8,-7.4766355140186915,100.0,49.56521739130435,50.43478260869565,79.79094076655052,69.68641114982579,10.104529616724733,A Creuser
2012,1,2019-06-03,131479,ACTIVIA FRT MANGO 125X4 OD,1,0,0,ACTIVIA,0,Villecomtal(FR),0077,0024 FR LILPARK (DC),119,527,427,359,68,168,100,0,408,-342.85714285714283,119,121,121,53,68,68,0,0,2,-1.680672268907563,100.0,43.80165289256198,56.19834710743802,81.02466793168881,68.1214421252372,12.903225806451616,A Creuser
2013,1,2019-06-03,132458,ACTIVIA SAV CITRON 125X4 OD,0,0,0,ACTIVIA,0,Bailleul(FR),0079,0024 FR PARIS SUD (DC),0,601,573,572,1,29,28,1,601,90000.0,0,38,10,9,1,29,28,1,38,10000.0,26.31578947368421,23.684210526315788,2.6315789473684212,95.34109816971714,95.17470881863561,0.1663893510815342,Previsions
2014,1,2019-06-03,136435,ACTIVIA FRUITS MYRTILLE 125X4 OD,1,0,0,ACTIVIA,0,Ferrières(FR),0080,0024 FR METZ (DC),41,403,312,223,89,180,91,0,362,-882.9268292682926,25,51,50,12,38,39,1,0,26,-104.0,98.0392156862745,23.52941176470588,74.50980392156862,77.41935483870968,55.33498759305211,22.084367245657567,Probleme Copacking
2015,1,2019-06-03,136435,ACTIVIA FRUITS MYRTILLE 125X4 OD,1,0,0,ACTIVIA,0,Ferrières(FR),0081,0024 FR TOURS (DC),41,403,312,223,89,180,91,0,362,-882.9268292682926,16,16,4,4,0,12,12,0,0,0.0,25.0,25.0,0.0,77.41935483870968,55.33498759305211,22.084367245657567,Probleme Copacking
2016,0,2019-06-03,148355,ACTIVIA SHOT NAT 80X6,0,1,0,ACTIVIA,1,Benesov(CZ),0084,0024 FR AIX (DC),500,2340,2202,1957,245,383,138,0,1840,-368.0,56,264,264,264,0,0,0,0,208,-371.42857142857144,100.0,100.0,0.0,94.1025641025641,83.63247863247864,10.470085470085465,A Creuser
2017,0,2019-06-03,148355,ACTIVIA SHOT NAT 80X6,0,1,0,ACTIVIA,1,Benesov(CZ),0080,0024 FR METZ (DC),500,2340,2202,1957,245,383,138,0,1840,-368.0,44,55,55,55,0,0,0,0,11,-25.0,100.0,100.0,0.0,94.1025641025641,83.63247863247864,10.470085470085465,A Creuser
2018,0,2019-06-03,148355,ACTIVIA SHOT NAT 80X6,0,1,0,ACTIVIA,1,Benesov(CZ),0081,0024 FR TOURS (DC),500,2340,2202,1957,245,383,138,0,1840,-368.0,31,131,131,131,0,0,0,0,100,-322.5806451612903,100.0,100.0,0.0,94.1025641025641,83.63247863247864,10.470085470085465,A Creuser
2019,0,2019-06-03,148355,ACTIVIA SHOT NAT 80X6,0,1,0,ACTIVIA,1,Benesov(CZ),0082,0024 FR VALLET (DC),500,2340,2202,1957,245,383,138,0,1840,-368.0,42,163,163,163,0,0,0,0,121,-288.0952380952381,100.0,100.0,0.0,94.1025641025641,83.63247863247864,10.470085470085465,A Creuser
2020,0,2019-06-03,148355,ACTIVIA SHOT NAT 80X6,0,1,0,ACTIVIA,1,Benesov(CZ),0077,0024 FR LILPARK (DC),500,2340,2202,1957,245,383,138,0,1840,-368.0,21,166,76,63,13,103,90,0,145,-690.4761904761905,45.78313253012048,37.95180722891566,7.831325301204821,94.1025641025641,83.63247863247864,10.470085470085465,A Creuser
2021,0,2019-06-03,148355,ACTIVIA SHOT NAT 80X6,0,1,0,ACTIVIA,1,Benesov(CZ),0085,0024 FR TOULOUSE (DC),500,2340,2202,1957,245,383,138,0,1840,-368.0,94,263,215,215,0,48,48,0,169,-179.7872340425532,81.74904942965779,81.74904942965779,0.0,94.1025641025641,83.63247863247864,10.470085470085465,A Creuser
2022,0,2019-06-03,148355,ACTIVIA SHOT NAT 80X6,0,1,0,ACTIVIA,1,Benesov(CZ),0083,0024 FR CHAPONNAY (DC),500,2340,2202,1957,245,383,138,0,1840,-368.0,75,330,330,330,0,0,0,0,255,-340.0,100.0,100.0,0.0,94.1025641025641,83.63247863247864,10.470085470085465,A Creuser
2023,0,2019-06-03,148355,ACTIVIA SHOT NAT 80X6,0,1,0,ACTIVIA,1,Benesov(CZ),0079,0024 FR PARIS SUD (DC),500,2340,2202,1957,245,383,138,0,1840,-368.0,83,736,736,736,0,0,0,0,653,-786.7469879518072,100.0,100.0,0.0,94.1025641025641,83.63247863247864,10.470085470085465,A Creuser
2024,0,2019-06-03,148355,ACTIVIA SHOT NAT 80X6,0,1,0,ACTIVIA,1,Benesov(CZ),0078,0024 FR PARIS NORD (DC),500,2340,2202,1957,245,383,138,0,1840,-368.0,54,232,232,0,232,232,0,0,178,-329.6296296296296,100.0,0.0,100.0,94.1025641025641,83.63247863247864,10.470085470085465,A Creuser
2025,0,2019-06-04,120163,DANONE FERME NATURE 125X16,0,0,0,DANONE,0,Bailleul(FR),0084,0024 FR AIX (DC),6047,8087,7718,7713,5,374,369,0,2040,-33.73573672895651,625,1585,1216,1211,5,374,369,0,960,-153.6,76.71924290220821,76.40378548895899,0.31545741324922005,95.43712130579944,95.37529368121676,0.06182762458267632,Client
2026,0,2019-06-04,120163,DANONE FERME NATURE 125X16,0,0,0,DANONE,0,Bailleul(FR),0080,0024 FR METZ (DC),6047,8087,7718,7713,5,374,369,0,2040,-33.73573672895651,288,393,393,393,0,0,0,0,105,-36.458333333333336,100.0,100.0,0.0,95.43712130579944,95.37529368121676,0.06182762458267632,Client
2027,0,2019-06-04,120163,DANONE FERME NATURE 125X16,0,0,0,DANONE,0,Bailleul(FR),0081,0024 FR TOURS (DC),6047,8087,7718,7713,5,374,369,0,2040,-33.73573672895651,947,1120,1120,1120,0,0,0,0,173,-18.268215417106653,100.0,100.0,0.0,95.43712130579944,95.37529368121676,0.06182762458267632,Client
2028,0,2019-06-04,120163,DANONE FERME NATURE 125X16,0,0,0,DANONE,0,Bailleul(FR),0082,0024 FR VALLET (DC),6047,8087,7718,7713,5,374,369,0,2040,-33.73573672895651,381,868,868,868,0,0,0,0,487,-127.82152230971128,100.0,100.0,0.0,95.43712130579944,95.37529368121676,0.06182762458267632,Client
2029,0,2019-06-04,120163,DANONE FERME NATURE 125X16,0,0,0,DANONE,0,Bailleul(FR),0077,0024 FR LILPARK (DC),6047,8087,7718,7713,5,374,369,0,2040,-33.73573672895651,391,348,348,348,0,0,0,0,-43,10.997442455242966,100.0,100.0,0.0,95.43712130579944,95.37529368121676,0.06182762458267632,Client
2030,0,2019-06-04,120163,DANONE FERME NATURE 125X16,0,0,0,DANONE,0,Bailleul(FR),0085,0024 FR TOULOUSE (DC),6047,8087,7718,7713,5,374,369,0,2040,-33.73573672895651,606,631,631,631,0,0,0,0,25,-4.125412541254126,100.0,100.0,0.0,95.43712130579944,95.37529368121676,0.06182762458267632,Client
2031,0,2019-06-04,120163,DANONE FERME NATURE 125X16,0,0,0,DANONE,0,Bailleul(FR),0083,0024 FR CHAPONNAY (DC),6047,8087,7718,7713,5,374,369,0,2040,-33.73573672895651,1043,1171,1171,1171,0,0,0,0,128,-12.27229146692234,100.0,100.0,0.0,95.43712130579944,95.37529368121676,0.06182762458267632,Client
2032,0,2019-06-04,120163,DANONE FERME NATURE 125X16,0,0,0,DANONE,0,Bailleul(FR),0079,0024 FR PARIS SUD (DC),6047,8087,7718,7713,5,374,369,0,2040,-33.73573672895651,1266,1430,1430,1430,0,0,0,0,164,-12.954186413902054,100.0,100.0,0.0,95.43712130579944,95.37529368121676,0.06182762458267632,Client
2033,0,2019-06-04,120163,DANONE FERME NATURE 125X16,0,0,0,DANONE,0,Bailleul(FR),0078,0024 FR PARIS NORD (DC),6047,8087,7718,7713,5,374,369,0,2040,-33.73573672895651,500,541,541,541,0,0,0,0,41,-8.2,100.0,100.0,0.0,95.43712130579944,95.37529368121676,0.06182762458267632,Client
2034,0,2019-06-04,127911,GERVAIS GRIEGO 115X4 VANILLA FR,0,0,0,GERVAIS,1,Rosenheim(ALL),0084,0024 FR AIX (DC),1057,1129,276,257,19,872,853,0,72,-6.811731315042573,154,179,11,1,10,178,168,0,25,-16.233766233766232,6.145251396648044,0.5586592178770949,5.58659217877095,24.446412754650133,22.763507528786537,1.6829052258635961,Transport
2035,0,2019-06-04,127911,GERVAIS GRIEGO 115X4 VANILLA FR,0,0,0,GERVAIS,1,Rosenheim(ALL),0081,0024 FR TOURS (DC),1057,1129,276,257,19,872,853,0,72,-6.811731315042573,172,167,1,0,1,167,166,0,-5,2.9069767441860463,0.5988023952095809,0.0,0.5988023952095809,24.446412754650133,22.763507528786537,1.6829052258635961,Transport
2036,0,2019-06-04,127911,GERVAIS GRIEGO 115X4 VANILLA FR,0,0,0,GERVAIS,1,Rosenheim(ALL),0077,0024 FR LILPARK (DC),1057,1129,276,257,19,872,853,0,72,-6.811731315042573,107,92,92,92,0,0,0,0,-15,14.018691588785046,100.0,100.0,0.0,24.446412754650133,22.763507528786537,1.6829052258635961,Transport
2037,0,2019-06-04,127911,GERVAIS GRIEGO 115X4 VANILLA FR,0,0,0,GERVAIS,1,Rosenheim(ALL),0085,0024 FR TOULOUSE (DC),1057,1129,276,257,19,872,853,0,72,-6.811731315042573,188,158,38,38,0,120,120,0,-30,15.957446808510639,24.050632911392405,24.050632911392405,0.0,24.446412754650133,22.763507528786537,1.6829052258635961,Transport
2038,0,2019-06-04,127911,GERVAIS GRIEGO 115X4 VANILLA FR,0,0,0,GERVAIS,1,Rosenheim(ALL),0083,0024 FR CHAPONNAY (DC),1057,1129,276,257,19,872,853,0,72,-6.811731315042573,172,168,19,19,0,149,149,0,-4,2.3255813953488373,11.30952380952381,11.30952380952381,0.0,24.446412754650133,22.763507528786537,1.6829052258635961,Transport
2039,0,2019-06-04,127911,GERVAIS GRIEGO 115X4 VANILLA FR,0,0,0,GERVAIS,1,Rosenheim(ALL),0079,0024 FR PARIS SUD (DC),1057,1129,276,257,19,872,853,0,72,-6.811731315042573,179,220,108,107,1,113,112,0,41,-22.905027932960895,49.09090909090909,48.63636363636364,0.45454545454545325,24.446412754650133,22.763507528786537,1.6829052258635961,Transport
2040,0,2019-06-04,127911,GERVAIS GRIEGO 115X4 VANILLA FR,0,0,0,GERVAIS,1,Rosenheim(ALL),0078,0024 FR PARIS NORD (DC),1057,1129,276,257,19,872,853,0,72,-6.811731315042573,85,145,7,0,7,145,138,0,60,-70.58823529411765,4.827586206896552,0.0,4.827586206896552,24.446412754650133,22.763507528786537,1.6829052258635961,Transport
2041,0,2019-06-04,127970,DANET CHOCO 125X8,0,0,0,DANETTE,0,StJust(FR),0084,0024 FR AIX (DC),2155,2202,2202,2200,2,2,0,0,47,-2.1809744779582365,31,35,35,35,0,0,0,0,4,-12.903225806451612,100.0,100.0,0.0,100.0,99.90917347865576,0.09082652134424052,A Creuser
2042,0,2019-06-04,127970,DANET CHOCO 125X8,0,0,0,DANETTE,0,StJust(FR),0081,0024 FR TOURS (DC),2155,2202,2202,2200,2,2,0,0,47,-2.1809744779582365,458,448,448,448,0,0,0,0,-10,2.183406113537118,100.0,100.0,0.0,100.0,99.90917347865576,0.09082652134424052,A Creuser
2043,0,2019-06-04,127970,DANET CHOCO 125X8,0,0,0,DANETTE,0,StJust(FR),0082,0024 FR VALLET (DC),2155,2202,2202,2200,2,2,0,0,47,-2.1809744779582365,21,121,121,121,0,0,0,0,100,-476.1904761904762,100.0,100.0,0.0,100.0,99.90917347865576,0.09082652134424052,A Creuser
2044,0,2019-06-04,127970,DANET CHOCO 125X8,0,0,0,DANETTE,0,StJust(FR),0077,0024 FR LILPARK (DC),2155,2202,2202,2200,2,2,0,0,47,-2.1809744779582365,590,567,567,567,0,0,0,0,-23,3.8983050847457625,100.0,100.0,0.0,100.0,99.90917347865576,0.09082652134424052,A Creuser
2045,0,2019-06-04,127970,DANET CHOCO 125X8,0,0,0,DANETTE,0,StJust(FR),0085,0024 FR TOULOUSE (DC),2155,2202,2202,2200,2,2,0,0,47,-2.1809744779582365,244,335,335,335,0,0,0,0,91,-37.295081967213115,100.0,100.0,0.0,100.0,99.90917347865576,0.09082652134424052,A Creuser
2046,0,2019-06-04,127970,DANET CHOCO 125X8,0,0,0,DANETTE,0,StJust(FR),0083,0024 FR CHAPONNAY (DC),2155,2202,2202,2200,2,2,0,0,47,-2.1809744779582365,70,82,82,82,0,0,0,0,12,-17.142857142857142,100.0,100.0,0.0,100.0,99.90917347865576,0.09082652134424052,A Creuser
2047,0,2019-06-04,127970,DANET CHOCO 125X8,0,0,0,DANETTE,0,StJust(FR),0079,0024 FR PARIS SUD (DC),2155,2202,2202,2200,2,2,0,0,47,-2.1809744779582365,448,348,348,348,0,0,0,0,-100,22.321428571428573,100.0,100.0,0.0,100.0,99.90917347865576,0.09082652134424052,A Creuser
2048,0,2019-06-04,127970,DANET CHOCO 125X8,0,0,0,DANETTE,0,StJust(FR),0078,0024 FR PARIS NORD (DC),2155,2202,2202,2200,2,2,0,0,47,-2.1809744779582365,293,266,266,264,2,2,0,0,-27,9.215017064846416,100.0,99.24812030075188,0.7518796992481214,100.0,99.90917347865576,0.09082652134424052,A Creuser
2049,1,2019-06-04,132459,ACTIVIA SAV VANILLE 125X4 OD,0,0,0,ACTIVIA,0,Bailleul(FR),0082,0024 FR VALLET (DC),103,353,328,326,2,27,25,0,250,-242.71844660194174,103,103,88,88,0,15,15,0,0,0.0,85.43689320388349,85.43689320388349,0.0,92.91784702549575,92.3512747875354,0.5665722379603437,Previsions
2050,0,2019-06-04,136162,FJORD NATURE 125X8 D,1,0,0,FJORD,0,LeMolay(FR),0080,0024 FR METZ (DC),781,960,851,467,384,493,109,0,179,-22.91933418693982,162,128,128,128,0,0,0,0,-34,20.987654320987655,100.0,100.0,0.0,88.64583333333333,48.645833333333336,39.99999999999999,Production
2051,0,2019-06-04,136162,FJORD NATURE 125X8 D,1,0,0,FJORD,0,LeMolay(FR),0081,0024 FR TOURS (DC),781,960,851,467,384,493,109,0,179,-22.91933418693982,57,64,64,64,0,0,0,0,7,-12.280701754385966,100.0,100.0,0.0,88.64583333333333,48.645833333333336,39.99999999999999,Production
2052,0,2019-06-04,136162,FJORD NATURE 125X8 D,1,0,0,FJORD,0,LeMolay(FR),0077,0024 FR LILPARK (DC),781,960,851,467,384,493,109,0,179,-22.91933418693982,0,128,128,128,0,0,0,1,128,10000.0,100.0,100.0,0.0,88.64583333333333,48.645833333333336,39.99999999999999,Production
2053,0,2019-06-04,136162,FJORD NATURE 125X8 D,1,0,0,FJORD,0,LeMolay(FR),0085,0024 FR TOULOUSE (DC),781,960,851,467,384,493,109,0,179,-22.91933418693982,140,256,147,147,0,109,109,0,116,-82.85714285714286,57.421875,57.421875,0.0,88.64583333333333,48.645833333333336,39.99999999999999,Production
2054,0,2019-06-04,136162,FJORD NATURE 125X8 D,1,0,0,FJORD,0,LeMolay(FR),0083,0024 FR CHAPONNAY (DC),781,960,851,467,384,493,109,0,179,-22.91933418693982,422,384,384,0,384,384,0,0,-38,9.004739336492891,100.0,0.0,100.0,88.64583333333333,48.645833333333336,39.99999999999999,Production
2055,0,2019-06-04,147230,L2V GOURMEUH MARRON VAN 115X2,0,1,0,LES 2 VACHES,0,LeMolay(FR),0084,0024 FR AIX (DC),197,736,482,441,41,295,254,0,539,-273.6040609137056,8,75,26,25,1,50,49,0,67,-837.5,34.66666666666667,33.33333333333333,1.3333333333333428,65.48913043478261,59.91847826086957,5.5706521739130395,Production
2056,0,2019-06-04,147230,L2V GOURMEUH MARRON VAN 115X2,0,1,0,LES 2 VACHES,0,LeMolay(FR),0080,0024 FR METZ (DC),197,736,482,441,41,295,254,0,539,-273.6040609137056,23,68,68,68,0,0,0,0,45,-195.65217391304347,100.0,100.0,0.0,65.48913043478261,59.91847826086957,5.5706521739130395,Production
2057,0,2019-06-04,147230,L2V GOURMEUH MARRON VAN 115X2,0,1,0,LES 2 VACHES,0,LeMolay(FR),0081,0024 FR TOURS (DC),197,736,482,441,41,295,254,0,539,-273.6040609137056,50,57,57,57,0,0,0,0,7,-14.0,100.0,100.0,0.0,65.48913043478261,59.91847826086957,5.5706521739130395,Production
2058,0,2019-06-04,147230,L2V GOURMEUH MARRON VAN 115X2,0,1,0,LES 2 VACHES,0,LeMolay(FR),0082,0024 FR VALLET (DC),197,736,482,441,41,295,254,0,539,-273.6040609137056,7,65,61,60,1,5,4,0,58,-828.5714285714286,93.84615384615384,92.3076923076923,1.538461538461533,65.48913043478261,59.91847826086957,5.5706521739130395,Production
2059,0,2019-06-04,147230,L2V GOURMEUH MARRON VAN 115X2,0,1,0,LES 2 VACHES,0,LeMolay(FR),0077,0024 FR LILPARK (DC),197,736,482,441,41,295,254,0,539,-273.6040609137056,8,26,26,26,0,0,0,0,18,-225.0,100.0,100.0,0.0,65.48913043478261,59.91847826086957,5.5706521739130395,Production
2060,0,2019-06-04,147230,L2V GOURMEUH MARRON VAN 115X2,0,1,0,LES 2 VACHES,0,LeMolay(FR),0085,0024 FR TOULOUSE (DC),197,736,482,441,41,295,254,0,539,-273.6040609137056,59,86,84,45,39,41,2,0,27,-45.76271186440678,97.67441860465115,52.32558139534884,45.34883720930231,65.48913043478261,59.91847826086957,5.5706521739130395,Production
2061,0,2019-06-04,147230,L2V GOURMEUH MARRON VAN 115X2,0,1,0,LES 2 VACHES,0,LeMolay(FR),0083,0024 FR CHAPONNAY (DC),197,736,482,441,41,295,254,0,539,-273.6040609137056,30,226,140,140,0,86,86,0,196,-653.3333333333334,61.94690265486725,61.94690265486725,0.0,65.48913043478261,59.91847826086957,5.5706521739130395,Production
2062,0,2019-06-04,147230,L2V GOURMEUH MARRON VAN 115X2,0,1,0,LES 2 VACHES,0,LeMolay(FR),0079,0024 FR PARIS SUD (DC),197,736,482,441,41,295,254,0,539,-273.6040609137056,12,133,20,20,0,113,113,0,121,-1008.3333333333334,15.037593984962406,15.037593984962406,0.0,65.48913043478261,59.91847826086957,5.5706521739130395,Production
2063,0,2019-06-05,2118,GERVITA NATUR 100gx4,0,0,0,GERVITA,0,Ferrières(FR),0084,0024 FR AIX (DC),8005,8634,7436,7436,0,1198,1198,0,629,-7.857589006870706,1391,1343,1343,1343,0,0,0,0,-48,3.4507548526240117,100.0,100.0,0.0,86.12462358119063,86.12462358119063,0.0,Qualité
2064,0,2019-06-05,2118,GERVITA NATUR 100gx4,0,0,0,GERVITA,0,Ferrières(FR),0080,0024 FR METZ (DC),8005,8634,7436,7436,0,1198,1198,0,629,-7.857589006870706,431,492,492,492,0,0,0,0,61,-14.153132250580047,100.0,100.0,0.0,86.12462358119063,86.12462358119063,0.0,Qualité
2065,0,2019-06-05,2118,GERVITA NATUR 100gx4,0,0,0,GERVITA,0,Ferrières(FR),0081,0024 FR TOURS (DC),8005,8634,7436,7436,0,1198,1198,0,629,-7.857589006870706,670,805,800,800,0,5,5,0,135,-20.149253731343283,99.37888198757764,99.37888198757764,0.0,86.12462358119063,86.12462358119063,0.0,Qualité
2066,0,2019-06-05,2118,GERVITA NATUR 100gx4,0,0,0,GERVITA,0,Ferrières(FR),0082,0024 FR VALLET (DC),8005,8634,7436,7436,0,1198,1198,0,629,-7.857589006870706,731,542,332,332,0,210,210,0,-189,25.85499316005472,61.254612546125465,61.254612546125465,0.0,86.12462358119063,86.12462358119063,0.0,Qualité
2067,0,2019-06-05,2118,GERVITA NATUR 100gx4,0,0,0,GERVITA,0,Ferrières(FR),0077,0024 FR LILPARK (DC),8005,8634,7436,7436,0,1198,1198,0,629,-7.857589006870706,378,348,348,348,0,0,0,0,-30,7.936507936507937,100.0,100.0,0.0,86.12462358119063,86.12462358119063,0.0,Qualité
2068,0,2019-06-05,2118,GERVITA NATUR 100gx4,0,0,0,GERVITA,0,Ferrières(FR),0085,0024 FR TOULOUSE (DC),8005,8634,7436,7436,0,1198,1198,0,629,-7.857589006870706,1173,1214,1214,1214,0,0,0,0,41,-3.495311167945439,100.0,100.0,0.0,86.12462358119063,86.12462358119063,0.0,Qualité
2069,0,2019-06-05,2118,GERVITA NATUR 100gx4,0,0,0,GERVITA,0,Ferrières(FR),0083,0024 FR CHAPONNAY (DC),8005,8634,7436,7436,0,1198,1198,0,629,-7.857589006870706,940,1005,943,943,0,62,62,0,65,-6.914893617021277,93.83084577114428,93.83084577114428,0.0,86.12462358119063,86.12462358119063,0.0,Qualité
2070,0,2019-06-05,2118,GERVITA NATUR 100gx4,0,0,0,GERVITA,0,Ferrières(FR),0079,0024 FR PARIS SUD (DC),8005,8634,7436,7436,0,1198,1198,0,629,-7.857589006870706,1509,1703,1268,1268,0,435,435,0,194,-12.856196156394963,74.4568408690546,74.4568408690546,0.0,86.12462358119063,86.12462358119063,0.0,Qualité
2071,0,2019-06-05,2118,GERVITA NATUR 100gx4,0,0,0,GERVITA,0,Ferrières(FR),0078,0024 FR PARIS NORD (DC),8005,8634,7436,7436,0,1198,1198,0,629,-7.857589006870706,782,1182,696,696,0,486,486,0,400,-51.150895140664964,58.88324873096447,58.88324873096447,0.0,86.12462358119063,86.12462358119063,0.0,Qualité
2072,0,2019-06-05,114706,ACTIVIA NATURE 125X4,0,0,0,ACTIVIA,0,Bailleul(FR),0084,0024 FR AIX (DC),3315,3487,2920,2572,348,915,567,0,172,-5.188536953242836,466,475,461,461,0,14,14,0,9,-1.9313304721030042,97.05263157894737,97.05263157894737,0.0,83.7396042443361,73.75967880699741,9.979925437338693,Production
2073,0,2019-06-05,114706,ACTIVIA NATURE 125X4,0,0,0,ACTIVIA,0,Bailleul(FR),0080,0024 FR METZ (DC),3315,3487,2920,2572,348,915,567,0,172,-5.188536953242836,257,311,267,42,225,269,44,0,54,-21.011673151750973,85.85209003215434,13.504823151125404,72.34726688102893,83.7396042443361,73.75967880699741,9.979925437338693,Production
2074,0,2019-06-05,114706,ACTIVIA NATURE 125X4,0,0,0,ACTIVIA,0,Bailleul(FR),0081,0024 FR TOURS (DC),3315,3487,2920,2572,348,915,567,0,172,-5.188536953242836,423,423,220,220,0,203,203,0,0,0.0,52.00945626477541,52.00945626477541,0.0,83.7396042443361,73.75967880699741,9.979925437338693,Production
2075,0,2019-06-05,114706,ACTIVIA NATURE 125X4,0,0,0,ACTIVIA,0,Bailleul(FR),0082,0024 FR VALLET (DC),3315,3487,2920,2572,348,915,567,0,172,-5.188536953242836,315,228,175,175,0,53,53,0,-87,27.61904761904762,76.75438596491229,76.75438596491229,0.0,83.7396042443361,73.75967880699741,9.979925437338693,Production
2076,0,2019-06-05,114706,ACTIVIA NATURE 125X4,0,0,0,ACTIVIA,0,Bailleul(FR),0077,0024 FR LILPARK (DC),3315,3487,2920,2572,348,915,567,0,172,-5.188536953242836,135,196,123,0,123,196,73,0,61,-45.18518518518518,62.755102040816325,0.0,62.755102040816325,83.7396042443361,73.75967880699741,9.979925437338693,Production
2077,0,2019-06-05,114706,ACTIVIA NATURE 125X4,0,0,0,ACTIVIA,0,Bailleul(FR),0085,0024 FR TOULOUSE (DC),3315,3487,2920,2572,348,915,567,0,172,-5.188536953242836,344,344,344,344,0,0,0,0,0,0.0,100.0,100.0,0.0,83.7396042443361,73.75967880699741,9.979925437338693,Production
2078,0,2019-06-05,114706,ACTIVIA NATURE 125X4,0,0,0,ACTIVIA,0,Bailleul(FR),0083,0024 FR CHAPONNAY (DC),3315,3487,2920,2572,348,915,567,0,172,-5.188536953242836,563,609,609,609,0,0,0,0,46,-8.170515097690942,100.0,100.0,0.0,83.7396042443361,73.75967880699741,9.979925437338693,Production
2079,0,2019-06-05,114706,ACTIVIA NATURE 125X4,0,0,0,ACTIVIA,0,Bailleul(FR),0079,0024 FR PARIS SUD (DC),3315,3487,2920,2572,348,915,567,0,172,-5.188536953242836,489,577,504,504,0,73,73,0,88,-17.995910020449898,87.34835355285962,87.34835355285962,0.0,83.7396042443361,73.75967880699741,9.979925437338693,Production
2080,0,2019-06-05,114706,ACTIVIA NATURE 125X4,0,0,0,ACTIVIA,0,Bailleul(FR),0078,0024 FR PARIS NORD (DC),3315,3487,2920,2572,348,915,567,0,172,-5.188536953242836,323,324,217,217,0,107,107,0,1,-0.30959752321981426,66.9753086419753,66.9753086419753,0.0,83.7396042443361,73.75967880699741,9.979925437338693,Production
2081,0,2019-06-05,122709,DANONINO GO POUCH STR 4x4x70G FR,0,0,0,DANONINO,1,Bierun(PL),0084,0024 FR AIX (DC),769,832,608,525,83,307,224,0,63,-8.192457737321197,136,118,99,99,0,19,19,0,-18,13.235294117647058,83.89830508474576,83.89830508474576,0.0,73.07692307692307,63.10096153846154,9.975961538461526,Previsions
2082,0,2019-06-05,122709,DANONINO GO POUCH STR 4x4x70G FR,0,0,0,DANONINO,1,Bierun(PL),0080,0024 FR METZ (DC),769,832,608,525,83,307,224,0,63,-8.192457737321197,66,72,72,72,0,0,0,0,6,-9.090909090909092,100.0,100.0,0.0,73.07692307692307,63.10096153846154,9.975961538461526,Previsions
2083,0,2019-06-05,122709,DANONINO GO POUCH STR 4x4x70G FR,0,0,0,DANONINO,1,Bierun(PL),0081,0024 FR TOURS (DC),769,832,608,525,83,307,224,0,63,-8.192457737321197,58,75,65,65,0,10,10,0,17,-29.310344827586206,86.66666666666667,86.66666666666667,0.0,73.07692307692307,63.10096153846154,9.975961538461526,Previsions
2084,0,2019-06-05,122709,DANONINO GO POUCH STR 4x4x70G FR,0,0,0,DANONINO,1,Bierun(PL),0082,0024 FR VALLET (DC),769,832,608,525,83,307,224,0,63,-8.192457737321197,43,50,50,50,0,0,0,0,7,-16.27906976744186,100.0,100.0,0.0,73.07692307692307,63.10096153846154,9.975961538461526,Previsions
2085,0,2019-06-05,122709,DANONINO GO POUCH STR 4x4x70G FR,0,0,0,DANONINO,1,Bierun(PL),0077,0024 FR LILPARK (DC),769,832,608,525,83,307,224,0,63,-8.192457737321197,35,82,82,0,82,82,0,0,47,-134.28571428571428,100.0,0.0,100.0,73.07692307692307,63.10096153846154,9.975961538461526,Previsions
2086,0,2019-06-05,122709,DANONINO GO POUCH STR 4x4x70G FR,0,0,0,DANONINO,1,Bierun(PL),0085,0024 FR TOULOUSE (DC),769,832,608,525,83,307,224,0,63,-8.192457737321197,67,98,5,4,1,94,93,0,31,-46.26865671641791,5.1020408163265305,4.081632653061225,1.020408163265306,73.07692307692307,63.10096153846154,9.975961538461526,Previsions
2087,0,2019-06-05,122709,DANONINO GO POUCH STR 4x4x70G FR,0,0,0,DANONINO,1,Bierun(PL),0083,0024 FR CHAPONNAY (DC),769,832,608,525,83,307,224,0,63,-8.192457737321197,132,124,115,115,0,9,9,0,-8,6.0606060606060606,92.74193548387096,92.74193548387096,0.0,73.07692307692307,63.10096153846154,9.975961538461526,Previsions
2088,0,2019-06-05,122709,DANONINO GO POUCH STR 4x4x70G FR,0,0,0,DANONINO,1,Bierun(PL),0079,0024 FR PARIS SUD (DC),769,832,608,525,83,307,224,0,63,-8.192457737321197,164,113,72,72,0,41,41,0,-51,31.097560975609756,63.716814159292035,63.716814159292035,0.0,73.07692307692307,63.10096153846154,9.975961538461526,Previsions
2089,0,2019-06-05,122709,DANONINO GO POUCH STR 4x4x70G FR,0,0,0,DANONINO,1,Bierun(PL),0078,0024 FR PARIS NORD (DC),769,832,608,525,83,307,224,0,63,-8.192457737321197,68,100,48,48,0,52,52,0,32,-47.05882352941177,48.0,48.0,0.0,73.07692307692307,63.10096153846154,9.975961538461526,Previsions
2090,0,2019-06-05,136162,FJORD NATURE 125X8 D,1,0,0,FJORD,0,LeMolay(FR),0080,0024 FR METZ (DC),630,1088,1088,256,832,832,0,0,458,-72.6984126984127,133,128,128,128,0,0,0,0,-5,3.7593984962406015,100.0,100.0,0.0,100.0,23.52941176470588,76.47058823529412,Production
2091,0,2019-06-05,136162,FJORD NATURE 125X8 D,1,0,0,FJORD,0,LeMolay(FR),0077,0024 FR LILPARK (DC),630,1088,1088,256,832,832,0,0,458,-72.6984126984127,93,128,128,128,0,0,0,0,35,-37.634408602150536,100.0,100.0,0.0,100.0,23.52941176470588,76.47058823529412,Production
2092,0,2019-06-05,136162,FJORD NATURE 125X8 D,1,0,0,FJORD,0,LeMolay(FR),0083,0024 FR CHAPONNAY (DC),630,1088,1088,256,832,832,0,0,458,-72.6984126984127,404,832,832,0,832,832,0,0,428,-105.94059405940594,100.0,0.0,100.0,100.0,23.52941176470588,76.47058823529412,Production
2093,0,2019-06-05,147230,L2V GOURMEUH MARRON VAN 115X2,0,1,0,LES 2 VACHES,0,LeMolay(FR),0080,0024 FR METZ (DC),199,304,147,145,2,159,157,0,105,-52.76381909547739,80,86,22,22,0,64,64,0,6,-7.5,25.581395348837212,25.581395348837212,0.0,48.35526315789473,47.69736842105263,0.6578947368421026,Production
2094,0,2019-06-05,147230,L2V GOURMEUH MARRON VAN 115X2,0,1,0,LES 2 VACHES,0,LeMolay(FR),0081,0024 FR TOURS (DC),199,304,147,145,2,159,157,0,105,-52.76381909547739,22,11,11,11,0,0,0,0,-11,50.0,100.0,100.0,0.0,48.35526315789473,47.69736842105263,0.6578947368421026,Production
2095,0,2019-06-05,147230,L2V GOURMEUH MARRON VAN 115X2,0,1,0,LES 2 VACHES,0,LeMolay(FR),0077,0024 FR LILPARK (DC),199,304,147,145,2,159,157,0,105,-52.76381909547739,15,36,21,21,0,15,15,0,21,-140.0,58.333333333333336,58.333333333333336,0.0,48.35526315789473,47.69736842105263,0.6578947368421026,Production
2096,0,2019-06-05,147230,L2V GOURMEUH MARRON VAN 115X2,0,1,0,LES 2 VACHES,0,LeMolay(FR),0085,0024 FR TOULOUSE (DC),199,304,147,145,2,159,157,0,105,-52.76381909547739,25,53,43,43,0,10,10,0,28,-112.0,81.13207547169812,81.13207547169812,0.0,48.35526315789473,47.69736842105263,0.6578947368421026,Production
2097,0,2019-06-05,147230,L2V GOURMEUH MARRON VAN 115X2,0,1,0,LES 2 VACHES,0,LeMolay(FR),0079,0024 FR PARIS SUD (DC),199,304,147,145,2,159,157,0,105,-52.76381909547739,41,84,30,29,1,55,54,0,43,-104.8780487804878,35.714285714285715,34.523809523809526,1.1904761904761898,48.35526315789473,47.69736842105263,0.6578947368421026,Production
2098,0,2019-06-05,147230,L2V GOURMEUH MARRON VAN 115X2,0,1,0,LES 2 VACHES,0,LeMolay(FR),0078,0024 FR PARIS NORD (DC),199,304,147,145,2,159,157,0,105,-52.76381909547739,16,34,20,19,1,15,14,0,18,-112.5,58.82352941176471,55.88235294117647,2.941176470588239,48.35526315789473,47.69736842105263,0.6578947368421026,Production
2099,0,2019-06-06,2118,GERVITA NATUR 100gx4,0,0,0,GERVITA,0,Ferrières(FR),0084,0024 FR AIX (DC),8758,10268,7537,7519,18,2749,2731,0,1510,-17.24137931034483,1385,1359,1359,1359,0,0,0,0,-26,1.8772563176895307,100.0,100.0,0.0,73.40280483054148,73.22750292169849,0.17530190884299657,Qualité
2100,0,2019-06-06,2118,GERVITA NATUR 100gx4,0,0,0,GERVITA,0,Ferrières(FR),0080,0024 FR METZ (DC),8758,10268,7537,7519,18,2749,2731,0,1510,-17.24137931034483,408,549,69,69,0,480,480,0,141,-34.55882352941177,12.568306010928962,12.568306010928962,0.0,73.40280483054148,73.22750292169849,0.17530190884299657,Qualité
2101,0,2019-06-06,2118,GERVITA NATUR 100gx4,0,0,0,GERVITA,0,Ferrières(FR),0081,0024 FR TOURS (DC),8758,10268,7537,7519,18,2749,2731,0,1510,-17.24137931034483,993,1223,511,511,0,712,712,0,230,-23.162134944612287,41.782502044153716,41.782502044153716,0.0,73.40280483054148,73.22750292169849,0.17530190884299657,Qualité
2102,0,2019-06-06,2118,GERVITA NATUR 100gx4,0,0,0,GERVITA,0,Ferrières(FR),0082,0024 FR VALLET (DC),8758,10268,7537,7519,18,2749,2731,0,1510,-17.24137931034483,530,666,666,666,0,0,0,0,136,-25.660377358490567,100.0,100.0,0.0,73.40280483054148,73.22750292169849,0.17530190884299657,Qualité
2103,0,2019-06-06,2118,GERVITA NATUR 100gx4,0,0,0,GERVITA,0,Ferrières(FR),0077,0024 FR LILPARK (DC),8758,10268,7537,7519,18,2749,2731,0,1510,-17.24137931034483,627,800,472,471,1,329,328,0,173,-27.59170653907496,59.0,58.875,0.125,73.40280483054148,73.22750292169849,0.17530190884299657,Qualité
2104,0,2019-06-06,2118,GERVITA NATUR 100gx4,0,0,0,GERVITA,0,Ferrières(FR),0085,0024 FR TOULOUSE (DC),8758,10268,7537,7519,18,2749,2731,0,1510,-17.24137931034483,1263,1722,1676,1666,10,56,46,0,459,-36.342042755344416,97.32868757259001,96.7479674796748,0.5807200929152145,73.40280483054148,73.22750292169849,0.17530190884299657,Qualité
2105,0,2019-06-06,2118,GERVITA NATUR 100gx4,0,0,0,GERVITA,0,Ferrières(FR),0083,0024 FR CHAPONNAY (DC),8758,10268,7537,7519,18,2749,2731,0,1510,-17.24137931034483,1061,1132,1026,1024,2,108,106,0,71,-6.691800188501413,90.63604240282686,90.45936395759718,0.17667844522968323,73.40280483054148,73.22750292169849,0.17530190884299657,Qualité
2106,0,2019-06-06,2118,GERVITA NATUR 100gx4,0,0,0,GERVITA,0,Ferrières(FR),0079,0024 FR PARIS SUD (DC),8758,10268,7537,7519,18,2749,2731,0,1510,-17.24137931034483,1218,1356,1029,1024,5,332,327,0,138,-11.330049261083744,75.88495575221239,75.51622418879056,0.3687315634218322,73.40280483054148,73.22750292169849,0.17530190884299657,Qualité
2107,0,2019-06-06,2118,GERVITA NATUR 100gx4,0,0,0,GERVITA,0,Ferrières(FR),0078,0024 FR PARIS NORD (DC),8758,10268,7537,7519,18,2749,2731,0,1510,-17.24137931034483,1273,1461,729,729,0,732,732,0,188,-14.768263943440692,49.89733059548255,49.89733059548255,0.0,73.40280483054148,73.22750292169849,0.17530190884299657,Qualité
2108,1,2019-06-06,132457,ACTIVIA SAV COCO 125X4 OD,0,0,0,ACTIVIA,0,Bailleul(FR),0081,0024 FR TOURS (DC),519,610,487,433,54,177,123,0,91,-17.533718689788053,83,83,78,51,27,32,5,0,0,0.0,93.97590361445783,61.44578313253012,32.53012048192772,79.83606557377048,70.98360655737706,8.852459016393425,Previsions
2109,1,2019-06-06,132457,ACTIVIA SAV COCO 125X4 OD,0,0,0,ACTIVIA,0,Bailleul(FR),0082,0024 FR VALLET (DC),519,610,487,433,54,177,123,0,91,-17.533718689788053,79,79,66,66,0,13,13,0,0,0.0,83.54430379746836,83.54430379746836,0.0,79.83606557377048,70.98360655737706,8.852459016393425,Previsions
2110,1,2019-06-06,132457,ACTIVIA SAV COCO 125X4 OD,0,0,0,ACTIVIA,0,Bailleul(FR),0085,0024 FR TOULOUSE (DC),519,610,487,433,54,177,123,0,91,-17.533718689788053,63,63,34,34,0,29,29,0,0,0.0,53.96825396825397,53.96825396825397,0.0,79.83606557377048,70.98360655737706,8.852459016393425,Previsions
2111,1,2019-06-06,132457,ACTIVIA SAV COCO 125X4 OD,0,0,0,ACTIVIA,0,Bailleul(FR),0083,0024 FR CHAPONNAY (DC),519,610,487,433,54,177,123,0,91,-17.533718689788053,230,233,159,159,0,74,74,0,3,-1.3043478260869565,68.24034334763948,68.24034334763948,0.0,79.83606557377048,70.98360655737706,8.852459016393425,Previsions
2112,1,2019-06-06,132457,ACTIVIA SAV COCO 125X4 OD,0,0,0,ACTIVIA,0,Bailleul(FR),0079,0024 FR PARIS SUD (DC),519,610,487,433,54,177,123,0,91,-17.533718689788053,64,64,62,35,27,29,2,0,0,0.0,96.875,54.6875,42.1875,79.83606557377048,70.98360655737706,8.852459016393425,Previsions
2113,1,2019-06-06,135065,ACTIVIA SAV PANACHE 125X12 OD,1,0,0,ACTIVIA,0,Bailleul(FR),0083,0024 FR CHAPONNAY (DC),154,408,285,241,44,167,123,0,254,-164.93506493506493,154,168,168,124,44,44,0,0,14,-9.090909090909092,100.0,73.80952380952381,26.19047619047619,69.85294117647058,59.068627450980394,10.784313725490186,Probleme Copacking
2114,1,2019-06-07,433,DANET MOUS CHOC LIEG 80gx4,1,0,0,DANETTE,1,Ochsenfurt(ALL),0083,0024 FR CHAPONNAY (DC),213,1724,1724,1698,26,26,0,0,1511,-709.3896713615023,213,250,250,224,26,26,0,0,37,-17.370892018779344,100.0,89.60000000000001,10.399999999999991,100.0,98.49187935034803,1.5081206496519712,Transport
2115,0,2019-06-07,2118,GERVITA NATUR 100gx4,0,0,0,GERVITA,0,Ferrières(FR),0084,0024 FR AIX (DC),7416,7654,862,670,192,6984,6792,0,238,-3.209277238403452,1357,1636,162,162,0,1474,1474,0,279,-20.56005895357406,9.902200488997554,9.902200488997554,0.0,11.262085184217403,8.753592892605173,2.50849229161223,Qualité
2116,0,2019-06-07,2118,GERVITA NATUR 100gx4,0,0,0,GERVITA,0,Ferrières(FR),0080,0024 FR METZ (DC),7416,7654,862,670,192,6984,6792,0,238,-3.209277238403452,424,559,5,1,4,558,554,0,135,-31.839622641509433,0.8944543828264758,0.17889087656529518,0.7155635062611807,11.262085184217403,8.753592892605173,2.50849229161223,Qualité
2117,0,2019-06-07,2118,GERVITA NATUR 100gx4,0,0,0,GERVITA,0,Ferrières(FR),0081,0024 FR TOURS (DC),7416,7654,862,670,192,6984,6792,0,238,-3.209277238403452,1192,1299,255,255,0,1044,1044,0,107,-8.976510067114093,19.630484988452658,19.630484988452658,0.0,11.262085184217403,8.753592892605173,2.50849229161223,Qualité
2118,0,2019-06-07,2118,GERVITA NATUR 100gx4,0,0,0,GERVITA,0,Ferrières(FR),0082,0024 FR VALLET (DC),7416,7654,862,670,192,6984,6792,0,238,-3.209277238403452,728,715,213,213,0,502,502,0,-13,1.7857142857142858,29.790209790209794,29.790209790209794,0.0,11.262085184217403,8.753592892605173,2.50849229161223,Qualité
2119,0,2019-06-07,2118,GERVITA NATUR 100gx4,0,0,0,GERVITA,0,Ferrières(FR),0077,0024 FR LILPARK (DC),7416,7654,862,670,192,6984,6792,0,238,-3.209277238403452,589,455,12,1,11,454,443,0,-134,22.750424448217316,2.6373626373626373,0.21978021978021978,2.4175824175824174,11.262085184217403,8.753592892605173,2.50849229161223,Qualité
2120,0,2019-06-07,2118,GERVITA NATUR 100gx4,0,0,0,GERVITA,0,Ferrières(FR),0079,0024 FR PARIS SUD (DC),7416,7654,862,670,192,6984,6792,0,238,-3.209277238403452,1716,1522,177,0,177,1522,1345,0,-194,11.305361305361306,11.629434954007884,0.0,11.629434954007884,11.262085184217403,8.753592892605173,2.50849229161223,Qualité
2121,0,2019-06-07,2118,GERVITA NATUR 100gx4,0,0,0,GERVITA,0,Ferrières(FR),0078,0024 FR PARIS NORD (DC),7416,7654,862,670,192,6984,6792,0,238,-3.209277238403452,1410,1468,38,38,0,1430,1430,0,58,-4.113475177304965,2.588555858310627,2.588555858310627,0.0,11.262085184217403,8.753592892605173,2.50849229161223,Qualité
2122,1,2019-06-07,69004,DANETTE MOU LIEG 80X8 CAFE NEW,0,0,0,DANETTE,1,Ochsenfurt(ALL),0083,0024 FR CHAPONNAY (DC),297,2525,2525,2428,97,97,0,0,2228,-750.1683501683501,297,341,341,244,97,97,0,0,44,-14.814814814814815,100.0,71.5542521994135,28.445747800586503,100.0,96.15841584158416,3.8415841584158414,Transport
2123,0,2019-06-07,113631,GERVITA NATURE 100X8 OPL,0,0,0,GERVITA,0,Ferrières(FR),0084,0024 FR AIX (DC),5705,3026,1732,1594,138,1432,1294,0,-2679,46.958808063102545,386,386,136,8,128,378,250,0,0,0.0,35.233160621761655,2.072538860103627,33.16062176165803,57.237276933245205,52.676801057501656,4.560475875743549,Qualité
2124,1,2019-06-07,113631,GERVITA NATURE 100X8 OPL,0,0,0,GERVITA,0,Ferrières(FR),0084,0024 FR AIX (DC),5705,3026,1732,1594,138,1432,1294,0,-2679,46.958808063102545,386,386,136,8,128,378,250,0,0,0.0,35.233160621761655,2.072538860103627,33.16062176165803,57.237276933245205,52.676801057501656,4.560475875743549,Qualité
2125,0,2019-06-07,113631,GERVITA NATURE 100X8 OPL,0,0,0,GERVITA,0,Ferrières(FR),0080,0024 FR METZ (DC),5705,3026,1732,1594,138,1432,1294,0,-2679,46.958808063102545,280,280,280,280,0,0,0,0,0,0.0,100.0,100.0,0.0,57.237276933245205,52.676801057501656,4.560475875743549,Qualité
2126,0,2019-06-07,113631,GERVITA NATURE 100X8 OPL,0,0,0,GERVITA,0,Ferrières(FR),0081,0024 FR TOURS (DC),5705,3026,1732,1594,138,1432,1294,0,-2679,46.958808063102545,201,201,15,15,0,186,186,0,0,0.0,7.462686567164178,7.462686567164178,0.0,57.237276933245205,52.676801057501656,4.560475875743549,Qualité
2127,1,2019-06-07,113631,GERVITA NATURE 100X8 OPL,0,0,0,GERVITA,0,Ferrières(FR),0081,0024 FR TOURS (DC),5705,3026,1732,1594,138,1432,1294,0,-2679,46.958808063102545,201,201,15,15,0,186,186,0,0,0.0,7.462686567164178,7.462686567164178,0.0,57.237276933245205,52.676801057501656,4.560475875743549,Qualité
2128,0,2019-06-07,113631,GERVITA NATURE 100X8 OPL,0,0,0,GERVITA,0,Ferrières(FR),0082,0024 FR VALLET (DC),5705,3026,1732,1594,138,1432,1294,0,-2679,46.958808063102545,111,111,111,111,0,0,0,0,0,0.0,100.0,100.0,0.0,57.237276933245205,52.676801057501656,4.560475875743549,Qualité
2129,0,2019-06-07,113631,GERVITA NATURE 100X8 OPL,0,0,0,GERVITA,0,Ferrières(FR),0085,0024 FR TOULOUSE (DC),5705,3026,1732,1594,138,1432,1294,0,-2679,46.958808063102545,272,272,177,177,0,95,95,0,0,0.0,65.07352941176471,65.07352941176471,0.0,57.237276933245205,52.676801057501656,4.560475875743549,Qualité
2130,1,2019-06-07,113631,GERVITA NATURE 100X8 OPL,0,0,0,GERVITA,0,Ferrières(FR),0085,0024 FR TOULOUSE (DC),5705,3026,1732,1594,138,1432,1294,0,-2679,46.958808063102545,272,272,177,177,0,95,95,0,0,0.0,65.07352941176471,65.07352941176471,0.0,57.237276933245205,52.676801057501656,4.560475875743549,Qualité
2131,0,2019-06-07,113631,GERVITA NATURE 100X8 OPL,0,0,0,GERVITA,0,Ferrières(FR),0083,0024 FR CHAPONNAY (DC),5705,3026,1732,1594,138,1432,1294,0,-2679,46.958808063102545,1047,1025,439,439,0,586,586,0,-22,2.1012416427889207,42.829268292682926,42.829268292682926,0.0,57.237276933245205,52.676801057501656,4.560475875743549,Qualité
2132,1,2019-06-07,113631,GERVITA NATURE 100X8 OPL,0,0,0,GERVITA,0,Ferrières(FR),0083,0024 FR CHAPONNAY (DC),5705,3026,1732,1594,138,1432,1294,0,-2679,46.958808063102545,1047,1025,439,439,0,586,586,0,-22,2.1012416427889207,42.829268292682926,42.829268292682926,0.0,57.237276933245205,52.676801057501656,4.560475875743549,Qualité
2133,0,2019-06-07,113631,GERVITA NATURE 100X8 OPL,0,0,0,GERVITA,0,Ferrières(FR),0079,0024 FR PARIS SUD (DC),5705,3026,1732,1594,138,1432,1294,0,-2679,46.958808063102545,156,156,94,93,1,63,62,0,0,0.0,60.256410256410255,59.61538461538461,0.6410256410256423,57.237276933245205,52.676801057501656,4.560475875743549,Qualité
2134,1,2019-06-07,113631,GERVITA NATURE 100X8 OPL,0,0,0,GERVITA,0,Ferrières(FR),0079,0024 FR PARIS SUD (DC),5705,3026,1732,1594,138,1432,1294,0,-2679,46.958808063102545,156,156,94,93,1,63,62,0,0,0.0,60.256410256410255,59.61538461538461,0.6410256410256423,57.237276933245205,52.676801057501656,4.560475875743549,Qualité
2135,0,2019-06-07,113631,GERVITA NATURE 100X8 OPL,0,0,0,GERVITA,0,Ferrières(FR),0078,0024 FR PARIS NORD (DC),5705,3026,1732,1594,138,1432,1294,0,-2679,46.958808063102545,595,595,480,471,9,124,115,0,0,0.0,80.67226890756302,79.15966386554622,1.5126050420168013,57.237276933245205,52.676801057501656,4.560475875743549,Qualité
2136,1,2019-06-07,113631,GERVITA NATURE 100X8 OPL,0,0,0,GERVITA,0,Ferrières(FR),0078,0024 FR PARIS NORD (DC),5705,3026,1732,1594,138,1432,1294,0,-2679,46.958808063102545,595,595,480,471,9,124,115,0,0,0.0,80.67226890756302,79.15966386554622,1.5126050420168013,57.237276933245205,52.676801057501656,4.560475875743549,Qualité
2137,1,2019-06-07,121523,TAILLEFINE FRT RASPBERRY 125X4,0,0,0,TAILLEFINE,0,Villecomtal(FR),0081,0024 FR TOURS (DC),108,549,545,515,30,34,4,0,441,-408.3333333333333,108,106,106,76,30,30,0,0,-2,1.8518518518518519,100.0,71.69811320754717,28.301886792452834,99.27140255009107,93.80692167577413,5.4644808743169335,Transport
2138,0,2019-06-07,140278,Activia almond/muesli/chia 170g FR-copac,0,0,0,ACTIVIA,1,Roumanie(RO),0084,0024 FR AIX (DC),158,226,34,30,4,196,192,0,68,-43.037974683544306,116,140,2,0,2,140,138,0,24,-20.689655172413794,1.4285714285714286,0.0,1.4285714285714286,15.04424778761062,13.274336283185843,1.769911504424778,Transport
2139,0,2019-06-07,140278,Activia almond/muesli/chia 170g FR-copac,0,0,0,ACTIVIA,1,Roumanie(RO),0081,0024 FR TOURS (DC),158,226,34,30,4,196,192,0,68,-43.037974683544306,42,86,32,30,2,56,54,0,44,-104.76190476190476,37.2093023255814,34.883720930232556,2.3255813953488413,15.04424778761062,13.274336283185843,1.769911504424778,Transport
2140,0,2019-06-07,148355,ACTIVIA SHOT NAT 80X6,0,1,0,ACTIVIA,1,Benesov(CZ),0084,0024 FR AIX (DC),440,1030,421,216,205,814,609,0,590,-134.0909090909091,65,108,108,0,108,108,0,0,43,-66.15384615384616,100.0,0.0,100.0,40.873786407766985,20.97087378640777,19.902912621359217,Client
2141,0,2019-06-07,148355,ACTIVIA SHOT NAT 80X6,0,1,0,ACTIVIA,1,Benesov(CZ),0080,0024 FR METZ (DC),440,1030,421,216,205,814,609,0,590,-134.0909090909091,31,13,13,13,0,0,0,0,-18,58.064516129032256,100.0,100.0,0.0,40.873786407766985,20.97087378640777,19.902912621359217,Client
2142,0,2019-06-07,148355,ACTIVIA SHOT NAT 80X6,0,1,0,ACTIVIA,1,Benesov(CZ),0081,0024 FR TOURS (DC),440,1030,421,216,205,814,609,0,590,-134.0909090909091,46,25,25,13,12,12,0,0,-21,45.65217391304348,100.0,52.0,48.0,40.873786407766985,20.97087378640777,19.902912621359217,Client
2143,0,2019-06-07,148355,ACTIVIA SHOT NAT 80X6,0,1,0,ACTIVIA,1,Benesov(CZ),0082,0024 FR VALLET (DC),440,1030,421,216,205,814,609,0,590,-134.0909090909091,48,33,22,14,8,19,11,0,-15,31.25,66.66666666666666,42.42424242424242,24.242424242424235,40.873786407766985,20.97087378640777,19.902912621359217,Client
2144,0,2019-06-07,148355,ACTIVIA SHOT NAT 80X6,0,1,0,ACTIVIA,1,Benesov(CZ),0085,0024 FR TOULOUSE (DC),440,1030,421,216,205,814,609,0,590,-134.0909090909091,52,63,33,0,33,63,30,0,11,-21.153846153846153,52.38095238095239,0.0,52.38095238095239,40.873786407766985,20.97087378640777,19.902912621359217,Client
2145,0,2019-06-07,148355,ACTIVIA SHOT NAT 80X6,0,1,0,ACTIVIA,1,Benesov(CZ),0083,0024 FR CHAPONNAY (DC),440,1030,421,216,205,814,609,0,590,-134.0909090909091,75,111,111,92,19,19,0,0,36,-48.0,100.0,82.88288288288288,17.117117117117118,40.873786407766985,20.97087378640777,19.902912621359217,Client
2146,0,2019-06-07,148355,ACTIVIA SHOT NAT 80X6,0,1,0,ACTIVIA,1,Benesov(CZ),0079,0024 FR PARIS SUD (DC),440,1030,421,216,205,814,609,0,590,-134.0909090909091,67,539,24,0,24,539,515,0,472,-704.4776119402985,4.452690166975881,0.0,4.452690166975881,40.873786407766985,20.97087378640777,19.902912621359217,Client
2147,0,2019-06-07,148355,ACTIVIA SHOT NAT 80X6,0,1,0,ACTIVIA,1,Benesov(CZ),0078,0024 FR PARIS NORD (DC),440,1030,421,216,205,814,609,0,590,-134.0909090909091,56,138,85,84,1,54,53,0,82,-146.42857142857142,61.59420289855072,60.86956521739131,0.7246376811594075,40.873786407766985,20.97087378640777,19.902912621359217,Client
2148,0,2019-01-02,122525,DANONINO FRTS FRAI FRAM ABR 50X6,0,0,0,DANONINO,0,Ferrières(FR),0084,0024 FR AIX (DC),1533,1905,1249,1249,0,656,656,0,372,-24.26614481409002,213,296,296,296,0,0,0,0,83,-38.967136150234744,100.0,100.0,0.0,65.56430446194226,65.56430446194226,0.0,Previsions
2149,0,2019-01-02,122525,DANONINO FRTS FRAI FRAM ABR 50X6,0,0,0,DANONINO,0,Ferrières(FR),0080,0024 FR METZ (DC),1533,1905,1249,1249,0,656,656,0,372,-24.26614481409002,206,215,173,173,0,42,42,0,9,-4.368932038834951,80.46511627906978,80.46511627906978,0.0,65.56430446194226,65.56430446194226,0.0,Previsions
2150,0,2019-01-02,122525,DANONINO FRTS FRAI FRAM ABR 50X6,0,0,0,DANONINO,0,Ferrières(FR),0081,0024 FR TOURS (DC),1533,1905,1249,1249,0,656,656,0,372,-24.26614481409002,12,159,159,159,0,0,0,0,147,-1225.0,100.0,100.0,0.0,65.56430446194226,65.56430446194226,0.0,Previsions
2151,0,2019-01-02,122525,DANONINO FRTS FRAI FRAM ABR 50X6,0,0,0,DANONINO,0,Ferrières(FR),0082,0024 FR VALLET (DC),1533,1905,1249,1249,0,656,656,0,372,-24.26614481409002,129,125,38,38,0,87,87,0,-4,3.10077519379845,30.4,30.4,0.0,65.56430446194226,65.56430446194226,0.0,Previsions
2152,0,2019-01-02,122525,DANONINO FRTS FRAI FRAM ABR 50X6,0,0,0,DANONINO,0,Ferrières(FR),0077,0024 FR LILPARK (DC),1533,1905,1249,1249,0,656,656,0,372,-24.26614481409002,120,115,115,115,0,0,0,0,-5,4.166666666666667,100.0,100.0,0.0,65.56430446194226,65.56430446194226,0.0,Previsions
2153,0,2019-01-02,122525,DANONINO FRTS FRAI FRAM ABR 50X6,0,0,0,DANONINO,0,Ferrières(FR),0085,0024 FR TOULOUSE (DC),1533,1905,1249,1249,0,656,656,0,372,-24.26614481409002,236,264,151,151,0,113,113,0,28,-11.864406779661017,57.1969696969697,57.1969696969697,0.0,65.56430446194226,65.56430446194226,0.0,Previsions
2154,0,2019-01-02,122525,DANONINO FRTS FRAI FRAM ABR 50X6,0,0,0,DANONINO,0,Ferrières(FR),0083,0024 FR CHAPONNAY (DC),1533,1905,1249,1249,0,656,656,0,372,-24.26614481409002,285,328,7,7,0,321,321,0,43,-15.087719298245615,2.1341463414634148,2.1341463414634148,0.0,65.56430446194226,65.56430446194226,0.0,Previsions
2155,0,2019-01-02,122525,DANONINO FRTS FRAI FRAM ABR 50X6,0,0,0,DANONINO,0,Ferrières(FR),0079,0024 FR PARIS SUD (DC),1533,1905,1249,1249,0,656,656,0,372,-24.26614481409002,223,279,186,186,0,93,93,0,56,-25.112107623318387,66.66666666666666,66.66666666666666,0.0,65.56430446194226,65.56430446194226,0.0,Previsions
2156,0,2019-01-02,122525,DANONINO FRTS FRAI FRAM ABR 50X6,0,0,0,DANONINO,0,Ferrières(FR),0078,0024 FR PARIS NORD (DC),1533,1905,1249,1249,0,656,656,0,372,-24.26614481409002,109,124,124,124,0,0,0,0,15,-13.761467889908257,100.0,100.0,0.0,65.56430446194226,65.56430446194226,0.0,Previsions
2157,0,2019-01-03,122050,VELOUTE FRUIX ROUGES 125X8 OD,1,0,0,VELOUTE,0,Villecomtal(FR),0084,0024 FR AIX (DC),1861,1583,1324,1324,0,259,259,0,-278,14.93820526598603,154,92,63,63,0,29,29,0,-62,40.25974025974026,68.47826086956522,68.47826086956522,0.0,83.63866077068856,83.63866077068856,0.0,Previsions
2158,0,2019-01-03,122050,VELOUTE FRUIX ROUGES 125X8 OD,1,0,0,VELOUTE,0,Villecomtal(FR),0080,0024 FR METZ (DC),1861,1583,1324,1324,0,259,259,0,-278,14.93820526598603,214,138,138,138,0,0,0,0,-76,35.51401869158879,100.0,100.0,0.0,83.63866077068856,83.63866077068856,0.0,Previsions
2159,0,2019-01-03,122050,VELOUTE FRUIX ROUGES 125X8 OD,1,0,0,VELOUTE,0,Villecomtal(FR),0081,0024 FR TOURS (DC),1861,1583,1324,1324,0,259,259,0,-278,14.93820526598603,299,212,212,212,0,0,0,0,-87,29.096989966555185,100.0,100.0,0.0,83.63866077068856,83.63866077068856,0.0,Previsions
2160,0,2019-01-03,122050,VELOUTE FRUIX ROUGES 125X8 OD,1,0,0,VELOUTE,0,Villecomtal(FR),0082,0024 FR VALLET (DC),1861,1583,1324,1324,0,259,259,0,-278,14.93820526598603,135,87,87,87,0,0,0,0,-48,35.55555555555556,100.0,100.0,0.0,83.63866077068856,83.63866077068856,0.0,Previsions
2161,0,2019-01-03,122050,VELOUTE FRUIX ROUGES 125X8 OD,1,0,0,VELOUTE,0,Villecomtal(FR),0077,0024 FR LILPARK (DC),1861,1583,1324,1324,0,259,259,0,-278,14.93820526598603,318,201,201,201,0,0,0,0,-117,36.79245283018868,100.0,100.0,0.0,83.63866077068856,83.63866077068856,0.0,Previsions
2162,0,2019-01-03,122050,VELOUTE FRUIX ROUGES 125X8 OD,1,0,0,VELOUTE,0,Villecomtal(FR),0085,0024 FR TOULOUSE (DC),1861,1583,1324,1324,0,259,259,0,-278,14.93820526598603,16,101,101,101,0,0,0,0,85,-531.25,100.0,100.0,0.0,83.63866077068856,83.63866077068856,0.0,Previsions
2163,0,2019-01-03,122050,VELOUTE FRUIX ROUGES 125X8 OD,1,0,0,VELOUTE,0,Villecomtal(FR),0083,0024 FR CHAPONNAY (DC),1861,1583,1324,1324,0,259,259,0,-278,14.93820526598603,476,302,72,72,0,230,230,0,-174,36.554621848739494,23.841059602649008,23.841059602649008,0.0,83.63866077068856,83.63866077068856,0.0,Previsions
2164,0,2019-01-03,122050,VELOUTE FRUIX ROUGES 125X8 OD,1,0,0,VELOUTE,0,Villecomtal(FR),0079,0024 FR PARIS SUD (DC),1861,1583,1324,1324,0,259,259,0,-278,14.93820526598603,56,334,334,334,0,0,0,0,278,-496.42857142857144,100.0,100.0,0.0,83.63866077068856,83.63866077068856,0.0,Previsions
2165,0,2019-01-03,122050,VELOUTE FRUIX ROUGES 125X8 OD,1,0,0,VELOUTE,0,Villecomtal(FR),0078,0024 FR PARIS NORD (DC),1861,1583,1324,1324,0,259,259,0,-278,14.93820526598603,193,116,116,116,0,0,0,0,-77,39.89637305699482,100.0,100.0,0.0,83.63866077068856,83.63866077068856,0.0,Previsions
2166,0,2019-01-03,122709,DANONINO GO POUCH STR 4x4x70G FR,0,0,0,DANONINO,1,Bierun(PL),0084,0024 FR AIX (DC),1131,999,631,588,43,411,368,0,-132,11.671087533156498,162,129,4,1,3,128,125,0,-33,20.37037037037037,3.10077519379845,0.7751937984496124,2.3255813953488373,63.16316316316316,58.85885885885885,4.30430430430431,A Creuser
2167,0,2019-01-03,122709,DANONINO GO POUCH STR 4x4x70G FR,0,0,0,DANONINO,1,Bierun(PL),0080,0024 FR METZ (DC),1131,999,631,588,43,411,368,0,-132,11.671087533156498,85,79,79,79,0,0,0,0,-6,7.0588235294117645,100.0,100.0,0.0,63.16316316316316,58.85885885885885,4.30430430430431,A Creuser
2168,0,2019-01-03,122709,DANONINO GO POUCH STR 4x4x70G FR,0,0,0,DANONINO,1,Bierun(PL),0081,0024 FR TOURS (DC),1131,999,631,588,43,411,368,0,-132,11.671087533156498,118,128,128,128,0,0,0,0,10,-8.474576271186441,100.0,100.0,0.0,63.16316316316316,58.85885885885885,4.30430430430431,A Creuser
2169,0,2019-01-03,122709,DANONINO GO POUCH STR 4x4x70G FR,0,0,0,DANONINO,1,Bierun(PL),0082,0024 FR VALLET (DC),1131,999,631,588,43,411,368,0,-132,11.671087533156498,87,53,27,27,0,26,26,0,-34,39.08045977011494,50.943396226415096,50.943396226415096,0.0,63.16316316316316,58.85885885885885,4.30430430430431,A Creuser
2170,0,2019-01-03,122709,DANONINO GO POUCH STR 4x4x70G FR,0,0,0,DANONINO,1,Bierun(PL),0077,0024 FR LILPARK (DC),1131,999,631,588,43,411,368,0,-132,11.671087533156498,132,126,115,114,1,12,11,0,-6,4.545454545454546,91.26984126984127,90.47619047619048,0.7936507936507837,63.16316316316316,58.85885885885885,4.30430430430431,A Creuser
2171,0,2019-01-03,122709,DANONINO GO POUCH STR 4x4x70G FR,0,0,0,DANONINO,1,Bierun(PL),0083,0024 FR CHAPONNAY (DC),1131,999,631,588,43,411,368,0,-132,11.671087533156498,166,128,128,128,0,0,0,0,-38,22.89156626506024,100.0,100.0,0.0,63.16316316316316,58.85885885885885,4.30430430430431,A Creuser
2172,0,2019-01-03,122709,DANONINO GO POUCH STR 4x4x70G FR,0,0,0,DANONINO,1,Bierun(PL),0079,0024 FR PARIS SUD (DC),1131,999,631,588,43,411,368,0,-132,11.671087533156498,210,194,39,0,39,194,155,0,-16,7.619047619047619,20.103092783505154,0.0,20.103092783505154,63.16316316316316,58.85885885885885,4.30430430430431,A Creuser
2173,0,2019-01-03,122709,DANONINO GO POUCH STR 4x4x70G FR,0,0,0,DANONINO,1,Bierun(PL),0078,0024 FR PARIS NORD (DC),1131,999,631,588,43,411,368,0,-132,11.671087533156498,171,162,111,111,0,51,51,0,-9,5.2631578947368425,68.51851851851852,68.51851851851852,0.0,63.16316316316316,58.85885885885885,4.30430430430431,A Creuser
2174,0,2019-01-03,127908,GERVAIS GRIEGO 115X2 BLUEBERRY FR,0,0,0,GERVAIS,1,Rosenheim(ALL),0084,0024 FR AIX (DC),1961,692,692,692,0,0,0,0,-1269,64.71188169301377,291,62,62,62,0,0,0,0,-229,78.69415807560138,100.0,100.0,0.0,100.0,100.0,0.0,A Creuser
2175,0,2019-01-03,127908,GERVAIS GRIEGO 115X2 BLUEBERRY FR,0,0,0,GERVAIS,1,Rosenheim(ALL),0080,0024 FR METZ (DC),1961,692,692,692,0,0,0,0,-1269,64.71188169301377,220,62,62,62,0,0,0,0,-158,71.81818181818181,100.0,100.0,0.0,100.0,100.0,0.0,A Creuser
2176,0,2019-01-03,127908,GERVAIS GRIEGO 115X2 BLUEBERRY FR,0,0,0,GERVAIS,1,Rosenheim(ALL),0081,0024 FR TOURS (DC),1961,692,692,692,0,0,0,0,-1269,64.71188169301377,717,84,84,84,0,0,0,0,-633,88.28451882845188,100.0,100.0,0.0,100.0,100.0,0.0,A Creuser
2177,0,2019-01-03,127908,GERVAIS GRIEGO 115X2 BLUEBERRY FR,0,0,0,GERVAIS,1,Rosenheim(ALL),0082,0024 FR VALLET (DC),1961,692,692,692,0,0,0,0,-1269,64.71188169301377,260,79,79,79,0,0,0,0,-181,69.61538461538461,100.0,100.0,0.0,100.0,100.0,0.0,A Creuser
2178,0,2019-01-03,127908,GERVAIS GRIEGO 115X2 BLUEBERRY FR,0,0,0,GERVAIS,1,Rosenheim(ALL),0077,0024 FR LILPARK (DC),1961,692,692,692,0,0,0,0,-1269,64.71188169301377,144,115,115,115,0,0,0,0,-29,20.13888888888889,100.0,100.0,0.0,100.0,100.0,0.0,A Creuser
2179,0,2019-01-03,127908,GERVAIS GRIEGO 115X2 BLUEBERRY FR,0,0,0,GERVAIS,1,Rosenheim(ALL),0079,0024 FR PARIS SUD (DC),1961,692,692,692,0,0,0,0,-1269,64.71188169301377,128,184,184,184,0,0,0,0,56,-43.75,100.0,100.0,0.0,100.0,100.0,0.0,A Creuser
2180,0,2019-01-03,127908,GERVAIS GRIEGO 115X2 BLUEBERRY FR,0,0,0,GERVAIS,1,Rosenheim(ALL),0078,0024 FR PARIS NORD (DC),1961,692,692,692,0,0,0,0,-1269,64.71188169301377,201,106,106,106,0,0,0,0,-95,47.2636815920398,100.0,100.0,0.0,100.0,100.0,0.0,A Creuser
2181,0,2019-01-03,127909,GERVAIS GRIEGO 115X2 RASPBERRY FR,0,0,0,GERVAIS,1,Rosenheim(ALL),0084,0024 FR AIX (DC),593,679,509,497,12,182,170,0,86,-14.502529510961214,46,44,44,44,0,0,0,0,-2,4.3478260869565215,100.0,100.0,0.0,74.96318114874816,73.19587628865979,1.7673048600883732,A Creuser
2182,0,2019-01-03,127909,GERVAIS GRIEGO 115X2 RASPBERRY FR,0,0,0,GERVAIS,1,Rosenheim(ALL),0080,0024 FR METZ (DC),593,679,509,497,12,182,170,0,86,-14.502529510961214,79,60,60,60,0,0,0,0,-19,24.050632911392405,100.0,100.0,0.0,74.96318114874816,73.19587628865979,1.7673048600883732,A Creuser
2183,0,2019-01-03,127909,GERVAIS GRIEGO 115X2 RASPBERRY FR,0,0,0,GERVAIS,1,Rosenheim(ALL),0081,0024 FR TOURS (DC),593,679,509,497,12,182,170,0,86,-14.502529510961214,10,75,75,75,0,0,0,0,65,-650.0,100.0,100.0,0.0,74.96318114874816,73.19587628865979,1.7673048600883732,A Creuser
2184,0,2019-01-03,127909,GERVAIS GRIEGO 115X2 RASPBERRY FR,0,0,0,GERVAIS,1,Rosenheim(ALL),0082,0024 FR VALLET (DC),593,679,509,497,12,182,170,0,86,-14.502529510961214,44,54,54,54,0,0,0,0,10,-22.727272727272727,100.0,100.0,0.0,74.96318114874816,73.19587628865979,1.7673048600883732,A Creuser
2185,0,2019-01-03,127909,GERVAIS GRIEGO 115X2 RASPBERRY FR,0,0,0,GERVAIS,1,Rosenheim(ALL),0077,0024 FR LILPARK (DC),593,679,509,497,12,182,170,0,86,-14.502529510961214,131,159,159,159,0,0,0,0,28,-21.374045801526716,100.0,100.0,0.0,74.96318114874816,73.19587628865979,1.7673048600883732,A Creuser
2186,0,2019-01-03,127909,GERVAIS GRIEGO 115X2 RASPBERRY FR,0,0,0,GERVAIS,1,Rosenheim(ALL),0083,0024 FR CHAPONNAY (DC),593,679,509,497,12,182,170,0,86,-14.502529510961214,179,198,59,58,1,140,139,0,19,-10.614525139664805,29.797979797979796,29.292929292929294,0.5050505050505016,74.96318114874816,73.19587628865979,1.7673048600883732,A Creuser
2187,0,2019-01-03,127909,GERVAIS GRIEGO 115X2 RASPBERRY FR,0,0,0,GERVAIS,1,Rosenheim(ALL),0078,0024 FR PARIS NORD (DC),593,679,509,497,12,182,170,0,86,-14.502529510961214,104,89,58,47,11,42,31,0,-15,14.423076923076923,65.1685393258427,52.80898876404494,12.35955056179776,74.96318114874816,73.19587628865979,1.7673048600883732,A Creuser
2188,0,2019-01-03,127911,GERVAIS GRIEGO 115X4 VANILLA FR,0,0,0,GERVAIS,1,Rosenheim(ALL),0084,0024 FR AIX (DC),1834,1782,1543,1541,2,241,239,0,-52,2.8353326063249726,219,191,191,191,0,0,0,0,-28,12.785388127853881,100.0,100.0,0.0,86.58810325476992,86.47586980920315,0.11223344556677262,A Creuser
2189,0,2019-01-03,127911,GERVAIS GRIEGO 115X4 VANILLA FR,0,0,0,GERVAIS,1,Rosenheim(ALL),0080,0024 FR METZ (DC),1834,1782,1543,1541,2,241,239,0,-52,2.8353326063249726,117,109,109,109,0,0,0,0,-8,6.837606837606837,100.0,100.0,0.0,86.58810325476992,86.47586980920315,0.11223344556677262,A Creuser
2190,0,2019-01-03,127911,GERVAIS GRIEGO 115X4 VANILLA FR,0,0,0,GERVAIS,1,Rosenheim(ALL),0081,0024 FR TOURS (DC),1834,1782,1543,1541,2,241,239,0,-52,2.8353326063249726,286,257,257,257,0,0,0,0,-29,10.13986013986014,100.0,100.0,0.0,86.58810325476992,86.47586980920315,0.11223344556677262,A Creuser
2191,0,2019-01-03,127911,GERVAIS GRIEGO 115X4 VANILLA FR,0,0,0,GERVAIS,1,Rosenheim(ALL),0082,0024 FR VALLET (DC),1834,1782,1543,1541,2,241,239,0,-52,2.8353326063249726,212,177,177,177,0,0,0,0,-35,16.50943396226415,100.0,100.0,0.0,86.58810325476992,86.47586980920315,0.11223344556677262,A Creuser
2192,0,2019-01-03,127911,GERVAIS GRIEGO 115X4 VANILLA FR,0,0,0,GERVAIS,1,Rosenheim(ALL),0077,0024 FR LILPARK (DC),1834,1782,1543,1541,2,241,239,0,-52,2.8353326063249726,19,175,175,175,0,0,0,0,156,-821.0526315789474,100.0,100.0,0.0,86.58810325476992,86.47586980920315,0.11223344556677262,A Creuser
2193,0,2019-01-03,127911,GERVAIS GRIEGO 115X4 VANILLA FR,0,0,0,GERVAIS,1,Rosenheim(ALL),0085,0024 FR TOULOUSE (DC),1834,1782,1543,1541,2,241,239,0,-52,2.8353326063249726,438,271,32,30,2,241,239,0,-167,38.12785388127854,11.808118081180812,11.07011070110701,0.7380073800738014,86.58810325476992,86.47586980920315,0.11223344556677262,A Creuser
2194,0,2019-01-03,127911,GERVAIS GRIEGO 115X4 VANILLA FR,0,0,0,GERVAIS,1,Rosenheim(ALL),0083,0024 FR CHAPONNAY (DC),1834,1782,1543,1541,2,241,239,0,-52,2.8353326063249726,271,372,372,372,0,0,0,0,101,-37.269372693726936,100.0,100.0,0.0,86.58810325476992,86.47586980920315,0.11223344556677262,A Creuser
2195,0,2019-01-03,127911,GERVAIS GRIEGO 115X4 VANILLA FR,0,0,0,GERVAIS,1,Rosenheim(ALL),0078,0024 FR PARIS NORD (DC),1834,1782,1543,1541,2,241,239,0,-52,2.8353326063249726,272,230,230,230,0,0,0,0,-42,15.441176470588236,100.0,100.0,0.0,86.58810325476992,86.47586980920315,0.11223344556677262,A Creuser
2196,1,2019-01-03,133134,LIGHT & FREE FRAMB GREN 120X4 OD,1,0,0,LIGHT & FREE,0,Ferrières(FR),0083,0024 FR CHAPONNAY (DC),46,673,624,594,30,79,49,0,627,-1363.0434782608695,46,68,68,38,30,30,0,0,22,-47.82608695652174,100.0,55.88235294117647,44.11764705882353,92.71916790490341,88.26151560178306,4.457652303120355,Probleme Copacking
2197,0,2019-01-03,140278,Activia almond/muesli/chia 170g FR-copac,0,0,0,ACTIVIA,1,Roumanie(RO),0084,0024 FR AIX (DC),564,433,212,114,98,319,221,0,-131,23.22695035460993,95,72,3,2,1,70,69,0,-23,24.210526315789473,4.166666666666666,2.7777777777777777,1.3888888888888884,48.96073903002309,26.32794457274827,22.632794457274823,A Creuser
2198,0,2019-01-03,140278,Activia almond/muesli/chia 170g FR-copac,0,0,0,ACTIVIA,1,Roumanie(RO),0080,0024 FR METZ (DC),564,433,212,114,98,319,221,0,-131,23.22695035460993,8,56,5,4,1,52,51,0,48,-600.0,8.928571428571429,7.142857142857142,1.7857142857142865,48.96073903002309,26.32794457274827,22.632794457274823,A Creuser
2199,0,2019-01-03,140278,Activia almond/muesli/chia 170g FR-copac,0,0,0,ACTIVIA,1,Roumanie(RO),0081,0024 FR TOURS (DC),564,433,212,114,98,319,221,0,-131,23.22695035460993,158,87,1,0,1,87,86,0,-71,44.936708860759495,1.1494252873563218,0.0,1.1494252873563218,48.96073903002309,26.32794457274827,22.632794457274823,A Creuser
2200,0,2019-01-03,140278,Activia almond/muesli/chia 170g FR-copac,0,0,0,ACTIVIA,1,Roumanie(RO),0082,0024 FR VALLET (DC),564,433,212,114,98,319,221,0,-131,23.22695035460993,86,60,60,0,60,60,0,0,-26,30.232558139534884,100.0,0.0,100.0,48.96073903002309,26.32794457274827,22.632794457274823,A Creuser
2201,0,2019-01-03,140278,Activia almond/muesli/chia 170g FR-copac,0,0,0,ACTIVIA,1,Roumanie(RO),0077,0024 FR LILPARK (DC),564,433,212,114,98,319,221,0,-131,23.22695035460993,66,51,51,36,15,15,0,0,-15,22.727272727272727,100.0,70.58823529411765,29.411764705882348,48.96073903002309,26.32794457274827,22.632794457274823,A Creuser
2202,0,2019-01-03,140278,Activia almond/muesli/chia 170g FR-copac,0,0,0,ACTIVIA,1,Roumanie(RO),0085,0024 FR TOULOUSE (DC),564,433,212,114,98,319,221,0,-131,23.22695035460993,87,50,35,26,9,24,15,0,-37,42.52873563218391,70.0,52.0,18.0,48.96073903002309,26.32794457274827,22.632794457274823,A Creuser
2203,0,2019-01-03,140278,Activia almond/muesli/chia 170g FR-copac,0,0,0,ACTIVIA,1,Roumanie(RO),0079,0024 FR PARIS SUD (DC),564,433,212,114,98,319,221,0,-131,23.22695035460993,64,57,57,46,11,11,0,0,-7,10.9375,100.0,80.7017543859649,19.298245614035096,48.96073903002309,26.32794457274827,22.632794457274823,A Creuser
2204,0,2019-01-03,140280,Activia chia/raspb/muesli 170g FR-copack,0,0,0,ACTIVIA,1,Roumanie(RO),0084,0024 FR AIX (DC),1000,905,487,176,311,729,418,0,-95,9.5,75,67,67,18,49,49,0,0,-8,10.666666666666666,100.0,26.865671641791046,73.13432835820896,53.812154696132595,19.447513812154696,34.3646408839779,A Creuser
2205,0,2019-01-03,140280,Activia chia/raspb/muesli 170g FR-copack,0,0,0,ACTIVIA,1,Roumanie(RO),0080,0024 FR METZ (DC),1000,905,487,176,311,729,418,0,-95,9.5,48,60,60,53,7,7,0,0,12,-25.0,100.0,88.33333333333333,11.666666666666671,53.812154696132595,19.447513812154696,34.3646408839779,A Creuser
2206,0,2019-01-03,140280,Activia chia/raspb/muesli 170g FR-copack,0,0,0,ACTIVIA,1,Roumanie(RO),0081,0024 FR TOURS (DC),1000,905,487,176,311,729,418,0,-95,9.5,229,147,13,0,13,147,134,0,-82,35.80786026200873,8.843537414965986,0.0,8.843537414965986,53.812154696132595,19.447513812154696,34.3646408839779,A Creuser
2207,0,2019-01-03,140280,Activia chia/raspb/muesli 170g FR-copack,0,0,0,ACTIVIA,1,Roumanie(RO),0082,0024 FR VALLET (DC),1000,905,487,176,311,729,418,0,-95,9.5,85,85,85,0,85,85,0,0,0,0.0,100.0,0.0,100.0,53.812154696132595,19.447513812154696,34.3646408839779,A Creuser
2208,0,2019-01-03,140280,Activia chia/raspb/muesli 170g FR-copack,0,0,0,ACTIVIA,1,Roumanie(RO),0077,0024 FR LILPARK (DC),1000,905,487,176,311,729,418,0,-95,9.5,56,72,72,46,26,26,0,0,16,-28.571428571428573,100.0,63.888888888888886,36.111111111111114,53.812154696132595,19.447513812154696,34.3646408839779,A Creuser
2209,0,2019-01-03,140280,Activia chia/raspb/muesli 170g FR-copack,0,0,0,ACTIVIA,1,Roumanie(RO),0085,0024 FR TOULOUSE (DC),1000,905,487,176,311,729,418,0,-95,9.5,1,61,11,7,4,54,50,0,60,-6000.0,18.0327868852459,11.475409836065573,6.557377049180328,53.812154696132595,19.447513812154696,34.3646408839779,A Creuser
2210,0,2019-01-03,140280,Activia chia/raspb/muesli 170g FR-copack,0,0,0,ACTIVIA,1,Roumanie(RO),0079,0024 FR PARIS SUD (DC),1000,905,487,176,311,729,418,0,-95,9.5,97,78,73,52,21,26,5,0,-19,19.587628865979383,93.58974358974359,66.66666666666666,26.923076923076934,53.812154696132595,19.447513812154696,34.3646408839779,A Creuser
2211,0,2019-01-03,140280,Activia chia/raspb/muesli 170g FR-copack,0,0,0,ACTIVIA,1,Roumanie(RO),0078,0024 FR PARIS NORD (DC),1000,905,487,176,311,729,418,0,-95,9.5,409,335,106,0,106,335,229,0,-74,18.09290953545232,31.64179104477612,0.0,31.64179104477612,53.812154696132595,19.447513812154696,34.3646408839779,A Creuser
2212,1,2019-01-04,433,DANET MOUS CHOC LIEG 80gx4,1,0,0,DANETTE,1,Ochsenfurt(ALL),0082,0024 FR VALLET (DC),60,1169,1169,1082,87,87,0,0,1109,-1848.3333333333333,60,86,86,0,86,86,0,0,26,-43.333333333333336,100.0,0.0,100.0,100.0,92.55774165953807,7.442258340461933,Transport
2213,0,2019-01-04,122061,VELOUTE FRUIX JAUNES 125X8 OD,1,0,0,VELOUTE,0,Villecomtal(FR),0084,0024 FR AIX (DC),3081,2449,2227,2187,40,262,222,0,-632,20.512820512820515,277,165,165,165,0,0,0,0,-112,40.43321299638989,100.0,100.0,0.0,90.93507554103716,89.30175581870151,1.6333197223356564,Previsions
2214,0,2019-01-04,122061,VELOUTE FRUIX JAUNES 125X8 OD,1,0,0,VELOUTE,0,Villecomtal(FR),0080,0024 FR METZ (DC),3081,2449,2227,2187,40,262,222,0,-632,20.512820512820515,228,145,145,145,0,0,0,0,-83,36.40350877192982,100.0,100.0,0.0,90.93507554103716,89.30175581870151,1.6333197223356564,Previsions
2215,0,2019-01-04,122061,VELOUTE FRUIX JAUNES 125X8 OD,1,0,0,VELOUTE,0,Villecomtal(FR),0081,0024 FR TOURS (DC),3081,2449,2227,2187,40,262,222,0,-632,20.512820512820515,419,289,289,289,0,0,0,0,-130,31.026252983293556,100.0,100.0,0.0,90.93507554103716,89.30175581870151,1.6333197223356564,Previsions
2216,0,2019-01-04,122061,VELOUTE FRUIX JAUNES 125X8 OD,1,0,0,VELOUTE,0,Villecomtal(FR),0082,0024 FR VALLET (DC),3081,2449,2227,2187,40,262,222,0,-632,20.512820512820515,148,101,101,101,0,0,0,0,-47,31.756756756756758,100.0,100.0,0.0,90.93507554103716,89.30175581870151,1.6333197223356564,Previsions
2217,0,2019-01-04,122061,VELOUTE FRUIX JAUNES 125X8 OD,1,0,0,VELOUTE,0,Villecomtal(FR),0077,0024 FR LILPARK (DC),3081,2449,2227,2187,40,262,222,0,-632,20.512820512820515,774,490,490,490,0,0,0,0,-284,36.69250645994832,100.0,100.0,0.0,90.93507554103716,89.30175581870151,1.6333197223356564,Previsions
2218,0,2019-01-04,122061,VELOUTE FRUIX JAUNES 125X8 OD,1,0,0,VELOUTE,0,Villecomtal(FR),0085,0024 FR TOULOUSE (DC),3081,2449,2227,2187,40,262,222,0,-632,20.512820512820515,44,274,274,274,0,0,0,0,230,-522.7272727272727,100.0,100.0,0.0,90.93507554103716,89.30175581870151,1.6333197223356564,Previsions
2219,0,2019-01-04,122061,VELOUTE FRUIX JAUNES 125X8 OD,1,0,0,VELOUTE,0,Villecomtal(FR),0083,0024 FR CHAPONNAY (DC),3081,2449,2227,2187,40,262,222,0,-632,20.512820512820515,550,344,215,175,40,169,129,0,-206,37.45454545454545,62.5,50.872093023255815,11.627906976744185,90.93507554103716,89.30175581870151,1.6333197223356564,Previsions
2220,0,2019-01-04,122061,VELOUTE FRUIX JAUNES 125X8 OD,1,0,0,VELOUTE,0,Villecomtal(FR),0079,0024 FR PARIS SUD (DC),3081,2449,2227,2187,40,262,222,0,-632,20.512820512820515,595,360,267,267,0,93,93,0,-235,39.49579831932773,74.16666666666667,74.16666666666667,0.0,90.93507554103716,89.30175581870151,1.6333197223356564,Previsions
2221,0,2019-01-04,122061,VELOUTE FRUIX JAUNES 125X8 OD,1,0,0,VELOUTE,0,Villecomtal(FR),0078,0024 FR PARIS NORD (DC),3081,2449,2227,2187,40,262,222,0,-632,20.512820512820515,46,281,281,281,0,0,0,0,235,-510.8695652173913,100.0,100.0,0.0,90.93507554103716,89.30175581870151,1.6333197223356564,Previsions
2222,0,2019-01-04,122329,POT VERRE CITRUS x2 FR - AFH,0,0,1,DANONE,1,Aldaya(ES),0084,0024 FR AIX (DC),124,264,84,5,79,259,180,0,140,-112.90322580645162,28,66,59,2,57,64,7,0,38,-135.71428571428572,89.39393939393939,3.0303030303030303,86.36363636363636,31.818181818181817,1.893939393939394,29.924242424242422,Previsions
2223,0,2019-01-04,122329,POT VERRE CITRUS x2 FR - AFH,0,0,1,DANONE,1,Aldaya(ES),0080,0024 FR METZ (DC),124,264,84,5,79,259,180,0,140,-112.90322580645162,5,12,2,0,2,12,10,0,7,-140.0,16.666666666666664,0.0,16.666666666666664,31.818181818181817,1.893939393939394,29.924242424242422,Previsions
2224,0,2019-01-04,122329,POT VERRE CITRUS x2 FR - AFH,0,0,1,DANONE,1,Aldaya(ES),0081,0024 FR TOURS (DC),124,264,84,5,79,259,180,0,140,-112.90322580645162,12,2,2,0,2,2,0,0,-10,83.33333333333333,100.0,0.0,100.0,31.818181818181817,1.893939393939394,29.924242424242422,Previsions
2225,0,2019-01-04,122329,POT VERRE CITRUS x2 FR - AFH,0,0,1,DANONE,1,Aldaya(ES),0085,0024 FR TOULOUSE (DC),124,264,84,5,79,259,180,0,140,-112.90322580645162,6,3,3,3,0,0,0,0,-3,50.0,100.0,100.0,0.0,31.818181818181817,1.893939393939394,29.924242424242422,Previsions
2226,0,2019-01-04,122329,POT VERRE CITRUS x2 FR - AFH,0,0,1,DANONE,1,Aldaya(ES),0083,0024 FR CHAPONNAY (DC),124,264,84,5,79,259,180,0,140,-112.90322580645162,29,16,16,0,16,16,0,0,-13,44.827586206896555,100.0,0.0,100.0,31.818181818181817,1.893939393939394,29.924242424242422,Previsions
2227,0,2019-01-04,122329,POT VERRE CITRUS x2 FR - AFH,0,0,1,DANONE,1,Aldaya(ES),0079,0024 FR PARIS SUD (DC),124,264,84,5,79,259,180,0,140,-112.90322580645162,44,165,2,0,2,165,163,0,121,-275.0,1.2121212121212122,0.0,1.2121212121212122,31.818181818181817,1.893939393939394,29.924242424242422,Previsions
2228,0,2019-01-04,122709,DANONINO GO POUCH STR 4x4x70G FR,0,0,0,DANONINO,1,Bierun(PL),0080,0024 FR METZ (DC),820,761,723,337,386,424,38,0,-59,7.195121951219512,83,76,76,76,0,0,0,0,-7,8.433734939759036,100.0,100.0,0.0,95.00657030223391,44.2838370565046,50.72273324572931,Déploiement/Quarantaine
2229,0,2019-01-04,122709,DANONINO GO POUCH STR 4x4x70G FR,0,0,0,DANONINO,1,Bierun(PL),0081,0024 FR TOURS (DC),820,761,723,337,386,424,38,0,-59,7.195121951219512,77,77,52,52,0,25,25,0,0,0.0,67.53246753246754,67.53246753246754,0.0,95.00657030223391,44.2838370565046,50.72273324572931,Déploiement/Quarantaine
2230,0,2019-01-04,122709,DANONINO GO POUCH STR 4x4x70G FR,0,0,0,DANONINO,1,Bierun(PL),0082,0024 FR VALLET (DC),820,761,723,337,386,424,38,0,-59,7.195121951219512,33,32,19,19,0,13,13,0,-1,3.0303030303030303,59.375,59.375,0.0,95.00657030223391,44.2838370565046,50.72273324572931,Déploiement/Quarantaine
2231,0,2019-01-04,122709,DANONINO GO POUCH STR 4x4x70G FR,0,0,0,DANONINO,1,Bierun(PL),0077,0024 FR LILPARK (DC),820,761,723,337,386,424,38,0,-59,7.195121951219512,119,66,66,4,62,62,0,0,-53,44.53781512605042,100.0,6.0606060606060606,93.93939393939394,95.00657030223391,44.2838370565046,50.72273324572931,Déploiement/Quarantaine
2232,0,2019-01-04,122709,DANONINO GO POUCH STR 4x4x70G FR,0,0,0,DANONINO,1,Bierun(PL),0085,0024 FR TOULOUSE (DC),820,761,723,337,386,424,38,0,-59,7.195121951219512,176,211,211,2,209,209,0,0,35,-19.886363636363637,100.0,0.9478672985781991,99.0521327014218,95.00657030223391,44.2838370565046,50.72273324572931,Déploiement/Quarantaine
2233,0,2019-01-04,122709,DANONINO GO POUCH STR 4x4x70G FR,0,0,0,DANONINO,1,Bierun(PL),0083,0024 FR CHAPONNAY (DC),820,761,723,337,386,424,38,0,-59,7.195121951219512,179,154,154,154,0,0,0,0,-25,13.966480446927374,100.0,100.0,0.0,95.00657030223391,44.2838370565046,50.72273324572931,Déploiement/Quarantaine
2234,0,2019-01-04,122709,DANONINO GO POUCH STR 4x4x70G FR,0,0,0,DANONINO,1,Bierun(PL),0078,0024 FR PARIS NORD (DC),820,761,723,337,386,424,38,0,-59,7.195121951219512,153,145,145,30,115,115,0,0,-8,5.228758169934641,100.0,20.689655172413794,79.3103448275862,95.00657030223391,44.2838370565046,50.72273324572931,Déploiement/Quarantaine
2235,0,2019-01-04,135120,ACTIVIA SAV CIT 125X12 PLUS 4,0,0,0,ACTIVIA,0,Bailleul(FR),0084,0024 FR AIX (DC),1101,631,510,502,8,129,121,0,-470,42.688465031789285,135,75,13,12,1,63,62,0,-60,44.44444444444444,17.333333333333336,16.0,1.3333333333333357,80.82408874801902,79.55625990491284,1.2678288431061873,Déploiement/Quarantaine
2236,0,2019-01-04,135120,ACTIVIA SAV CIT 125X12 PLUS 4,0,0,0,ACTIVIA,0,Bailleul(FR),0080,0024 FR METZ (DC),1101,631,510,502,8,129,121,0,-470,42.688465031789285,58,35,32,31,1,4,3,0,-23,39.6551724137931,91.42857142857143,88.57142857142857,2.857142857142861,80.82408874801902,79.55625990491284,1.2678288431061873,Déploiement/Quarantaine
2237,0,2019-01-04,135120,ACTIVIA SAV CIT 125X12 PLUS 4,0,0,0,ACTIVIA,0,Bailleul(FR),0077,0024 FR LILPARK (DC),1101,631,510,502,8,129,121,0,-470,42.688465031789285,481,275,219,216,3,59,56,0,-206,42.82744282744283,79.63636363636364,78.54545454545455,1.0909090909090935,80.82408874801902,79.55625990491284,1.2678288431061873,Déploiement/Quarantaine
2238,0,2019-01-04,135120,ACTIVIA SAV CIT 125X12 PLUS 4,0,0,0,ACTIVIA,0,Bailleul(FR),0085,0024 FR TOULOUSE (DC),1101,631,510,502,8,129,121,0,-470,42.688465031789285,120,68,68,65,3,3,0,0,-52,43.333333333333336,100.0,95.58823529411765,4.411764705882348,80.82408874801902,79.55625990491284,1.2678288431061873,Déploiement/Quarantaine
2239,0,2019-01-04,135120,ACTIVIA SAV CIT 125X12 PLUS 4,0,0,0,ACTIVIA,0,Bailleul(FR),0083,0024 FR CHAPONNAY (DC),1101,631,510,502,8,129,121,0,-470,42.688465031789285,240,139,139,139,0,0,0,0,-101,42.083333333333336,100.0,100.0,0.0,80.82408874801902,79.55625990491284,1.2678288431061873,Déploiement/Quarantaine
2240,0,2019-01-04,135120,ACTIVIA SAV CIT 125X12 PLUS 4,0,0,0,ACTIVIA,0,Bailleul(FR),0078,0024 FR PARIS NORD (DC),1101,631,510,502,8,129,121,0,-470,42.688465031789285,67,39,39,39,0,0,0,0,-28,41.791044776119406,100.0,100.0,0.0,80.82408874801902,79.55625990491284,1.2678288431061873,Déploiement/Quarantaine
2241,0,2019-01-04,140278,Activia almond/muesli/chia 170g FR-copac,0,0,0,ACTIVIA,1,Roumanie(RO),0084,0024 FR AIX (DC),865,741,741,253,488,488,0,0,-124,14.335260115606937,97,61,61,1,60,60,0,0,-36,37.11340206185567,100.0,1.639344262295082,98.36065573770492,100.0,34.14304993252362,65.85695006747639,A Creuser
2242,0,2019-01-04,140278,Activia almond/muesli/chia 170g FR-copac,0,0,0,ACTIVIA,1,Roumanie(RO),0080,0024 FR METZ (DC),865,741,741,253,488,488,0,0,-124,14.335260115606937,87,71,71,15,56,56,0,0,-16,18.39080459770115,100.0,21.12676056338028,78.87323943661971,100.0,34.14304993252362,65.85695006747639,A Creuser
2243,0,2019-01-04,140278,Activia almond/muesli/chia 170g FR-copac,0,0,0,ACTIVIA,1,Roumanie(RO),0081,0024 FR TOURS (DC),865,741,741,253,488,488,0,0,-124,14.335260115606937,11,76,76,0,76,76,0,0,65,-590.9090909090909,100.0,0.0,100.0,100.0,34.14304993252362,65.85695006747639,A Creuser
2244,0,2019-01-04,140278,Activia almond/muesli/chia 170g FR-copac,0,0,0,ACTIVIA,1,Roumanie(RO),0082,0024 FR VALLET (DC),865,741,741,253,488,488,0,0,-124,14.335260115606937,83,105,105,0,105,105,0,0,22,-26.50602409638554,100.0,0.0,100.0,100.0,34.14304993252362,65.85695006747639,A Creuser
2245,0,2019-01-04,140278,Activia almond/muesli/chia 170g FR-copac,0,0,0,ACTIVIA,1,Roumanie(RO),0077,0024 FR LILPARK (DC),865,741,741,253,488,488,0,0,-124,14.335260115606937,61,30,30,30,0,0,0,0,-31,50.81967213114754,100.0,100.0,0.0,100.0,34.14304993252362,65.85695006747639,A Creuser
2246,0,2019-01-04,140278,Activia almond/muesli/chia 170g FR-copac,0,0,0,ACTIVIA,1,Roumanie(RO),0085,0024 FR TOULOUSE (DC),865,741,741,253,488,488,0,0,-124,14.335260115606937,66,43,43,23,20,20,0,0,-23,34.84848484848485,100.0,53.48837209302325,46.51162790697675,100.0,34.14304993252362,65.85695006747639,A Creuser
2247,0,2019-01-04,140278,Activia almond/muesli/chia 170g FR-copac,0,0,0,ACTIVIA,1,Roumanie(RO),0083,0024 FR CHAPONNAY (DC),865,741,741,253,488,488,0,0,-124,14.335260115606937,146,99,99,82,17,17,0,0,-47,32.19178082191781,100.0,82.82828282828282,17.171717171717177,100.0,34.14304993252362,65.85695006747639,A Creuser
2248,0,2019-01-04,140278,Activia almond/muesli/chia 170g FR-copac,0,0,0,ACTIVIA,1,Roumanie(RO),0079,0024 FR PARIS SUD (DC),865,741,741,253,488,488,0,0,-124,14.335260115606937,111,59,59,59,0,0,0,0,-52,46.846846846846844,100.0,100.0,0.0,100.0,34.14304993252362,65.85695006747639,A Creuser
2249,0,2019-01-04,140278,Activia almond/muesli/chia 170g FR-copac,0,0,0,ACTIVIA,1,Roumanie(RO),0078,0024 FR PARIS NORD (DC),865,741,741,253,488,488,0,0,-124,14.335260115606937,203,197,197,43,154,154,0,0,-6,2.955665024630542,100.0,21.82741116751269,78.1725888324873,100.0,34.14304993252362,65.85695006747639,A Creuser
2250,0,2019-01-04,140280,Activia chia/raspb/muesli 170g FR-copack,0,0,0,ACTIVIA,1,Roumanie(RO),0084,0024 FR AIX (DC),935,1094,988,427,561,667,106,0,159,-17.005347593582886,90,100,54,22,32,78,46,0,10,-11.11111111111111,54.0,22.0,32.0,90.31078610603291,39.031078610603295,51.27970749542961,A Creuser
2251,0,2019-01-04,140280,Activia chia/raspb/muesli 170g FR-copack,0,0,0,ACTIVIA,1,Roumanie(RO),0080,0024 FR METZ (DC),935,1094,988,427,561,667,106,0,159,-17.005347593582886,61,85,85,19,66,66,0,0,24,-39.34426229508197,100.0,22.35294117647059,77.6470588235294,90.31078610603291,39.031078610603295,51.27970749542961,A Creuser
2252,0,2019-01-04,140280,Activia chia/raspb/muesli 170g FR-copack,0,0,0,ACTIVIA,1,Roumanie(RO),0081,0024 FR TOURS (DC),935,1094,988,427,561,667,106,0,159,-17.005347593582886,145,146,146,35,111,111,0,0,1,-0.6896551724137931,100.0,23.972602739726025,76.02739726027397,90.31078610603291,39.031078610603295,51.27970749542961,A Creuser
2253,0,2019-01-04,140280,Activia chia/raspb/muesli 170g FR-copack,0,0,0,ACTIVIA,1,Roumanie(RO),0082,0024 FR VALLET (DC),935,1094,988,427,561,667,106,0,159,-17.005347593582886,75,117,117,0,117,117,0,0,42,-56.0,100.0,0.0,100.0,90.31078610603291,39.031078610603295,51.27970749542961,A Creuser
2254,0,2019-01-04,140280,Activia chia/raspb/muesli 170g FR-copack,0,0,0,ACTIVIA,1,Roumanie(RO),0077,0024 FR LILPARK (DC),935,1094,988,427,561,667,106,0,159,-17.005347593582886,6,41,41,34,7,7,0,0,35,-583.3333333333334,100.0,82.92682926829268,17.07317073170732,90.31078610603291,39.031078610603295,51.27970749542961,A Creuser
2255,0,2019-01-04,140280,Activia chia/raspb/muesli 170g FR-copack,0,0,0,ACTIVIA,1,Roumanie(RO),0085,0024 FR TOULOUSE (DC),935,1094,988,427,561,667,106,0,159,-17.005347593582886,9,67,67,32,35,35,0,0,58,-644.4444444444445,100.0,47.76119402985074,52.23880597014926,90.31078610603291,39.031078610603295,51.27970749542961,A Creuser
2256,0,2019-01-04,140280,Activia chia/raspb/muesli 170g FR-copack,0,0,0,ACTIVIA,1,Roumanie(RO),0083,0024 FR CHAPONNAY (DC),935,1094,988,427,561,667,106,0,159,-17.005347593582886,189,172,172,153,19,19,0,0,-17,8.994708994708995,100.0,88.95348837209302,11.04651162790698,90.31078610603291,39.031078610603295,51.27970749542961,A Creuser
2257,0,2019-01-04,140280,Activia chia/raspb/muesli 170g FR-copack,0,0,0,ACTIVIA,1,Roumanie(RO),0079,0024 FR PARIS SUD (DC),935,1094,988,427,561,667,106,0,159,-17.005347593582886,99,65,26,25,1,40,39,0,-34,34.343434343434346,40.0,38.46153846153847,1.538461538461533,90.31078610603291,39.031078610603295,51.27970749542961,A Creuser
2258,0,2019-01-04,140280,Activia chia/raspb/muesli 170g FR-copack,0,0,0,ACTIVIA,1,Roumanie(RO),0078,0024 FR PARIS NORD (DC),935,1094,988,427,561,667,106,0,159,-17.005347593582886,261,301,280,107,173,194,21,0,40,-15.32567049808429,93.02325581395348,35.548172757475086,57.4750830564784,90.31078610603291,39.031078610603295,51.27970749542961,A Creuser
2259,1,2019-01-05,121313,ACTIMEL MULTI 4x(10x100g) FR,0,0,0,ACTIMEL,1,Rotselaar(BE),0077,0024 FR LILPARK (DC),714,2129,2129,2114,15,15,0,0,1415,-198.17927170868347,714,423,423,408,15,15,0,0,-291,40.7563025210084,100.0,96.45390070921985,3.5460992907801483,100.0,99.29544387036168,0.7045561296383198,Transport
2260,1,2019-01-05,121448,ACTIMEL RASP-BLUE 3x(8x100g) FR,0,0,0,ACTIMEL,1,Rotselaar(BE),0084,0024 FR AIX (DC),88,537,377,347,30,190,160,0,449,-510.22727272727275,88,89,16,0,16,89,73,0,1,-1.1363636363636365,17.97752808988764,0.0,17.97752808988764,70.2048417132216,64.61824953445065,5.5865921787709425,Transport
2261,1,2019-01-05,131288,ACTIMEL STRA-NATU 3x(8x100g) FR,1,0,0,ACTIMEL,1,Rotselaar(BE),0084,0024 FR AIX (DC),1037,3124,3124,2979,145,145,0,0,2087,-201.2536162005786,1037,557,557,412,145,145,0,0,-480,46.287367405978785,100.0,73.96768402154399,26.032315978456012,100.0,95.35851472471191,4.64148527528809,Transport
2262,1,2019-01-05,131289,ACTIMEL MULTI 3x(8x100g) FR,1,0,0,ACTIMEL,1,Rotselaar(BE),0084,0024 FR AIX (DC),2375,2177,2177,1938,239,239,0,0,-198,8.336842105263157,694,373,373,166,207,207,0,0,-321,46.2536023054755,100.0,44.50402144772118,55.49597855227882,100.0,89.02158934313276,10.97841065686724,Transport
2263,1,2019-01-05,131289,ACTIMEL MULTI 3x(8x100g) FR,1,0,0,ACTIMEL,1,Rotselaar(BE),0078,0024 FR PARIS NORD (DC),2375,2177,2177,1938,239,239,0,0,-198,8.336842105263157,1681,905,905,873,32,32,0,0,-776,46.162998215348004,100.0,96.46408839779006,3.5359116022099357,100.0,89.02158934313276,10.97841065686724,Transport
2264,0,2019-01-05,131290,ACTIMEL RASP-BLUE 3x(8x100g) FR OD,1,0,0,ACTIMEL,1,Rotselaar(BE),0084,0024 FR AIX (DC),4198,1938,1796,1629,167,309,142,0,-2260,53.83515959980943,739,397,255,91,164,306,142,0,-342,46.2787550744249,64.23173803526448,22.921914357682617,41.30982367758187,92.67285861713106,84.05572755417957,8.617131062951486,Transport
2265,1,2019-01-05,131290,ACTIMEL RASP-BLUE 3x(8x100g) FR OD,1,0,0,ACTIMEL,1,Rotselaar(BE),0084,0024 FR AIX (DC),4198,1938,1796,1629,167,309,142,0,-2260,53.83515959980943,739,397,255,91,164,306,142,0,-342,46.2787550744249,64.23173803526448,22.921914357682617,41.30982367758187,92.67285861713106,84.05572755417957,8.617131062951486,Transport
2266,0,2019-01-05,131290,ACTIMEL RASP-BLUE 3x(8x100g) FR OD,1,0,0,ACTIMEL,1,Rotselaar(BE),0080,0024 FR METZ (DC),4198,1938,1796,1629,167,309,142,0,-2260,53.83515959980943,1,11,11,11,0,0,0,0,10,-1000.0,100.0,100.0,0.0,92.67285861713106,84.05572755417957,8.617131062951486,Transport
2267,0,2019-01-05,131290,ACTIMEL RASP-BLUE 3x(8x100g) FR OD,1,0,0,ACTIMEL,1,Rotselaar(BE),0081,0024 FR TOURS (DC),4198,1938,1796,1629,167,309,142,0,-2260,53.83515959980943,70,16,16,16,0,0,0,0,-54,77.14285714285714,100.0,100.0,0.0,92.67285861713106,84.05572755417957,8.617131062951486,Transport
2268,0,2019-01-05,131290,ACTIMEL RASP-BLUE 3x(8x100g) FR OD,1,0,0,ACTIMEL,1,Rotselaar(BE),0082,0024 FR VALLET (DC),4198,1938,1796,1629,167,309,142,0,-2260,53.83515959980943,445,274,274,271,3,3,0,0,-171,38.42696629213483,100.0,98.90510948905109,1.0948905109489147,92.67285861713106,84.05572755417957,8.617131062951486,Transport
2269,0,2019-01-05,131290,ACTIMEL RASP-BLUE 3x(8x100g) FR OD,1,0,0,ACTIMEL,1,Rotselaar(BE),0077,0024 FR LILPARK (DC),4198,1938,1796,1629,167,309,142,0,-2260,53.83515959980943,90,51,51,51,0,0,0,0,-39,43.333333333333336,100.0,100.0,0.0,92.67285861713106,84.05572755417957,8.617131062951486,Transport
2270,0,2019-01-05,131290,ACTIMEL RASP-BLUE 3x(8x100g) FR OD,1,0,0,ACTIMEL,1,Rotselaar(BE),0085,0024 FR TOULOUSE (DC),4198,1938,1796,1629,167,309,142,0,-2260,53.83515959980943,3,19,19,19,0,0,0,0,16,-533.3333333333334,100.0,100.0,0.0,92.67285861713106,84.05572755417957,8.617131062951486,Transport
2271,0,2019-01-05,131290,ACTIMEL RASP-BLUE 3x(8x100g) FR OD,1,0,0,ACTIMEL,1,Rotselaar(BE),0083,0024 FR CHAPONNAY (DC),4198,1938,1796,1629,167,309,142,0,-2260,53.83515959980943,763,441,441,441,0,0,0,0,-322,42.20183486238532,100.0,100.0,0.0,92.67285861713106,84.05572755417957,8.617131062951486,Transport
2272,0,2019-01-05,131290,ACTIMEL RASP-BLUE 3x(8x100g) FR OD,1,0,0,ACTIMEL,1,Rotselaar(BE),0079,0024 FR PARIS SUD (DC),4198,1938,1796,1629,167,309,142,0,-2260,53.83515959980943,10,8,8,8,0,0,0,0,-2,20.0,100.0,100.0,0.0,92.67285861713106,84.05572755417957,8.617131062951486,Transport
2273,0,2019-01-05,131290,ACTIMEL RASP-BLUE 3x(8x100g) FR OD,1,0,0,ACTIMEL,1,Rotselaar(BE),0078,0024 FR PARIS NORD (DC),4198,1938,1796,1629,167,309,142,0,-2260,53.83515959980943,1338,721,721,721,0,0,0,0,-617,46.1136023916293,100.0,100.0,0.0,92.67285861713106,84.05572755417957,8.617131062951486,Transport
2274,1,2019-01-05,131291,ACTIMEL 0% NATU 3x(8x100g) FR,1,0,0,ACTIMEL,1,Rotselaar(BE),0084,0024 FR AIX (DC),811,1460,1460,1303,157,157,0,0,649,-80.02466091245375,500,269,269,234,35,35,0,0,-231,46.2,100.0,86.98884758364312,13.011152416356879,100.0,89.24657534246575,10.753424657534254,Transport
2275,1,2019-01-05,131291,ACTIMEL 0% NATU 3x(8x100g) FR,1,0,0,ACTIMEL,1,Rotselaar(BE),0082,0024 FR VALLET (DC),811,1460,1460,1303,157,157,0,0,649,-80.02466091245375,311,185,185,63,122,122,0,0,-126,40.51446945337621,100.0,34.054054054054056,65.94594594594594,100.0,89.24657534246575,10.753424657534254,Expe usine
2276,1,2019-01-05,133134,LIGHT & FREE FRAMB GREN 120X4 OD,1,0,0,LIGHT & FREE,0,Ferrières(FR),0083,0024 FR CHAPONNAY (DC),14,258,258,238,20,20,0,0,244,-1742.857142857143,14,20,20,0,20,20,0,0,6,-42.857142857142854,100.0,0.0,100.0,100.0,92.24806201550388,7.751937984496124,Probleme Copacking
2277,1,2019-01-05,138217,ACTIVIA 0% FRTS PAN 125X16 OD,0,0,0,ACTIVIA,0,Villecomtal(FR),0078,0024 FR PARIS NORD (DC),19,1058,1058,1010,48,48,0,0,1039,-5468.421052631579,19,266,266,218,48,48,0,0,247,-1300.0,100.0,81.95488721804512,18.045112781954884,100.0,95.46313799621929,4.536862003780712,A Creuser
2278,0,2019-01-05,140278,Activia almond/muesli/chia 170g FR-copac,0,0,0,ACTIVIA,1,Roumanie(RO),0084,0024 FR AIX (DC),450,678,678,278,400,400,0,0,228,-50.666666666666664,61,67,67,23,44,44,0,0,6,-9.836065573770492,100.0,34.32835820895522,65.67164179104478,100.0,41.00294985250738,58.99705014749262,Transport
2279,0,2019-01-05,140278,Activia almond/muesli/chia 170g FR-copac,0,0,0,ACTIVIA,1,Roumanie(RO),0080,0024 FR METZ (DC),450,678,678,278,400,400,0,0,228,-50.666666666666664,18,37,37,37,0,0,0,0,19,-105.55555555555556,100.0,100.0,0.0,100.0,41.00294985250738,58.99705014749262,Transport
2280,0,2019-01-05,140278,Activia almond/muesli/chia 170g FR-copac,0,0,0,ACTIVIA,1,Roumanie(RO),0081,0024 FR TOURS (DC),450,678,678,278,400,400,0,0,228,-50.666666666666664,43,128,128,50,78,78,0,0,85,-197.67441860465115,100.0,39.0625,60.9375,100.0,41.00294985250738,58.99705014749262,Transport
2281,0,2019-01-05,140278,Activia almond/muesli/chia 170g FR-copac,0,0,0,ACTIVIA,1,Roumanie(RO),0082,0024 FR VALLET (DC),450,678,678,278,400,400,0,0,228,-50.666666666666664,50,64,64,13,51,51,0,0,14,-28.0,100.0,20.3125,79.6875,100.0,41.00294985250738,58.99705014749262,Transport
2282,0,2019-01-05,140278,Activia almond/muesli/chia 170g FR-copac,0,0,0,ACTIVIA,1,Roumanie(RO),0077,0024 FR LILPARK (DC),450,678,678,278,400,400,0,0,228,-50.666666666666664,26,26,26,0,26,26,0,0,0,0.0,100.0,0.0,100.0,100.0,41.00294985250738,58.99705014749262,Transport
2283,0,2019-01-05,140278,Activia almond/muesli/chia 170g FR-copac,0,0,0,ACTIVIA,1,Roumanie(RO),0085,0024 FR TOULOUSE (DC),450,678,678,278,400,400,0,0,228,-50.666666666666664,60,65,65,41,24,24,0,0,5,-8.333333333333334,100.0,63.07692307692307,36.92307692307693,100.0,41.00294985250738,58.99705014749262,Transport
2284,0,2019-01-05,140278,Activia almond/muesli/chia 170g FR-copac,0,0,0,ACTIVIA,1,Roumanie(RO),0083,0024 FR CHAPONNAY (DC),450,678,678,278,400,400,0,0,228,-50.666666666666664,100,135,135,80,55,55,0,0,35,-35.0,100.0,59.25925925925925,40.74074074074075,100.0,41.00294985250738,58.99705014749262,Transport
2285,0,2019-01-05,140278,Activia almond/muesli/chia 170g FR-copac,0,0,0,ACTIVIA,1,Roumanie(RO),0079,0024 FR PARIS SUD (DC),450,678,678,278,400,400,0,0,228,-50.666666666666664,84,43,43,23,20,20,0,0,-41,48.80952380952381,100.0,53.48837209302325,46.51162790697675,100.0,41.00294985250738,58.99705014749262,Transport
2286,0,2019-01-05,140278,Activia almond/muesli/chia 170g FR-copac,0,0,0,ACTIVIA,1,Roumanie(RO),0078,0024 FR PARIS NORD (DC),450,678,678,278,400,400,0,0,228,-50.666666666666664,8,113,113,11,102,102,0,0,105,-1312.5,100.0,9.734513274336283,90.26548672566372,100.0,41.00294985250738,58.99705014749262,Transport
2287,0,2019-01-05,140280,Activia chia/raspb/muesli 170g FR-copack,0,0,0,ACTIVIA,1,Roumanie(RO),0084,0024 FR AIX (DC),718,1006,1006,556,450,450,0,0,288,-40.11142061281337,75,78,78,33,45,45,0,0,3,-4.0,100.0,42.30769230769231,57.69230769230769,100.0,55.26838966202783,44.73161033797217,Transport
2288,0,2019-01-05,140280,Activia chia/raspb/muesli 170g FR-copack,0,0,0,ACTIVIA,1,Roumanie(RO),0080,0024 FR METZ (DC),718,1006,1006,556,450,450,0,0,288,-40.11142061281337,31,46,46,46,0,0,0,0,15,-48.38709677419355,100.0,100.0,0.0,100.0,55.26838966202783,44.73161033797217,Transport
2289,0,2019-01-05,140280,Activia chia/raspb/muesli 170g FR-copack,0,0,0,ACTIVIA,1,Roumanie(RO),0081,0024 FR TOURS (DC),718,1006,1006,556,450,450,0,0,288,-40.11142061281337,83,172,172,86,86,86,0,0,89,-107.2289156626506,100.0,50.0,50.0,100.0,55.26838966202783,44.73161033797217,Transport
2290,0,2019-01-05,140280,Activia chia/raspb/muesli 170g FR-copack,0,0,0,ACTIVIA,1,Roumanie(RO),0082,0024 FR VALLET (DC),718,1006,1006,556,450,450,0,0,288,-40.11142061281337,61,105,105,13,92,92,0,0,44,-72.1311475409836,100.0,12.380952380952381,87.61904761904762,100.0,55.26838966202783,44.73161033797217,Transport
2291,0,2019-01-05,140280,Activia chia/raspb/muesli 170g FR-copack,0,0,0,ACTIVIA,1,Roumanie(RO),0077,0024 FR LILPARK (DC),718,1006,1006,556,450,450,0,0,288,-40.11142061281337,48,59,59,56,3,3,0,0,11,-22.916666666666668,100.0,94.91525423728814,5.0847457627118615,100.0,55.26838966202783,44.73161033797217,Transport
2292,0,2019-01-05,140280,Activia chia/raspb/muesli 170g FR-copack,0,0,0,ACTIVIA,1,Roumanie(RO),0085,0024 FR TOULOUSE (DC),718,1006,1006,556,450,450,0,0,288,-40.11142061281337,87,101,101,79,22,22,0,0,14,-16.091954022988507,100.0,78.21782178217822,21.78217821782178,100.0,55.26838966202783,44.73161033797217,Transport
2293,0,2019-01-05,140280,Activia chia/raspb/muesli 170g FR-copack,0,0,0,ACTIVIA,1,Roumanie(RO),0083,0024 FR CHAPONNAY (DC),718,1006,1006,556,450,450,0,0,288,-40.11142061281337,113,186,186,122,64,64,0,0,73,-64.60176991150442,100.0,65.59139784946237,34.40860215053763,100.0,55.26838966202783,44.73161033797217,Transport
2294,0,2019-01-05,140280,Activia chia/raspb/muesli 170g FR-copack,0,0,0,ACTIVIA,1,Roumanie(RO),0079,0024 FR PARIS SUD (DC),718,1006,1006,556,450,450,0,0,288,-40.11142061281337,87,87,87,66,21,21,0,0,0,0.0,100.0,75.86206896551724,24.13793103448276,100.0,55.26838966202783,44.73161033797217,Transport
2295,0,2019-01-05,140280,Activia chia/raspb/muesli 170g FR-copack,0,0,0,ACTIVIA,1,Roumanie(RO),0078,0024 FR PARIS NORD (DC),718,1006,1006,556,450,450,0,0,288,-40.11142061281337,133,172,172,55,117,117,0,0,39,-29.32330827067669,100.0,31.976744186046513,68.02325581395348,100.0,55.26838966202783,44.73161033797217,Transport
2296,0,2019-01-08,120170,VELOUTE FRUIX PANACHE 125X12,0,0,0,VELOUTE,0,Villecomtal(FR),0084,0024 FR AIX (DC),2553,3112,3112,3108,4,4,0,0,559,-21.895808852330592,144,169,169,165,4,4,0,0,25,-17.36111111111111,100.0,97.63313609467455,2.366863905325445,100.0,99.87146529562982,0.12853470437018188,Previsions
2297,0,2019-01-08,120170,VELOUTE FRUIX PANACHE 125X12,0,0,0,VELOUTE,0,Villecomtal(FR),0080,0024 FR METZ (DC),2553,3112,3112,3108,4,4,0,0,559,-21.895808852330592,168,179,179,179,0,0,0,0,11,-6.5476190476190474,100.0,100.0,0.0,100.0,99.87146529562982,0.12853470437018188,Previsions
2298,0,2019-01-08,120170,VELOUTE FRUIX PANACHE 125X12,0,0,0,VELOUTE,0,Villecomtal(FR),0081,0024 FR TOURS (DC),2553,3112,3112,3108,4,4,0,0,559,-21.895808852330592,428,509,509,509,0,0,0,0,81,-18.925233644859812,100.0,100.0,0.0,100.0,99.87146529562982,0.12853470437018188,Previsions
2299,0,2019-01-08,120170,VELOUTE FRUIX PANACHE 125X12,0,0,0,VELOUTE,0,Villecomtal(FR),0082,0024 FR VALLET (DC),2553,3112,3112,3108,4,4,0,0,559,-21.895808852330592,200,246,246,246,0,0,0,0,46,-23.0,100.0,100.0,0.0,100.0,99.87146529562982,0.12853470437018188,Previsions
2300,0,2019-01-08,120170,VELOUTE FRUIX PANACHE 125X12,0,0,0,VELOUTE,0,Villecomtal(FR),0077,0024 FR LILPARK (DC),2553,3112,3112,3108,4,4,0,0,559,-21.895808852330592,238,285,285,285,0,0,0,0,47,-19.747899159663866,100.0,100.0,0.0,100.0,99.87146529562982,0.12853470437018188,Previsions
2301,0,2019-01-08,120170,VELOUTE FRUIX PANACHE 125X12,0,0,0,VELOUTE,0,Villecomtal(FR),0085,0024 FR TOULOUSE (DC),2553,3112,3112,3108,4,4,0,0,559,-21.895808852330592,225,551,551,551,0,0,0,0,326,-144.88888888888889,100.0,100.0,0.0,100.0,99.87146529562982,0.12853470437018188,Previsions
2302,0,2019-01-08,120170,VELOUTE FRUIX PANACHE 125X12,0,0,0,VELOUTE,0,Villecomtal(FR),0083,0024 FR CHAPONNAY (DC),2553,3112,3112,3108,4,4,0,0,559,-21.895808852330592,479,450,450,450,0,0,0,0,-29,6.054279749478079,100.0,100.0,0.0,100.0,99.87146529562982,0.12853470437018188,Previsions
2303,0,2019-01-08,120170,VELOUTE FRUIX PANACHE 125X12,0,0,0,VELOUTE,0,Villecomtal(FR),0079,0024 FR PARIS SUD (DC),2553,3112,3112,3108,4,4,0,0,559,-21.895808852330592,460,515,515,515,0,0,0,0,55,-11.956521739130435,100.0,100.0,0.0,100.0,99.87146529562982,0.12853470437018188,Previsions
2304,0,2019-01-08,120170,VELOUTE FRUIX PANACHE 125X12,0,0,0,VELOUTE,0,Villecomtal(FR),0078,0024 FR PARIS NORD (DC),2553,3112,3112,3108,4,4,0,0,559,-21.895808852330592,211,208,208,208,0,0,0,0,-3,1.4218009478672986,100.0,100.0,0.0,100.0,99.87146529562982,0.12853470437018188,Previsions
2305,0,2019-01-08,127908,GERVAIS GRIEGO 115X2 BLUEBERRY FR,0,0,0,GERVAIS,1,Rosenheim(ALL),0084,0024 FR AIX (DC),478,581,581,581,0,0,0,0,103,-21.548117154811717,62,52,52,52,0,0,0,0,-10,16.129032258064516,100.0,100.0,0.0,100.0,100.0,0.0,Transport
2306,0,2019-01-08,127908,GERVAIS GRIEGO 115X2 BLUEBERRY FR,0,0,0,GERVAIS,1,Rosenheim(ALL),0080,0024 FR METZ (DC),478,581,581,581,0,0,0,0,103,-21.548117154811717,39,44,44,44,0,0,0,0,5,-12.820512820512821,100.0,100.0,0.0,100.0,100.0,0.0,Transport
2307,0,2019-01-08,127908,GERVAIS GRIEGO 115X2 BLUEBERRY FR,0,0,0,GERVAIS,1,Rosenheim(ALL),0081,0024 FR TOURS (DC),478,581,581,581,0,0,0,0,103,-21.548117154811717,71,70,70,70,0,0,0,0,-1,1.408450704225352,100.0,100.0,0.0,100.0,100.0,0.0,Transport
2308,0,2019-01-08,127908,GERVAIS GRIEGO 115X2 BLUEBERRY FR,0,0,0,GERVAIS,1,Rosenheim(ALL),0082,0024 FR VALLET (DC),478,581,581,581,0,0,0,0,103,-21.548117154811717,49,64,64,64,0,0,0,0,15,-30.612244897959183,100.0,100.0,0.0,100.0,100.0,0.0,Transport
2309,0,2019-01-08,127908,GERVAIS GRIEGO 115X2 BLUEBERRY FR,0,0,0,GERVAIS,1,Rosenheim(ALL),0077,0024 FR LILPARK (DC),478,581,581,581,0,0,0,0,103,-21.548117154811717,61,86,86,86,0,0,0,0,25,-40.98360655737705,100.0,100.0,0.0,100.0,100.0,0.0,Transport
2310,0,2019-01-08,127908,GERVAIS GRIEGO 115X2 BLUEBERRY FR,0,0,0,GERVAIS,1,Rosenheim(ALL),0085,0024 FR TOULOUSE (DC),478,581,581,581,0,0,0,0,103,-21.548117154811717,62,82,82,82,0,0,0,0,20,-32.25806451612903,100.0,100.0,0.0,100.0,100.0,0.0,Transport
2311,0,2019-01-08,127908,GERVAIS GRIEGO 115X2 BLUEBERRY FR,0,0,0,GERVAIS,1,Rosenheim(ALL),0079,0024 FR PARIS SUD (DC),478,581,581,581,0,0,0,0,103,-21.548117154811717,133,117,117,117,0,0,0,0,-16,12.030075187969924,100.0,100.0,0.0,100.0,100.0,0.0,Transport
2312,0,2019-01-08,127908,GERVAIS GRIEGO 115X2 BLUEBERRY FR,0,0,0,GERVAIS,1,Rosenheim(ALL),0078,0024 FR PARIS NORD (DC),478,581,581,581,0,0,0,0,103,-21.548117154811717,1,66,66,66,0,0,0,0,65,-6500.0,100.0,100.0,0.0,100.0,100.0,0.0,Transport
2313,1,2019-01-08,131288,ACTIMEL STRA-NATU 3x(8x100g) FR,1,0,0,ACTIMEL,1,Rotselaar(BE),0082,0024 FR VALLET (DC),94,1650,1650,1572,78,78,0,0,1556,-1655.3191489361702,94,79,79,1,78,78,0,0,-15,15.957446808510639,100.0,1.2658227848101267,98.73417721518987,100.0,95.27272727272728,4.7272727272727195,Transport
2314,0,2019-01-08,132458,ACTIVIA SAV CITRON 125X4 OD,0,0,0,ACTIVIA,0,Bailleul(FR),0085,0024 FR TOULOUSE (DC),36,10,10,10,0,0,0,0,-26,72.22222222222223,14,1,1,1,0,0,0,0,-13,92.85714285714286,100.0,100.0,0.0,100.0,100.0,0.0,Previsions
2315,0,2019-01-08,132458,ACTIVIA SAV CITRON 125X4 OD,0,0,0,ACTIVIA,0,Bailleul(FR),0079,0024 FR PARIS SUD (DC),36,10,10,10,0,0,0,0,-26,72.22222222222223,22,9,9,9,0,0,0,0,-13,59.09090909090909,100.0,100.0,0.0,100.0,100.0,0.0,Previsions
2316,1,2019-01-08,132491,ACTIVIA SAV FRAMB 125X4 OD,0,0,0,ACTIVIA,0,Bailleul(FR),0084,0024 FR AIX (DC),29,15,5,0,5,15,10,0,-14,48.275862068965516,29,15,5,0,5,15,10,0,-14,48.275862068965516,33.33333333333333,0.0,33.33333333333333,33.33333333333333,0.0,33.33333333333333,Previsions
2317,0,2019-01-09,432,COTTAGE 200gx2 fr,0,0,0,COTTAGE,1,Rosenheim(ALL),0084,0024 FR AIX (DC),202,306,172,88,84,218,134,0,104,-51.48514851485149,1,66,35,0,35,66,31,0,65,-6500.0,53.03030303030303,0.0,53.03030303030303,56.209150326797385,28.75816993464052,27.450980392156865,Transport
2318,0,2019-01-09,432,COTTAGE 200gx2 fr,0,0,0,COTTAGE,1,Rosenheim(ALL),0080,0024 FR METZ (DC),202,306,172,88,84,218,134,0,104,-51.48514851485149,26,20,1,0,1,20,19,0,-6,23.076923076923077,5.0,0.0,5.0,56.209150326797385,28.75816993464052,27.450980392156865,Transport
2319,0,2019-01-09,432,COTTAGE 200gx2 fr,0,0,0,COTTAGE,1,Rosenheim(ALL),0081,0024 FR TOURS (DC),202,306,172,88,84,218,134,0,104,-51.48514851485149,20,23,6,0,6,23,17,0,3,-15.0,26.08695652173913,0.0,26.08695652173913,56.209150326797385,28.75816993464052,27.450980392156865,Transport
2320,0,2019-01-09,432,COTTAGE 200gx2 fr,0,0,0,COTTAGE,1,Rosenheim(ALL),0082,0024 FR VALLET (DC),202,306,172,88,84,218,134,0,104,-51.48514851485149,12,6,4,0,4,6,2,0,-6,50.0,66.66666666666666,0.0,66.66666666666666,56.209150326797385,28.75816993464052,27.450980392156865,Transport
2321,0,2019-01-09,432,COTTAGE 200gx2 fr,0,0,0,COTTAGE,1,Rosenheim(ALL),0077,0024 FR LILPARK (DC),202,306,172,88,84,218,134,0,104,-51.48514851485149,10,3,1,0,1,3,2,0,-7,70.0,33.33333333333333,0.0,33.33333333333333,56.209150326797385,28.75816993464052,27.450980392156865,Transport
2322,0,2019-01-09,432,COTTAGE 200gx2 fr,0,0,0,COTTAGE,1,Rosenheim(ALL),0085,0024 FR TOULOUSE (DC),202,306,172,88,84,218,134,0,104,-51.48514851485149,31,27,18,2,16,25,9,0,-4,12.903225806451612,66.66666666666666,7.4074074074074066,59.25925925925925,56.209150326797385,28.75816993464052,27.450980392156865,Transport
2323,0,2019-01-09,432,COTTAGE 200gx2 fr,0,0,0,COTTAGE,1,Rosenheim(ALL),0083,0024 FR CHAPONNAY (DC),202,306,172,88,84,218,134,0,104,-51.48514851485149,36,40,40,40,0,0,0,0,4,-11.11111111111111,100.0,100.0,0.0,56.209150326797385,28.75816993464052,27.450980392156865,Transport
2324,0,2019-01-09,432,COTTAGE 200gx2 fr,0,0,0,COTTAGE,1,Rosenheim(ALL),0079,0024 FR PARIS SUD (DC),202,306,172,88,84,218,134,0,104,-51.48514851485149,7,90,48,46,2,44,42,0,83,-1185.7142857142858,53.333333333333336,51.11111111111111,2.2222222222222285,56.209150326797385,28.75816993464052,27.450980392156865,Transport
2325,0,2019-01-09,432,COTTAGE 200gx2 fr,0,0,0,COTTAGE,1,Rosenheim(ALL),0078,0024 FR PARIS NORD (DC),202,306,172,88,84,218,134,0,104,-51.48514851485149,59,31,19,0,19,31,12,0,-28,47.45762711864407,61.29032258064516,0.0,61.29032258064516,56.209150326797385,28.75816993464052,27.450980392156865,Transport
2326,0,2019-01-09,69189,GERVITA NATURE 100G X 8,0,0,0,GERVITA,0,Ferrières(FR),0084,0024 FR AIX (DC),4284,4966,4723,4719,4,247,243,0,682,-15.919701213818861,869,746,746,746,0,0,0,0,-123,14.154200230149597,100.0,100.0,0.0,95.106725734998,95.02617801047121,0.08054772452678094,Expe usine
2327,0,2019-01-09,69189,GERVITA NATURE 100G X 8,0,0,0,GERVITA,0,Ferrières(FR),0080,0024 FR METZ (DC),4284,4966,4723,4719,4,247,243,0,682,-15.919701213818861,328,381,138,134,4,247,243,0,53,-16.158536585365855,36.22047244094488,35.170603674540686,1.0498687664041952,95.106725734998,95.02617801047121,0.08054772452678094,Expe usine
2328,0,2019-01-09,69189,GERVITA NATURE 100G X 8,0,0,0,GERVITA,0,Ferrières(FR),0081,0024 FR TOURS (DC),4284,4966,4723,4719,4,247,243,0,682,-15.919701213818861,42,519,519,519,0,0,0,0,477,-1135.7142857142858,100.0,100.0,0.0,95.106725734998,95.02617801047121,0.08054772452678094,Expe usine
2329,0,2019-01-09,69189,GERVITA NATURE 100G X 8,0,0,0,GERVITA,0,Ferrières(FR),0082,0024 FR VALLET (DC),4284,4966,4723,4719,4,247,243,0,682,-15.919701213818861,358,375,375,375,0,0,0,0,17,-4.748603351955308,100.0,100.0,0.0,95.106725734998,95.02617801047121,0.08054772452678094,Expe usine
2330,0,2019-01-09,69189,GERVITA NATURE 100G X 8,0,0,0,GERVITA,0,Ferrières(FR),0077,0024 FR LILPARK (DC),4284,4966,4723,4719,4,247,243,0,682,-15.919701213818861,115,163,163,163,0,0,0,0,48,-41.73913043478261,100.0,100.0,0.0,95.106725734998,95.02617801047121,0.08054772452678094,Expe usine
2331,0,2019-01-09,69189,GERVITA NATURE 100G X 8,0,0,0,GERVITA,0,Ferrières(FR),0085,0024 FR TOULOUSE (DC),4284,4966,4723,4719,4,247,243,0,682,-15.919701213818861,994,1099,1099,1099,0,0,0,0,105,-10.56338028169014,100.0,100.0,0.0,95.106725734998,95.02617801047121,0.08054772452678094,Expe usine
2332,0,2019-01-09,69189,GERVITA NATURE 100G X 8,0,0,0,GERVITA,0,Ferrières(FR),0083,0024 FR CHAPONNAY (DC),4284,4966,4723,4719,4,247,243,0,682,-15.919701213818861,755,729,729,729,0,0,0,0,-26,3.443708609271523,100.0,100.0,0.0,95.106725734998,95.02617801047121,0.08054772452678094,Expe usine
2333,0,2019-01-09,69189,GERVITA NATURE 100G X 8,0,0,0,GERVITA,0,Ferrières(FR),0079,0024 FR PARIS SUD (DC),4284,4966,4723,4719,4,247,243,0,682,-15.919701213818861,455,514,514,514,0,0,0,0,59,-12.967032967032967,100.0,100.0,0.0,95.106725734998,95.02617801047121,0.08054772452678094,Expe usine
2334,0,2019-01-09,69189,GERVITA NATURE 100G X 8,0,0,0,GERVITA,0,Ferrières(FR),0078,0024 FR PARIS NORD (DC),4284,4966,4723,4719,4,247,243,0,682,-15.919701213818861,368,440,440,440,0,0,0,0,72,-19.565217391304348,100.0,100.0,0.0,95.106725734998,95.02617801047121,0.08054772452678094,Expe usine
2335,0,2019-01-09,78735,DANONE Y STRAWB RASPB 150X1,0,0,1,DANONE YOGHURT,1,Mlc(FR),0084,0024 FR AIX (DC),487,576,428,426,2,150,148,0,89,-18.275154004106778,33,39,31,31,0,8,8,0,6,-18.181818181818183,79.48717948717949,79.48717948717949,0.0,74.30555555555556,73.95833333333334,0.3472222222222143,Previsions
2336,0,2019-01-09,78735,DANONE Y STRAWB RASPB 150X1,0,0,1,DANONE YOGHURT,1,Mlc(FR),0080,0024 FR METZ (DC),487,576,428,426,2,150,148,0,89,-18.275154004106778,10,16,13,12,1,4,3,0,6,-60.0,81.25,75.0,6.25,74.30555555555556,73.95833333333334,0.3472222222222143,Previsions
2337,0,2019-01-09,78735,DANONE Y STRAWB RASPB 150X1,0,0,1,DANONE YOGHURT,1,Mlc(FR),0081,0024 FR TOURS (DC),487,576,428,426,2,150,148,0,89,-18.275154004106778,48,12,8,8,0,4,4,0,-36,75.0,66.66666666666666,66.66666666666666,0.0,74.30555555555556,73.95833333333334,0.3472222222222143,Previsions
2338,0,2019-01-09,78735,DANONE Y STRAWB RASPB 150X1,0,0,1,DANONE YOGHURT,1,Mlc(FR),0082,0024 FR VALLET (DC),487,576,428,426,2,150,148,0,89,-18.275154004106778,16,32,12,12,0,20,20,0,16,-100.0,37.5,37.5,0.0,74.30555555555556,73.95833333333334,0.3472222222222143,Previsions
2339,0,2019-01-09,78735,DANONE Y STRAWB RASPB 150X1,0,0,1,DANONE YOGHURT,1,Mlc(FR),0077,0024 FR LILPARK (DC),487,576,428,426,2,150,148,0,89,-18.275154004106778,23,12,12,12,0,0,0,0,-11,47.82608695652174,100.0,100.0,0.0,74.30555555555556,73.95833333333334,0.3472222222222143,Previsions
2340,0,2019-01-09,78735,DANONE Y STRAWB RASPB 150X1,0,0,1,DANONE YOGHURT,1,Mlc(FR),0085,0024 FR TOULOUSE (DC),487,576,428,426,2,150,148,0,89,-18.275154004106778,34,153,50,50,0,103,103,0,119,-350.0,32.6797385620915,32.6797385620915,0.0,74.30555555555556,73.95833333333334,0.3472222222222143,Previsions
2341,0,2019-01-09,78735,DANONE Y STRAWB RASPB 150X1,0,0,1,DANONE YOGHURT,1,Mlc(FR),0083,0024 FR CHAPONNAY (DC),487,576,428,426,2,150,148,0,89,-18.275154004106778,77,100,90,89,1,11,10,0,23,-29.87012987012987,90.0,89.0,1.0,74.30555555555556,73.95833333333334,0.3472222222222143,Previsions
2342,0,2019-01-09,78735,DANONE Y STRAWB RASPB 150X1,0,0,1,DANONE YOGHURT,1,Mlc(FR),0078,0024 FR PARIS NORD (DC),487,576,428,426,2,150,148,0,89,-18.275154004106778,246,212,212,212,0,0,0,0,-34,13.821138211382113,100.0,100.0,0.0,74.30555555555556,73.95833333333334,0.3472222222222143,Previsions
2343,1,2019-01-09,121313,ACTIMEL MULTI 4x(10x100g) FR,0,0,0,ACTIMEL,1,Rotselaar(BE),0081,0024 FR TOURS (DC),578,2965,2965,2965,0,0,0,0,2387,-412.9757785467128,578,1205,1205,1205,0,0,0,0,627,-108.47750865051903,100.0,100.0,0.0,100.0,100.0,0.0,Transport
2344,1,2019-01-09,121315,ACTIMEL NATU 4x(10x100g) FR,0,0,0,ACTIMEL,1,Rotselaar(BE),0081,0024 FR TOURS (DC),411,3233,3233,3233,0,0,0,0,2822,-686.6180048661801,411,1004,1004,1004,0,0,0,0,593,-144.28223844282238,100.0,100.0,0.0,100.0,100.0,0.0,Transport
2345,0,2019-01-09,122527,DANONINO FRTS PANACHE 50X24,0,0,0,DANONINO,0,Ferrières(FR),0084,0024 FR AIX (DC),1731,1579,1578,1401,177,178,1,0,-152,8.78105141536684,173,155,155,155,0,0,0,0,-18,10.404624277456648,100.0,100.0,0.0,99.93666877770741,88.72704243191893,11.209626345788479,Expe usine
2346,0,2019-01-09,122527,DANONINO FRTS PANACHE 50X24,0,0,0,DANONINO,0,Ferrières(FR),0080,0024 FR METZ (DC),1731,1579,1578,1401,177,178,1,0,-152,8.78105141536684,198,191,190,90,100,101,1,0,-7,3.5353535353535355,99.47643979057592,47.12041884816754,52.356020942408385,99.93666877770741,88.72704243191893,11.209626345788479,Expe usine
2347,0,2019-01-09,122527,DANONINO FRTS PANACHE 50X24,0,0,0,DANONINO,0,Ferrières(FR),0081,0024 FR TOURS (DC),1731,1579,1578,1401,177,178,1,0,-152,8.78105141536684,190,146,146,146,0,0,0,0,-44,23.157894736842106,100.0,100.0,0.0,99.93666877770741,88.72704243191893,11.209626345788479,Expe usine
2348,0,2019-01-09,122527,DANONINO FRTS PANACHE 50X24,0,0,0,DANONINO,0,Ferrières(FR),0082,0024 FR VALLET (DC),1731,1579,1578,1401,177,178,1,0,-152,8.78105141536684,164,142,142,131,11,11,0,0,-22,13.414634146341463,100.0,92.25352112676056,7.74647887323944,99.93666877770741,88.72704243191893,11.209626345788479,Expe usine
2349,0,2019-01-09,122527,DANONINO FRTS PANACHE 50X24,0,0,0,DANONINO,0,Ferrières(FR),0077,0024 FR LILPARK (DC),1731,1579,1578,1401,177,178,1,0,-152,8.78105141536684,126,107,107,41,66,66,0,0,-19,15.079365079365079,100.0,38.31775700934579,61.68224299065421,99.93666877770741,88.72704243191893,11.209626345788479,Expe usine
2350,0,2019-01-09,122527,DANONINO FRTS PANACHE 50X24,0,0,0,DANONINO,0,Ferrières(FR),0085,0024 FR TOULOUSE (DC),1731,1579,1578,1401,177,178,1,0,-152,8.78105141536684,186,178,178,178,0,0,0,0,-8,4.301075268817204,100.0,100.0,0.0,99.93666877770741,88.72704243191893,11.209626345788479,Expe usine
2351,0,2019-01-09,122527,DANONINO FRTS PANACHE 50X24,0,0,0,DANONINO,0,Ferrières(FR),0083,0024 FR CHAPONNAY (DC),1731,1579,1578,1401,177,178,1,0,-152,8.78105141536684,290,289,289,289,0,0,0,0,-1,0.3448275862068966,100.0,100.0,0.0,99.93666877770741,88.72704243191893,11.209626345788479,Expe usine
2352,0,2019-01-09,122527,DANONINO FRTS PANACHE 50X24,0,0,0,DANONINO,0,Ferrières(FR),0079,0024 FR PARIS SUD (DC),1731,1579,1578,1401,177,178,1,0,-152,8.78105141536684,183,143,143,143,0,0,0,0,-40,21.85792349726776,100.0,100.0,0.0,99.93666877770741,88.72704243191893,11.209626345788479,Expe usine
2353,0,2019-01-09,122527,DANONINO FRTS PANACHE 50X24,0,0,0,DANONINO,0,Ferrières(FR),0078,0024 FR PARIS NORD (DC),1731,1579,1578,1401,177,178,1,0,-152,8.78105141536684,221,228,228,228,0,0,0,0,7,-3.167420814479638,100.0,100.0,0.0,99.93666877770741,88.72704243191893,11.209626345788479,Expe usine
2354,0,2019-01-10,69004,DANETTE MOU LIEG 80X8 CAFE NEW,0,0,0,DANETTE,1,Ochsenfurt(ALL),0084,0024 FR AIX (DC),823,1020,865,782,83,238,155,0,197,-23.93681652490887,50,78,78,78,0,0,0,0,28,-56.0,100.0,100.0,0.0,84.80392156862744,76.66666666666667,8.137254901960773,Client
2355,0,2019-01-10,69004,DANETTE MOU LIEG 80X8 CAFE NEW,0,0,0,DANETTE,1,Ochsenfurt(ALL),0080,0024 FR METZ (DC),823,1020,865,782,83,238,155,0,197,-23.93681652490887,107,73,73,73,0,0,0,0,-34,31.77570093457944,100.0,100.0,0.0,84.80392156862744,76.66666666666667,8.137254901960773,Client
2356,0,2019-01-10,69004,DANETTE MOU LIEG 80X8 CAFE NEW,0,0,0,DANETTE,1,Ochsenfurt(ALL),0081,0024 FR TOURS (DC),823,1020,865,782,83,238,155,0,197,-23.93681652490887,11,89,89,7,82,82,0,0,78,-709.0909090909091,100.0,7.865168539325842,92.13483146067416,84.80392156862744,76.66666666666667,8.137254901960773,Client
2357,0,2019-01-10,69004,DANETTE MOU LIEG 80X8 CAFE NEW,0,0,0,DANETTE,1,Ochsenfurt(ALL),0082,0024 FR VALLET (DC),823,1020,865,782,83,238,155,0,197,-23.93681652490887,34,43,24,23,1,20,19,0,9,-26.470588235294116,55.81395348837209,53.48837209302325,2.3255813953488413,84.80392156862744,76.66666666666667,8.137254901960773,Client
2358,0,2019-01-10,69004,DANETTE MOU LIEG 80X8 CAFE NEW,0,0,0,DANETTE,1,Ochsenfurt(ALL),0077,0024 FR LILPARK (DC),823,1020,865,782,83,238,155,0,197,-23.93681652490887,263,338,223,223,0,115,115,0,75,-28.517110266159698,65.97633136094674,65.97633136094674,0.0,84.80392156862744,76.66666666666667,8.137254901960773,Client
2359,0,2019-01-10,69004,DANETTE MOU LIEG 80X8 CAFE NEW,0,0,0,DANETTE,1,Ochsenfurt(ALL),0085,0024 FR TOULOUSE (DC),823,1020,865,782,83,238,155,0,197,-23.93681652490887,150,162,162,162,0,0,0,0,12,-8.0,100.0,100.0,0.0,84.80392156862744,76.66666666666667,8.137254901960773,Client
2360,0,2019-01-10,69004,DANETTE MOU LIEG 80X8 CAFE NEW,0,0,0,DANETTE,1,Ochsenfurt(ALL),0083,0024 FR CHAPONNAY (DC),823,1020,865,782,83,238,155,0,197,-23.93681652490887,80,96,75,75,0,21,21,0,16,-20.0,78.125,78.125,0.0,84.80392156862744,76.66666666666667,8.137254901960773,Client
2361,0,2019-01-10,69004,DANETTE MOU LIEG 80X8 CAFE NEW,0,0,0,DANETTE,1,Ochsenfurt(ALL),0079,0024 FR PARIS SUD (DC),823,1020,865,782,83,238,155,0,197,-23.93681652490887,58,52,52,52,0,0,0,0,-6,10.344827586206897,100.0,100.0,0.0,84.80392156862744,76.66666666666667,8.137254901960773,Client
2362,0,2019-01-10,69004,DANETTE MOU LIEG 80X8 CAFE NEW,0,0,0,DANETTE,1,Ochsenfurt(ALL),0078,0024 FR PARIS NORD (DC),823,1020,865,782,83,238,155,0,197,-23.93681652490887,70,89,89,89,0,0,0,0,19,-27.142857142857142,100.0,100.0,0.0,84.80392156862744,76.66666666666667,8.137254901960773,Client
2363,0,2019-01-10,121315,ACTIMEL NATU 4x(10x100g) FR,0,0,0,ACTIMEL,1,Rotselaar(BE),0084,0024 FR AIX (DC),2133,2454,2454,2270,184,184,0,0,321,-15.049226441631506,249,145,145,143,2,2,0,0,-104,41.76706827309237,100.0,98.62068965517241,1.3793103448275872,100.0,92.50203748981255,7.497962510187449,Transport
2364,0,2019-01-10,121315,ACTIMEL NATU 4x(10x100g) FR,0,0,0,ACTIMEL,1,Rotselaar(BE),0080,0024 FR METZ (DC),2133,2454,2454,2270,184,184,0,0,321,-15.049226441631506,562,818,818,818,0,0,0,0,256,-45.55160142348755,100.0,100.0,0.0,100.0,92.50203748981255,7.497962510187449,Transport
2365,0,2019-01-10,121315,ACTIMEL NATU 4x(10x100g) FR,0,0,0,ACTIMEL,1,Rotselaar(BE),0081,0024 FR TOURS (DC),2133,2454,2454,2270,184,184,0,0,321,-15.049226441631506,229,350,350,350,0,0,0,0,121,-52.838427947598255,100.0,100.0,0.0,100.0,92.50203748981255,7.497962510187449,Transport
2366,0,2019-01-10,121315,ACTIMEL NATU 4x(10x100g) FR,0,0,0,ACTIMEL,1,Rotselaar(BE),0082,0024 FR VALLET (DC),2133,2454,2454,2270,184,184,0,0,321,-15.049226441631506,301,514,514,332,182,182,0,0,213,-70.7641196013289,100.0,64.59143968871595,35.40856031128405,100.0,92.50203748981255,7.497962510187449,Transport
2367,1,2019-01-10,121315,ACTIMEL NATU 4x(10x100g) FR,0,0,0,ACTIMEL,1,Rotselaar(BE),0082,0024 FR VALLET (DC),2133,2454,2454,2270,184,184,0,0,321,-15.049226441631506,301,514,514,332,182,182,0,0,213,-70.7641196013289,100.0,64.59143968871595,35.40856031128405,100.0,92.50203748981255,7.497962510187449,Transport
2368,0,2019-01-10,121315,ACTIMEL NATU 4x(10x100g) FR,0,0,0,ACTIMEL,1,Rotselaar(BE),0077,0024 FR LILPARK (DC),2133,2454,2454,2270,184,184,0,0,321,-15.049226441631506,81,48,48,48,0,0,0,0,-33,40.74074074074074,100.0,100.0,0.0,100.0,92.50203748981255,7.497962510187449,Transport
2369,0,2019-01-10,121315,ACTIMEL NATU 4x(10x100g) FR,0,0,0,ACTIMEL,1,Rotselaar(BE),0085,0024 FR TOULOUSE (DC),2133,2454,2454,2270,184,184,0,0,321,-15.049226441631506,182,221,221,221,0,0,0,0,39,-21.428571428571427,100.0,100.0,0.0,100.0,92.50203748981255,7.497962510187449,Transport
2370,0,2019-01-10,121315,ACTIMEL NATU 4x(10x100g) FR,0,0,0,ACTIMEL,1,Rotselaar(BE),0083,0024 FR CHAPONNAY (DC),2133,2454,2454,2270,184,184,0,0,321,-15.049226441631506,92,56,56,56,0,0,0,0,-36,39.130434782608695,100.0,100.0,0.0,100.0,92.50203748981255,7.497962510187449,Transport
2371,0,2019-01-10,121315,ACTIMEL NATU 4x(10x100g) FR,0,0,0,ACTIMEL,1,Rotselaar(BE),0079,0024 FR PARIS SUD (DC),2133,2454,2454,2270,184,184,0,0,321,-15.049226441631506,44,246,246,246,0,0,0,0,202,-459.09090909090907,100.0,100.0,0.0,100.0,92.50203748981255,7.497962510187449,Transport
2372,0,2019-01-10,121315,ACTIMEL NATU 4x(10x100g) FR,0,0,0,ACTIMEL,1,Rotselaar(BE),0078,0024 FR PARIS NORD (DC),2133,2454,2454,2270,184,184,0,0,321,-15.049226441631506,92,56,56,56,0,0,0,0,-36,39.130434782608695,100.0,100.0,0.0,100.0,92.50203748981255,7.497962510187449,Transport
2373,0,2019-01-10,121319,ACTIMEL STRA 4x(12x100g) FR,0,0,0,ACTIMEL,1,Aldaya(ES),0084,0024 FR AIX (DC),1665,1657,1464,1456,8,201,193,0,-8,0.4804804804804805,103,99,99,99,0,0,0,0,-4,3.883495145631068,100.0,100.0,0.0,88.3524441762221,87.86964393482197,0.48280024140012756,Previsions
2374,0,2019-01-10,121319,ACTIMEL STRA 4x(12x100g) FR,0,0,0,ACTIMEL,1,Aldaya(ES),0080,0024 FR METZ (DC),1665,1657,1464,1456,8,201,193,0,-8,0.4804804804804805,162,159,159,159,0,0,0,0,-3,1.8518518518518519,100.0,100.0,0.0,88.3524441762221,87.86964393482197,0.48280024140012756,Previsions
2375,0,2019-01-10,121319,ACTIMEL STRA 4x(12x100g) FR,0,0,0,ACTIMEL,1,Aldaya(ES),0081,0024 FR TOURS (DC),1665,1657,1464,1456,8,201,193,0,-8,0.4804804804804805,183,242,49,41,8,201,193,0,59,-32.240437158469945,20.24793388429752,16.94214876033058,3.305785123966942,88.3524441762221,87.86964393482197,0.48280024140012756,Previsions
2376,0,2019-01-10,121319,ACTIMEL STRA 4x(12x100g) FR,0,0,0,ACTIMEL,1,Aldaya(ES),0082,0024 FR VALLET (DC),1665,1657,1464,1456,8,201,193,0,-8,0.4804804804804805,109,103,103,103,0,0,0,0,-6,5.504587155963303,100.0,100.0,0.0,88.3524441762221,87.86964393482197,0.48280024140012756,Previsions
2377,0,2019-01-10,121319,ACTIMEL STRA 4x(12x100g) FR,0,0,0,ACTIMEL,1,Aldaya(ES),0077,0024 FR LILPARK (DC),1665,1657,1464,1456,8,201,193,0,-8,0.4804804804804805,186,199,199,199,0,0,0,0,13,-6.989247311827957,100.0,100.0,0.0,88.3524441762221,87.86964393482197,0.48280024140012756,Previsions
2378,0,2019-01-10,121319,ACTIMEL STRA 4x(12x100g) FR,0,0,0,ACTIMEL,1,Aldaya(ES),0085,0024 FR TOULOUSE (DC),1665,1657,1464,1456,8,201,193,0,-8,0.4804804804804805,189,188,188,188,0,0,0,0,-1,0.5291005291005291,100.0,100.0,0.0,88.3524441762221,87.86964393482197,0.48280024140012756,Previsions
2379,0,2019-01-10,121319,ACTIMEL STRA 4x(12x100g) FR,0,0,0,ACTIMEL,1,Aldaya(ES),0083,0024 FR CHAPONNAY (DC),1665,1657,1464,1456,8,201,193,0,-8,0.4804804804804805,301,266,266,266,0,0,0,0,-35,11.627906976744185,100.0,100.0,0.0,88.3524441762221,87.86964393482197,0.48280024140012756,Previsions
2380,0,2019-01-10,121319,ACTIMEL STRA 4x(12x100g) FR,0,0,0,ACTIMEL,1,Aldaya(ES),0079,0024 FR PARIS SUD (DC),1665,1657,1464,1456,8,201,193,0,-8,0.4804804804804805,268,238,238,238,0,0,0,0,-30,11.194029850746269,100.0,100.0,0.0,88.3524441762221,87.86964393482197,0.48280024140012756,Previsions
2381,0,2019-01-10,121319,ACTIMEL STRA 4x(12x100g) FR,0,0,0,ACTIMEL,1,Aldaya(ES),0078,0024 FR PARIS NORD (DC),1665,1657,1464,1456,8,201,193,0,-8,0.4804804804804805,164,163,163,163,0,0,0,0,-1,0.6097560975609756,100.0,100.0,0.0,88.3524441762221,87.86964393482197,0.48280024140012756,Previsions
2382,0,2019-01-10,121321,ACTIMEL MULTI 3x(8x100g) FR,0,0,0,ACTIMEL,1,Aldaya(ES),0084,0024 FR AIX (DC),2242,2630,2497,2430,67,200,133,0,388,-17.305976806422837,22,249,249,249,0,0,0,0,227,-1031.8181818181818,100.0,100.0,0.0,94.94296577946768,92.39543726235742,2.5475285171102655,Previsions
2383,0,2019-01-10,121321,ACTIMEL MULTI 3x(8x100g) FR,0,0,0,ACTIMEL,1,Aldaya(ES),0080,0024 FR METZ (DC),2242,2630,2497,2430,67,200,133,0,388,-17.305976806422837,188,192,192,192,0,0,0,0,4,-2.127659574468085,100.0,100.0,0.0,94.94296577946768,92.39543726235742,2.5475285171102655,Previsions
2384,0,2019-01-10,121321,ACTIMEL MULTI 3x(8x100g) FR,0,0,0,ACTIMEL,1,Aldaya(ES),0081,0024 FR TOURS (DC),2242,2630,2497,2430,67,200,133,0,388,-17.305976806422837,232,263,231,231,0,32,32,0,31,-13.362068965517242,87.83269961977186,87.83269961977186,0.0,94.94296577946768,92.39543726235742,2.5475285171102655,Previsions
2385,0,2019-01-10,121321,ACTIMEL MULTI 3x(8x100g) FR,0,0,0,ACTIMEL,1,Aldaya(ES),0082,0024 FR VALLET (DC),2242,2630,2497,2430,67,200,133,0,388,-17.305976806422837,150,150,150,150,0,0,0,0,0,0.0,100.0,100.0,0.0,94.94296577946768,92.39543726235742,2.5475285171102655,Previsions
2386,0,2019-01-10,121321,ACTIMEL MULTI 3x(8x100g) FR,0,0,0,ACTIMEL,1,Aldaya(ES),0077,0024 FR LILPARK (DC),2242,2630,2497,2430,67,200,133,0,388,-17.305976806422837,210,240,240,240,0,0,0,0,30,-14.285714285714286,100.0,100.0,0.0,94.94296577946768,92.39543726235742,2.5475285171102655,Previsions
2387,0,2019-01-10,121321,ACTIMEL MULTI 3x(8x100g) FR,0,0,0,ACTIMEL,1,Aldaya(ES),0085,0024 FR TOULOUSE (DC),2242,2630,2497,2430,67,200,133,0,388,-17.305976806422837,197,211,211,211,0,0,0,0,14,-7.106598984771574,100.0,100.0,0.0,94.94296577946768,92.39543726235742,2.5475285171102655,Previsions
2388,0,2019-01-10,121321,ACTIMEL MULTI 3x(8x100g) FR,0,0,0,ACTIMEL,1,Aldaya(ES),0083,0024 FR CHAPONNAY (DC),2242,2630,2497,2430,67,200,133,0,388,-17.305976806422837,362,379,379,379,0,0,0,0,17,-4.696132596685083,100.0,100.0,0.0,94.94296577946768,92.39543726235742,2.5475285171102655,Previsions
2389,0,2019-01-10,121321,ACTIMEL MULTI 3x(8x100g) FR,0,0,0,ACTIMEL,1,Aldaya(ES),0079,0024 FR PARIS SUD (DC),2242,2630,2497,2430,67,200,133,0,388,-17.305976806422837,536,564,564,564,0,0,0,0,28,-5.223880597014926,100.0,100.0,0.0,94.94296577946768,92.39543726235742,2.5475285171102655,Previsions
2390,0,2019-01-10,121321,ACTIMEL MULTI 3x(8x100g) FR,0,0,0,ACTIMEL,1,Aldaya(ES),0078,0024 FR PARIS NORD (DC),2242,2630,2497,2430,67,200,133,0,388,-17.305976806422837,345,382,281,214,67,168,101,0,37,-10.72463768115942,73.56020942408377,56.02094240837696,17.539267015706805,94.94296577946768,92.39543726235742,2.5475285171102655,Previsions
2391,1,2019-01-10,121428,ACTIMEL FOREST FR 4x(10x100g) FR,0,0,0,ACTIMEL,1,Rotselaar(BE),0082,0024 FR VALLET (DC),244,1504,1481,1390,91,114,23,0,1260,-516.3934426229508,244,341,318,227,91,114,23,0,97,-39.75409836065574,93.25513196480938,66.56891495601172,26.686217008797655,98.47074468085107,92.42021276595744,6.050531914893625,Transport
2392,0,2019-01-11,121321,ACTIMEL MULTI 3x(8x100g) FR,0,0,0,ACTIMEL,1,Rotselaar(BE),0084,0024 FR AIX (DC),1809,1920,1583,1583,0,337,337,0,111,-6.135986733001658,241,211,211,211,0,0,0,0,-30,12.448132780082988,100.0,100.0,0.0,82.44791666666667,82.44791666666667,0.0,Previsions
2393,0,2019-01-11,121321,ACTIMEL MULTI 3x(8x100g) FR,0,0,0,ACTIMEL,1,Rotselaar(BE),0080,0024 FR METZ (DC),1809,1920,1583,1583,0,337,337,0,111,-6.135986733001658,145,196,196,196,0,0,0,0,51,-35.172413793103445,100.0,100.0,0.0,82.44791666666667,82.44791666666667,0.0,Previsions
2394,0,2019-01-11,121321,ACTIMEL MULTI 3x(8x100g) FR,0,0,0,ACTIMEL,1,Rotselaar(BE),0081,0024 FR TOURS (DC),1809,1920,1583,1583,0,337,337,0,111,-6.135986733001658,201,183,95,95,0,88,88,0,-18,8.955223880597014,51.91256830601093,51.91256830601093,0.0,82.44791666666667,82.44791666666667,0.0,Previsions
2395,0,2019-01-11,121321,ACTIMEL MULTI 3x(8x100g) FR,0,0,0,ACTIMEL,1,Rotselaar(BE),0082,0024 FR VALLET (DC),1809,1920,1583,1583,0,337,337,0,111,-6.135986733001658,134,115,115,115,0,0,0,0,-19,14.17910447761194,100.0,100.0,0.0,82.44791666666667,82.44791666666667,0.0,Previsions
2396,0,2019-01-11,121321,ACTIMEL MULTI 3x(8x100g) FR,0,0,0,ACTIMEL,1,Rotselaar(BE),0077,0024 FR LILPARK (DC),1809,1920,1583,1583,0,337,337,0,111,-6.135986733001658,104,110,110,110,0,0,0,0,6,-5.769230769230769,100.0,100.0,0.0,82.44791666666667,82.44791666666667,0.0,Previsions
2397,0,2019-01-11,121321,ACTIMEL MULTI 3x(8x100g) FR,0,0,0,ACTIMEL,1,Rotselaar(BE),0085,0024 FR TOULOUSE (DC),1809,1920,1583,1583,0,337,337,0,111,-6.135986733001658,170,167,167,167,0,0,0,0,-3,1.7647058823529411,100.0,100.0,0.0,82.44791666666667,82.44791666666667,0.0,Previsions
2398,0,2019-01-11,121321,ACTIMEL MULTI 3x(8x100g) FR,0,0,0,ACTIMEL,1,Rotselaar(BE),0083,0024 FR CHAPONNAY (DC),1809,1920,1583,1583,0,337,337,0,111,-6.135986733001658,287,253,253,253,0,0,0,0,-34,11.846689895470384,100.0,100.0,0.0,82.44791666666667,82.44791666666667,0.0,Previsions
2399,0,2019-01-11,121321,ACTIMEL MULTI 3x(8x100g) FR,0,0,0,ACTIMEL,1,Rotselaar(BE),0079,0024 FR PARIS SUD (DC),1809,1920,1583,1583,0,337,337,0,111,-6.135986733001658,497,419,170,170,0,249,249,0,-78,15.694164989939638,40.572792362768496,40.572792362768496,0.0,82.44791666666667,82.44791666666667,0.0,Previsions
2400,0,2019-01-11,121321,ACTIMEL MULTI 3x(8x100g) FR,0,0,0,ACTIMEL,1,Rotselaar(BE),0078,0024 FR PARIS NORD (DC),1809,1920,1583,1583,0,337,337,0,111,-6.135986733001658,30,266,266,266,0,0,0,0,236,-786.6666666666666,100.0,100.0,0.0,82.44791666666667,82.44791666666667,0.0,Previsions
2401,1,2019-01-11,121428,ACTIMEL FOREST FR 4x(10x100g) FR,0,0,0,ACTIMEL,1,Rotselaar(BE),0082,0024 FR VALLET (DC),867,4218,4187,3769,418,449,31,0,3351,-386.5051903114187,867,545,545,129,416,416,0,0,-322,37.13956170703575,100.0,23.669724770642205,76.3302752293578,99.26505452821243,89.35514461830252,9.909909909909913,Transport
2402,1,2019-01-11,131289,ACTIMEL MULTI 3x(8x100g) FR,1,0,0,ACTIMEL,1,Rotselaar(BE),0082,0024 FR VALLET (DC),215,1881,1881,1831,50,50,0,0,1666,-774.8837209302326,215,120,120,70,50,50,0,0,-95,44.18604651162791,100.0,58.333333333333336,41.666666666666664,100.0,97.3418394471026,2.6581605528973995,Transport
2403,1,2019-01-11,131290,ACTIMEL RASP-BLUE 3x(8x100g) FR OD,1,0,0,ACTIMEL,1,Rotselaar(BE),0082,0024 FR VALLET (DC),195,1633,1633,1460,173,173,0,0,1438,-737.4358974358975,195,107,107,72,35,35,0,0,-88,45.12820512820513,100.0,67.28971962616822,32.71028037383178,100.0,89.40600122473974,10.59399877526026,Transport
2404,0,2019-01-11,140278,Activia almond/muesli/chia 170g FR-copac,0,0,0,ACTIVIA,1,Roumanie(RO),0080,0024 FR METZ (DC),274,334,207,142,65,192,127,0,60,-21.8978102189781,44,63,63,63,0,0,0,0,19,-43.18181818181818,100.0,100.0,0.0,61.97604790419161,42.51497005988024,19.46107784431137,Transport
2405,0,2019-01-11,140278,Activia almond/muesli/chia 170g FR-copac,0,0,0,ACTIVIA,1,Roumanie(RO),0081,0024 FR TOURS (DC),274,334,207,142,65,192,127,0,60,-21.8978102189781,7,52,3,2,1,50,49,0,45,-642.8571428571429,5.769230769230769,3.8461538461538463,1.923076923076923,61.97604790419161,42.51497005988024,19.46107784431137,Transport
2406,0,2019-01-11,140278,Activia almond/muesli/chia 170g FR-copac,0,0,0,ACTIVIA,1,Roumanie(RO),0082,0024 FR VALLET (DC),274,334,207,142,65,192,127,0,60,-21.8978102189781,47,38,4,3,1,35,34,0,-9,19.148936170212767,10.526315789473683,7.894736842105263,2.6315789473684204,61.97604790419161,42.51497005988024,19.46107784431137,Transport
2407,0,2019-01-11,140278,Activia almond/muesli/chia 170g FR-copac,0,0,0,ACTIVIA,1,Roumanie(RO),0077,0024 FR LILPARK (DC),274,334,207,142,65,192,127,0,60,-21.8978102189781,34,44,1,1,0,43,43,0,10,-29.41176470588235,2.272727272727273,2.272727272727273,0.0,61.97604790419161,42.51497005988024,19.46107784431137,Transport
2408,0,2019-01-11,140278,Activia almond/muesli/chia 170g FR-copac,0,0,0,ACTIVIA,1,Roumanie(RO),0085,0024 FR TOULOUSE (DC),274,334,207,142,65,192,127,0,60,-21.8978102189781,4,30,30,30,0,0,0,0,26,-650.0,100.0,100.0,0.0,61.97604790419161,42.51497005988024,19.46107784431137,Transport
2409,0,2019-01-11,140278,Activia almond/muesli/chia 170g FR-copac,0,0,0,ACTIVIA,1,Roumanie(RO),0083,0024 FR CHAPONNAY (DC),274,334,207,142,65,192,127,0,60,-21.8978102189781,51,43,43,43,0,0,0,0,-8,15.686274509803921,100.0,100.0,0.0,61.97604790419161,42.51497005988024,19.46107784431137,Transport
2410,0,2019-01-11,140278,Activia almond/muesli/chia 170g FR-copac,0,0,0,ACTIVIA,1,Roumanie(RO),0079,0024 FR PARIS SUD (DC),274,334,207,142,65,192,127,0,60,-21.8978102189781,87,64,63,0,63,64,1,0,-23,26.436781609195403,98.4375,0.0,98.4375,61.97604790419161,42.51497005988024,19.46107784431137,Transport
2411,0,2019-01-12,120170,VELOUTE FRUIX PANACHE 125X12,0,0,0,VELOUTE,0,Villecomtal(FR),0084,0024 FR AIX (DC),2311,1867,1768,1768,0,99,99,0,-444,19.21246213760277,154,106,101,101,0,5,5,0,-48,31.16883116883117,95.28301886792453,95.28301886792453,0.0,94.69737546866631,94.69737546866631,0.0,Déploiement/Quarantaine
2412,0,2019-01-12,120170,VELOUTE FRUIX PANACHE 125X12,0,0,0,VELOUTE,0,Villecomtal(FR),0080,0024 FR METZ (DC),2311,1867,1768,1768,0,99,99,0,-444,19.21246213760277,122,96,95,95,0,1,1,0,-26,21.311475409836067,98.95833333333334,98.95833333333334,0.0,94.69737546866631,94.69737546866631,0.0,Déploiement/Quarantaine
2413,0,2019-01-12,120170,VELOUTE FRUIX PANACHE 125X12,0,0,0,VELOUTE,0,Villecomtal(FR),0081,0024 FR TOURS (DC),2311,1867,1768,1768,0,99,99,0,-444,19.21246213760277,399,305,302,302,0,3,3,0,-94,23.55889724310777,99.01639344262296,99.01639344262296,0.0,94.69737546866631,94.69737546866631,0.0,Déploiement/Quarantaine
2414,0,2019-01-12,120170,VELOUTE FRUIX PANACHE 125X12,0,0,0,VELOUTE,0,Villecomtal(FR),0082,0024 FR VALLET (DC),2311,1867,1768,1768,0,99,99,0,-444,19.21246213760277,221,201,123,123,0,78,78,0,-20,9.049773755656108,61.19402985074627,61.19402985074627,0.0,94.69737546866631,94.69737546866631,0.0,Déploiement/Quarantaine
2415,0,2019-01-12,120170,VELOUTE FRUIX PANACHE 125X12,0,0,0,VELOUTE,0,Villecomtal(FR),0077,0024 FR LILPARK (DC),2311,1867,1768,1768,0,99,99,0,-444,19.21246213760277,144,108,103,103,0,5,5,0,-36,25.0,95.37037037037037,95.37037037037037,0.0,94.69737546866631,94.69737546866631,0.0,Déploiement/Quarantaine
2416,0,2019-01-12,120170,VELOUTE FRUIX PANACHE 125X12,0,0,0,VELOUTE,0,Villecomtal(FR),0085,0024 FR TOULOUSE (DC),2311,1867,1768,1768,0,99,99,0,-444,19.21246213760277,248,213,212,212,0,1,1,0,-35,14.112903225806452,99.53051643192488,99.53051643192488,0.0,94.69737546866631,94.69737546866631,0.0,Déploiement/Quarantaine
2417,0,2019-01-12,120170,VELOUTE FRUIX PANACHE 125X12,0,0,0,VELOUTE,0,Villecomtal(FR),0083,0024 FR CHAPONNAY (DC),2311,1867,1768,1768,0,99,99,0,-444,19.21246213760277,435,314,313,313,0,1,1,0,-121,27.816091954022987,99.68152866242038,99.68152866242038,0.0,94.69737546866631,94.69737546866631,0.0,Déploiement/Quarantaine
2418,0,2019-01-12,120170,VELOUTE FRUIX PANACHE 125X12,0,0,0,VELOUTE,0,Villecomtal(FR),0079,0024 FR PARIS SUD (DC),2311,1867,1768,1768,0,99,99,0,-444,19.21246213760277,350,298,298,298,0,0,0,0,-52,14.857142857142858,100.0,100.0,0.0,94.69737546866631,94.69737546866631,0.0,Déploiement/Quarantaine
2419,0,2019-01-12,120170,VELOUTE FRUIX PANACHE 125X12,0,0,0,VELOUTE,0,Villecomtal(FR),0078,0024 FR PARIS NORD (DC),2311,1867,1768,1768,0,99,99,0,-444,19.21246213760277,238,226,221,221,0,5,5,0,-12,5.042016806722689,97.78761061946902,97.78761061946902,0.0,94.69737546866631,94.69737546866631,0.0,Déploiement/Quarantaine
2420,0,2019-01-12,140278,Activia almond/muesli/chia 170g FR-copac,0,0,0,ACTIVIA,1,Roumanie(RO),0080,0024 FR METZ (DC),269,414,414,120,294,294,0,0,145,-53.90334572490706,8,16,16,16,0,0,0,0,8,-100.0,100.0,100.0,0.0,100.0,28.985507246376812,71.01449275362319,Transport
2421,0,2019-01-12,140278,Activia almond/muesli/chia 170g FR-copac,0,0,0,ACTIVIA,1,Roumanie(RO),0081,0024 FR TOURS (DC),269,414,414,120,294,294,0,0,145,-53.90334572490706,43,55,55,0,55,55,0,0,12,-27.906976744186046,100.0,0.0,100.0,100.0,28.985507246376812,71.01449275362319,Transport
2422,0,2019-01-12,140278,Activia almond/muesli/chia 170g FR-copac,0,0,0,ACTIVIA,1,Roumanie(RO),0082,0024 FR VALLET (DC),269,414,414,120,294,294,0,0,145,-53.90334572490706,40,42,42,42,0,0,0,0,2,-5.0,100.0,100.0,0.0,100.0,28.985507246376812,71.01449275362319,Transport
2423,0,2019-01-12,140278,Activia almond/muesli/chia 170g FR-copac,0,0,0,ACTIVIA,1,Roumanie(RO),0077,0024 FR LILPARK (DC),269,414,414,120,294,294,0,0,145,-53.90334572490706,17,7,7,0,7,7,0,0,-10,58.8235294117647,100.0,0.0,100.0,100.0,28.985507246376812,71.01449275362319,Transport
2424,0,2019-01-12,140278,Activia almond/muesli/chia 170g FR-copac,0,0,0,ACTIVIA,1,Roumanie(RO),0085,0024 FR TOULOUSE (DC),269,414,414,120,294,294,0,0,145,-53.90334572490706,34,45,45,21,24,24,0,0,11,-32.35294117647059,100.0,46.666666666666664,53.333333333333336,100.0,28.985507246376812,71.01449275362319,Transport
2425,0,2019-01-12,140278,Activia almond/muesli/chia 170g FR-copac,0,0,0,ACTIVIA,1,Roumanie(RO),0083,0024 FR CHAPONNAY (DC),269,414,414,120,294,294,0,0,145,-53.90334572490706,45,42,42,41,1,1,0,0,-3,6.666666666666667,100.0,97.61904761904762,2.3809523809523796,100.0,28.985507246376812,71.01449275362319,Transport
2426,0,2019-01-12,140278,Activia almond/muesli/chia 170g FR-copac,0,0,0,ACTIVIA,1,Roumanie(RO),0079,0024 FR PARIS SUD (DC),269,414,414,120,294,294,0,0,145,-53.90334572490706,52,66,66,0,66,66,0,0,14,-26.923076923076923,100.0,0.0,100.0,100.0,28.985507246376812,71.01449275362319,Transport
2427,0,2019-01-12,140278,Activia almond/muesli/chia 170g FR-copac,0,0,0,ACTIVIA,1,Roumanie(RO),0078,0024 FR PARIS NORD (DC),269,414,414,120,294,294,0,0,145,-53.90334572490706,30,95,95,0,95,95,0,0,65,-216.66666666666666,100.0,0.0,100.0,100.0,28.985507246376812,71.01449275362319,Transport
2428,0,2019-01-12,140280,Activia chia/raspb/muesli 170g FR-copack,0,0,0,ACTIVIA,1,Roumanie(RO),0080,0024 FR METZ (DC),355,565,504,356,148,209,61,0,210,-59.15492957746479,30,22,21,21,0,1,1,0,-8,26.666666666666668,95.45454545454545,95.45454545454545,0.0,89.20353982300885,63.008849557522126,26.194690265486727,Transport
2429,0,2019-01-12,140280,Activia chia/raspb/muesli 170g FR-copack,0,0,0,ACTIVIA,1,Roumanie(RO),0081,0024 FR TOURS (DC),355,565,504,356,148,209,61,0,210,-59.15492957746479,51,70,62,62,0,8,8,0,19,-37.254901960784316,88.57142857142857,88.57142857142857,0.0,89.20353982300885,63.008849557522126,26.194690265486727,Transport
2430,0,2019-01-12,140280,Activia chia/raspb/muesli 170g FR-copack,0,0,0,ACTIVIA,1,Roumanie(RO),0082,0024 FR VALLET (DC),355,565,504,356,148,209,61,0,210,-59.15492957746479,54,82,73,73,0,9,9,0,28,-51.851851851851855,89.02439024390245,89.02439024390245,0.0,89.20353982300885,63.008849557522126,26.194690265486727,Transport
2431,0,2019-01-12,140280,Activia chia/raspb/muesli 170g FR-copack,0,0,0,ACTIVIA,1,Roumanie(RO),0077,0024 FR LILPARK (DC),355,565,504,356,148,209,61,0,210,-59.15492957746479,38,21,19,5,14,16,2,0,-17,44.73684210526316,90.47619047619048,23.809523809523807,66.66666666666667,89.20353982300885,63.008849557522126,26.194690265486727,Transport
2432,0,2019-01-12,140280,Activia chia/raspb/muesli 170g FR-copack,0,0,0,ACTIVIA,1,Roumanie(RO),0085,0024 FR TOULOUSE (DC),355,565,504,356,148,209,61,0,210,-59.15492957746479,56,55,54,40,14,15,1,0,-1,1.7857142857142858,98.18181818181819,72.72727272727273,25.454545454545453,89.20353982300885,63.008849557522126,26.194690265486727,Transport
2433,0,2019-01-12,140280,Activia chia/raspb/muesli 170g FR-copack,0,0,0,ACTIVIA,1,Roumanie(RO),0083,0024 FR CHAPONNAY (DC),355,565,504,356,148,209,61,0,210,-59.15492957746479,71,83,72,72,0,11,11,0,12,-16.901408450704224,86.74698795180723,86.74698795180723,0.0,89.20353982300885,63.008849557522126,26.194690265486727,Transport
2434,0,2019-01-12,140280,Activia chia/raspb/muesli 170g FR-copack,0,0,0,ACTIVIA,1,Roumanie(RO),0079,0024 FR PARIS SUD (DC),355,565,504,356,148,209,61,0,210,-59.15492957746479,50,84,65,45,20,39,19,0,34,-68.0,77.38095238095238,53.57142857142857,23.80952380952381,89.20353982300885,63.008849557522126,26.194690265486727,Transport
2435,0,2019-01-12,140280,Activia chia/raspb/muesli 170g FR-copack,0,0,0,ACTIVIA,1,Roumanie(RO),0078,0024 FR PARIS NORD (DC),355,565,504,356,148,209,61,0,210,-59.15492957746479,5,106,100,0,100,106,6,0,101,-2020.0,94.33962264150944,0.0,94.33962264150944,89.20353982300885,63.008849557522126,26.194690265486727,Transport
2436,0,2019-01-14,120170,VELOUTE FRUIX PANACHE 125X12,0,0,0,VELOUTE,0,Villecomtal(FR),0084,0024 FR AIX (DC),2794,2265,2130,2011,119,254,135,0,-529,18.93342877594846,229,152,152,152,0,0,0,0,-77,33.624454148471614,100.0,100.0,0.0,94.03973509933775,88.78587196467991,5.253863134657834,Previsions
2437,0,2019-01-14,120170,VELOUTE FRUIX PANACHE 125X12,0,0,0,VELOUTE,0,Villecomtal(FR),0080,0024 FR METZ (DC),2794,2265,2130,2011,119,254,135,0,-529,18.93342877594846,345,291,291,291,0,0,0,0,-54,15.652173913043478,100.0,100.0,0.0,94.03973509933775,88.78587196467991,5.253863134657834,Previsions
2438,0,2019-01-14,120170,VELOUTE FRUIX PANACHE 125X12,0,0,0,VELOUTE,0,Villecomtal(FR),0081,0024 FR TOURS (DC),2794,2265,2130,2011,119,254,135,0,-529,18.93342877594846,284,248,248,248,0,0,0,0,-36,12.67605633802817,100.0,100.0,0.0,94.03973509933775,88.78587196467991,5.253863134657834,Previsions
2439,0,2019-01-14,120170,VELOUTE FRUIX PANACHE 125X12,0,0,0,VELOUTE,0,Villecomtal(FR),0082,0024 FR VALLET (DC),2794,2265,2130,2011,119,254,135,0,-529,18.93342877594846,149,191,129,10,119,181,62,0,42,-28.187919463087248,67.5392670157068,5.2356020942408374,62.30366492146596,94.03973509933775,88.78587196467991,5.253863134657834,Previsions
2440,0,2019-01-14,120170,VELOUTE FRUIX PANACHE 125X12,0,0,0,VELOUTE,0,Villecomtal(FR),0077,0024 FR LILPARK (DC),2794,2265,2130,2011,119,254,135,0,-529,18.93342877594846,10,57,43,43,0,14,14,0,47,-470.0,75.43859649122807,75.43859649122807,0.0,94.03973509933775,88.78587196467991,5.253863134657834,Previsions
2441,0,2019-01-14,120170,VELOUTE FRUIX PANACHE 125X12,0,0,0,VELOUTE,0,Villecomtal(FR),0085,0024 FR TOULOUSE (DC),2794,2265,2130,2011,119,254,135,0,-529,18.93342877594846,549,472,472,472,0,0,0,0,-77,14.025500910746812,100.0,100.0,0.0,94.03973509933775,88.78587196467991,5.253863134657834,Previsions
2442,0,2019-01-14,120170,VELOUTE FRUIX PANACHE 125X12,0,0,0,VELOUTE,0,Villecomtal(FR),0083,0024 FR CHAPONNAY (DC),2794,2265,2130,2011,119,254,135,0,-529,18.93342877594846,390,371,371,371,0,0,0,0,-19,4.871794871794871,100.0,100.0,0.0,94.03973509933775,88.78587196467991,5.253863134657834,Previsions
2443,0,2019-01-14,120170,VELOUTE FRUIX PANACHE 125X12,0,0,0,VELOUTE,0,Villecomtal(FR),0079,0024 FR PARIS SUD (DC),2794,2265,2130,2011,119,254,135,0,-529,18.93342877594846,559,303,271,271,0,32,32,0,-256,45.796064400715565,89.43894389438944,89.43894389438944,0.0,94.03973509933775,88.78587196467991,5.253863134657834,Previsions
2444,0,2019-01-14,120170,VELOUTE FRUIX PANACHE 125X12,0,0,0,VELOUTE,0,Villecomtal(FR),0078,0024 FR PARIS NORD (DC),2794,2265,2130,2011,119,254,135,0,-529,18.93342877594846,279,180,153,153,0,27,27,0,-99,35.483870967741936,85.0,85.0,0.0,94.03973509933775,88.78587196467991,5.253863134657834,Previsions
2445,0,2019-01-14,140278,Activia almond/muesli/chia 170g FR-copac,0,0,0,ACTIVIA,1,Roumanie(RO),0084,0024 FR AIX (DC),560,662,482,256,226,406,180,0,102,-18.214285714285715,82,79,75,0,75,79,4,0,-3,3.658536585365854,94.9367088607595,0.0,94.9367088607595,72.80966767371602,38.670694864048336,34.138972809667685,Transport
2446,0,2019-01-14,140278,Activia almond/muesli/chia 170g FR-copac,0,0,0,ACTIVIA,1,Roumanie(RO),0080,0024 FR METZ (DC),560,662,482,256,226,406,180,0,102,-18.214285714285715,57,78,36,34,2,44,42,0,21,-36.8421052631579,46.15384615384615,43.58974358974359,2.564102564102562,72.80966767371602,38.670694864048336,34.138972809667685,Transport
2447,0,2019-01-14,140278,Activia almond/muesli/chia 170g FR-copac,0,0,0,ACTIVIA,1,Roumanie(RO),0081,0024 FR TOURS (DC),560,662,482,256,226,406,180,0,102,-18.214285714285715,75,50,3,0,3,50,47,0,-25,33.333333333333336,6.0,0.0,6.0,72.80966767371602,38.670694864048336,34.138972809667685,Transport
2448,0,2019-01-14,140278,Activia almond/muesli/chia 170g FR-copac,0,0,0,ACTIVIA,1,Roumanie(RO),0082,0024 FR VALLET (DC),560,662,482,256,226,406,180,0,102,-18.214285714285715,46,50,6,5,1,45,44,0,4,-8.695652173913043,12.0,10.0,2.0,72.80966767371602,38.670694864048336,34.138972809667685,Transport
2449,0,2019-01-14,140278,Activia almond/muesli/chia 170g FR-copac,0,0,0,ACTIVIA,1,Roumanie(RO),0077,0024 FR LILPARK (DC),560,662,482,256,226,406,180,0,102,-18.214285714285715,24,33,33,0,33,33,0,0,9,-37.5,100.0,0.0,100.0,72.80966767371602,38.670694864048336,34.138972809667685,Transport
2450,0,2019-01-14,140278,Activia almond/muesli/chia 170g FR-copac,0,0,0,ACTIVIA,1,Roumanie(RO),0085,0024 FR TOULOUSE (DC),560,662,482,256,226,406,180,0,102,-18.214285714285715,68,46,46,8,38,38,0,0,-22,32.35294117647059,100.0,17.391304347826086,82.6086956521739,72.80966767371602,38.670694864048336,34.138972809667685,Transport
2451,0,2019-01-14,140278,Activia almond/muesli/chia 170g FR-copac,0,0,0,ACTIVIA,1,Roumanie(RO),0083,0024 FR CHAPONNAY (DC),560,662,482,256,226,406,180,0,102,-18.214285714285715,42,54,49,49,0,5,5,0,12,-28.571428571428573,90.74074074074075,90.74074074074075,0.0,72.80966767371602,38.670694864048336,34.138972809667685,Transport
2452,0,2019-01-14,140278,Activia almond/muesli/chia 170g FR-copac,0,0,0,ACTIVIA,1,Roumanie(RO),0079,0024 FR PARIS SUD (DC),560,662,482,256,226,406,180,0,102,-18.214285714285715,84,72,48,0,48,72,24,0,-12,14.285714285714286,66.66666666666666,0.0,66.66666666666666,72.80966767371602,38.670694864048336,34.138972809667685,Transport
2453,0,2019-01-14,140278,Activia almond/muesli/chia 170g FR-copac,0,0,0,ACTIVIA,1,Roumanie(RO),0078,0024 FR PARIS NORD (DC),560,662,482,256,226,406,180,0,102,-18.214285714285715,82,200,186,160,26,40,14,0,118,-143.90243902439025,93.0,80.0,13.0,72.80966767371602,38.670694864048336,34.138972809667685,Transport
2454,0,2019-01-15,121321,ACTIMEL MULTI 3x(8x100g) FR,0,0,0,ACTIMEL,1,Rotselaar(BE),0084,0024 FR AIX (DC),2197,1863,1691,1688,3,175,172,0,-334,15.202548930359582,211,133,133,133,0,0,0,0,-78,36.96682464454976,100.0,100.0,0.0,90.76757917337628,90.60654857756307,0.16103059581320167,Previsions
2455,0,2019-01-15,121321,ACTIMEL MULTI 3x(8x100g) FR,0,0,0,ACTIMEL,1,Rotselaar(BE),0080,0024 FR METZ (DC),2197,1863,1691,1688,3,175,172,0,-334,15.202548930359582,155,145,97,97,0,48,48,0,-10,6.451612903225806,66.89655172413794,66.89655172413794,0.0,90.76757917337628,90.60654857756307,0.16103059581320167,Previsions
2456,0,2019-01-15,121321,ACTIMEL MULTI 3x(8x100g) FR,0,0,0,ACTIMEL,1,Rotselaar(BE),0081,0024 FR TOURS (DC),2197,1863,1691,1688,3,175,172,0,-334,15.202548930359582,287,199,133,132,1,67,66,0,-88,30.662020905923345,66.83417085427136,66.33165829145729,0.5025125628140756,90.76757917337628,90.60654857756307,0.16103059581320167,Previsions
2457,0,2019-01-15,121321,ACTIMEL MULTI 3x(8x100g) FR,0,0,0,ACTIMEL,1,Rotselaar(BE),0082,0024 FR VALLET (DC),2197,1863,1691,1688,3,175,172,0,-334,15.202548930359582,198,145,145,145,0,0,0,0,-53,26.767676767676768,100.0,100.0,0.0,90.76757917337628,90.60654857756307,0.16103059581320167,Previsions
2458,0,2019-01-15,121321,ACTIMEL MULTI 3x(8x100g) FR,0,0,0,ACTIMEL,1,Rotselaar(BE),0077,0024 FR LILPARK (DC),2197,1863,1691,1688,3,175,172,0,-334,15.202548930359582,177,187,171,169,2,18,16,0,10,-5.649717514124294,91.44385026737967,90.37433155080214,1.0695187165775337,90.76757917337628,90.60654857756307,0.16103059581320167,Previsions
2459,0,2019-01-15,121321,ACTIMEL MULTI 3x(8x100g) FR,0,0,0,ACTIMEL,1,Rotselaar(BE),0085,0024 FR TOULOUSE (DC),2197,1863,1691,1688,3,175,172,0,-334,15.202548930359582,183,132,90,90,0,42,42,0,-51,27.868852459016395,68.18181818181817,68.18181818181817,0.0,90.76757917337628,90.60654857756307,0.16103059581320167,Previsions
2460,0,2019-01-15,121321,ACTIMEL MULTI 3x(8x100g) FR,0,0,0,ACTIMEL,1,Rotselaar(BE),0083,0024 FR CHAPONNAY (DC),2197,1863,1691,1688,3,175,172,0,-334,15.202548930359582,301,248,248,248,0,0,0,0,-53,17.60797342192691,100.0,100.0,0.0,90.76757917337628,90.60654857756307,0.16103059581320167,Previsions
2461,0,2019-01-15,121321,ACTIMEL MULTI 3x(8x100g) FR,0,0,0,ACTIMEL,1,Rotselaar(BE),0079,0024 FR PARIS SUD (DC),2197,1863,1691,1688,3,175,172,0,-334,15.202548930359582,473,381,381,381,0,0,0,0,-92,19.45031712473573,100.0,100.0,0.0,90.76757917337628,90.60654857756307,0.16103059581320167,Previsions
2462,0,2019-01-15,121321,ACTIMEL MULTI 3x(8x100g) FR,0,0,0,ACTIMEL,1,Rotselaar(BE),0078,0024 FR PARIS NORD (DC),2197,1863,1691,1688,3,175,172,0,-334,15.202548930359582,212,293,293,293,0,0,0,0,81,-38.20754716981132,100.0,100.0,0.0,90.76757917337628,90.60654857756307,0.16103059581320167,Previsions
2463,1,2019-01-15,121459,DANETTE DS CHO CAR 125X4 P CHOC,0,0,0,DANETTE,0,StJust(FR),0078,0024 FR PARIS NORD (DC),171,1142,1142,995,147,147,0,0,971,-567.8362573099415,171,201,201,54,147,147,0,0,30,-17.54385964912281,100.0,26.865671641791046,73.13432835820896,100.0,87.12784588441332,12.872154115586682,Déploiement/Quarantaine
2464,0,2019-01-15,132239,DANET CARAMEL SALE 125X4 PCHOC,1,0,0,DANETTE,0,StJust(FR),0084,0024 FR AIX (DC),1470,1343,1258,997,261,346,85,0,-127,8.639455782312925,61,34,4,4,0,30,30,0,-27,44.26229508196721,11.76470588235294,11.76470588235294,0.0,93.67088607594937,74.23678332092331,19.43410275502606,Previsions
2465,0,2019-01-15,132239,DANET CARAMEL SALE 125X4 PCHOC,1,0,0,DANETTE,0,StJust(FR),0080,0024 FR METZ (DC),1470,1343,1258,997,261,346,85,0,-127,8.639455782312925,171,119,119,119,0,0,0,0,-52,30.4093567251462,100.0,100.0,0.0,93.67088607594937,74.23678332092331,19.43410275502606,Previsions
2466,0,2019-01-15,132239,DANET CARAMEL SALE 125X4 PCHOC,1,0,0,DANETTE,0,StJust(FR),0081,0024 FR TOURS (DC),1470,1343,1258,997,261,346,85,0,-127,8.639455782312925,139,325,325,325,0,0,0,0,186,-133.81294964028777,100.0,100.0,0.0,93.67088607594937,74.23678332092331,19.43410275502606,Previsions
2467,0,2019-01-15,132239,DANET CARAMEL SALE 125X4 PCHOC,1,0,0,DANETTE,0,StJust(FR),0082,0024 FR VALLET (DC),1470,1343,1258,997,261,346,85,0,-127,8.639455782312925,53,133,133,133,0,0,0,0,80,-150.9433962264151,100.0,100.0,0.0,93.67088607594937,74.23678332092331,19.43410275502606,Previsions
2468,0,2019-01-15,132239,DANET CARAMEL SALE 125X4 PCHOC,1,0,0,DANETTE,0,StJust(FR),0077,0024 FR LILPARK (DC),1470,1343,1258,997,261,346,85,0,-127,8.639455782312925,236,227,172,11,161,216,55,0,-9,3.8135593220338984,75.77092511013215,4.845814977973569,70.92511013215858,93.67088607594937,74.23678332092331,19.43410275502606,Previsions
2469,1,2019-01-15,132239,DANET CARAMEL SALE 125X4 PCHOC,1,0,0,DANETTE,0,StJust(FR),0077,0024 FR LILPARK (DC),1470,1343,1258,997,261,346,85,0,-127,8.639455782312925,236,227,172,11,161,216,55,0,-9,3.8135593220338984,75.77092511013215,4.845814977973569,70.92511013215858,93.67088607594937,74.23678332092331,19.43410275502606,Previsions
2470,0,2019-01-15,132239,DANET CARAMEL SALE 125X4 PCHOC,1,0,0,DANETTE,0,StJust(FR),0085,0024 FR TOULOUSE (DC),1470,1343,1258,997,261,346,85,0,-127,8.639455782312925,48,78,78,78,0,0,0,0,30,-62.5,100.0,100.0,0.0,93.67088607594937,74.23678332092331,19.43410275502606,Previsions
2471,0,2019-01-15,132239,DANET CARAMEL SALE 125X4 PCHOC,1,0,0,DANETTE,0,StJust(FR),0083,0024 FR CHAPONNAY (DC),1470,1343,1258,997,261,346,85,0,-127,8.639455782312925,12,147,147,147,0,0,0,0,135,-1125.0,100.0,100.0,0.0,93.67088607594937,74.23678332092331,19.43410275502606,Previsions
2472,0,2019-01-15,132239,DANET CARAMEL SALE 125X4 PCHOC,1,0,0,DANETTE,0,StJust(FR),0079,0024 FR PARIS SUD (DC),1470,1343,1258,997,261,346,85,0,-127,8.639455782312925,162,113,113,113,0,0,0,0,-49,30.246913580246915,100.0,100.0,0.0,93.67088607594937,74.23678332092331,19.43410275502606,Previsions
2473,0,2019-01-15,132239,DANET CARAMEL SALE 125X4 PCHOC,1,0,0,DANETTE,0,StJust(FR),0078,0024 FR PARIS NORD (DC),1470,1343,1258,997,261,346,85,0,-127,8.639455782312925,176,167,167,67,100,100,0,0,-9,5.113636363636363,100.0,40.119760479041915,59.880239520958085,93.67088607594937,74.23678332092331,19.43410275502606,Previsions
2474,1,2019-01-15,132239,DANET CARAMEL SALE 125X4 PCHOC,1,0,0,DANETTE,0,StJust(FR),0078,0024 FR PARIS NORD (DC),1470,1343,1258,997,261,346,85,0,-127,8.639455782312925,176,167,167,67,100,100,0,0,-9,5.113636363636363,100.0,40.119760479041915,59.880239520958085,93.67088607594937,74.23678332092331,19.43410275502606,Previsions
2475,1,2019-01-16,115026,FJORD NATURE 125GX8 OPL,1,0,0,FJORD,0,LeMolay(FR),0085,0024 FR TOULOUSE (DC),1036,4312,4310,4010,300,302,2,0,3276,-316.2162162162162,1036,738,738,438,300,300,0,0,-298,28.764478764478763,100.0,59.34959349593496,40.65040650406504,99.95361781076066,92.99628942486086,6.9573283858998,A Creuser
2476,0,2019-01-16,127911,GERVAIS GRIEGO 115X4 VANILLA FR,0,0,0,GERVAIS,1,Rosenheim(ALL),0084,0024 FR AIX (DC),1721,1654,707,685,22,969,947,0,-67,3.89308541545613,247,272,41,41,0,231,231,0,25,-10.121457489878543,15.073529411764705,15.073529411764705,0.0,42.74486094316808,41.41475211608223,1.3301088270858514,Schéma
2477,0,2019-01-16,127911,GERVAIS GRIEGO 115X4 VANILLA FR,0,0,0,GERVAIS,1,Rosenheim(ALL),0080,0024 FR METZ (DC),1721,1654,707,685,22,969,947,0,-67,3.89308541545613,186,170,6,2,4,168,164,0,-16,8.602150537634408,3.5294117647058822,1.1764705882352942,2.352941176470588,42.74486094316808,41.41475211608223,1.3301088270858514,Schéma
2478,0,2019-01-16,127911,GERVAIS GRIEGO 115X4 VANILLA FR,0,0,0,GERVAIS,1,Rosenheim(ALL),0081,0024 FR TOURS (DC),1721,1654,707,685,22,969,947,0,-67,3.89308541545613,189,163,8,1,7,162,155,0,-26,13.756613756613756,4.9079754601226995,0.6134969325153374,4.294478527607362,42.74486094316808,41.41475211608223,1.3301088270858514,Schéma
2479,0,2019-01-16,127911,GERVAIS GRIEGO 115X4 VANILLA FR,0,0,0,GERVAIS,1,Rosenheim(ALL),0082,0024 FR VALLET (DC),1721,1654,707,685,22,969,947,0,-67,3.89308541545613,175,140,140,137,3,3,0,0,-35,20.0,100.0,97.85714285714285,2.142857142857153,42.74486094316808,41.41475211608223,1.3301088270858514,Schéma
2480,0,2019-01-16,127911,GERVAIS GRIEGO 115X4 VANILLA FR,0,0,0,GERVAIS,1,Rosenheim(ALL),0077,0024 FR LILPARK (DC),1721,1654,707,685,22,969,947,0,-67,3.89308541545613,95,93,8,0,8,93,85,0,-2,2.1052631578947367,8.60215053763441,0.0,8.60215053763441,42.74486094316808,41.41475211608223,1.3301088270858514,Schéma
2481,0,2019-01-16,127911,GERVAIS GRIEGO 115X4 VANILLA FR,0,0,0,GERVAIS,1,Rosenheim(ALL),0085,0024 FR TOULOUSE (DC),1721,1654,707,685,22,969,947,0,-67,3.89308541545613,322,249,68,68,0,181,181,0,-73,22.67080745341615,27.309236947791167,27.309236947791167,0.0,42.74486094316808,41.41475211608223,1.3301088270858514,Schéma
2482,0,2019-01-16,127911,GERVAIS GRIEGO 115X4 VANILLA FR,0,0,0,GERVAIS,1,Rosenheim(ALL),0083,0024 FR CHAPONNAY (DC),1721,1654,707,685,22,969,947,0,-67,3.89308541545613,233,192,192,192,0,0,0,0,-41,17.59656652360515,100.0,100.0,0.0,42.74486094316808,41.41475211608223,1.3301088270858514,Schéma
2483,0,2019-01-16,127911,GERVAIS GRIEGO 115X4 VANILLA FR,0,0,0,GERVAIS,1,Rosenheim(ALL),0079,0024 FR PARIS SUD (DC),1721,1654,707,685,22,969,947,0,-67,3.89308541545613,25,207,86,86,0,121,121,0,182,-728.0,41.54589371980676,41.54589371980676,0.0,42.74486094316808,41.41475211608223,1.3301088270858514,Schéma
2484,0,2019-01-16,127911,GERVAIS GRIEGO 115X4 VANILLA FR,0,0,0,GERVAIS,1,Rosenheim(ALL),0078,0024 FR PARIS NORD (DC),1721,1654,707,685,22,969,947,0,-67,3.89308541545613,249,168,158,158,0,10,10,0,-81,32.53012048192771,94.04761904761905,94.04761904761905,0.0,42.74486094316808,41.41475211608223,1.3301088270858514,Schéma
2485,1,2019-01-16,131479,ACTIVIA FRT MANGO 125X4 OD,1,0,0,ACTIVIA,0,Villecomtal(FR),0085,0024 FR TOULOUSE (DC),30,1486,1475,1385,90,101,11,0,1456,-4853.333333333333,30,186,186,96,90,90,0,0,156,-520.0,100.0,51.61290322580645,48.38709677419355,99.25975773889637,93.20323014804845,6.056527590847921,A Creuser
2486,0,2019-01-17,79537,LES 2 VACHES FLAN BIO 100X4,0,0,0,LES 2 VACHES,0,LeMolay(FR),0084,0024 FR AIX (DC),886,1825,1179,1179,0,646,646,0,939,-105.98194130925508,178,523,2,2,0,521,521,0,345,-193.82022471910113,0.3824091778202677,0.3824091778202677,0.0,64.60273972602741,64.60273972602741,0.0,Previsions
2487,0,2019-01-17,79537,LES 2 VACHES FLAN BIO 100X4,0,0,0,LES 2 VACHES,0,LeMolay(FR),0080,0024 FR METZ (DC),886,1825,1179,1179,0,646,646,0,939,-105.98194130925508,119,75,75,75,0,0,0,0,-44,36.97478991596638,100.0,100.0,0.0,64.60273972602741,64.60273972602741,0.0,Previsions
2488,0,2019-01-17,79537,LES 2 VACHES FLAN BIO 100X4,0,0,0,LES 2 VACHES,0,LeMolay(FR),0081,0024 FR TOURS (DC),886,1825,1179,1179,0,646,646,0,939,-105.98194130925508,115,146,146,146,0,0,0,0,31,-26.956521739130434,100.0,100.0,0.0,64.60273972602741,64.60273972602741,0.0,Previsions
2489,0,2019-01-17,79537,LES 2 VACHES FLAN BIO 100X4,0,0,0,LES 2 VACHES,0,LeMolay(FR),0077,0024 FR LILPARK (DC),886,1825,1179,1179,0,646,646,0,939,-105.98194130925508,5,33,33,33,0,0,0,0,28,-560.0,100.0,100.0,0.0,64.60273972602741,64.60273972602741,0.0,Previsions
2490,0,2019-01-17,79537,LES 2 VACHES FLAN BIO 100X4,0,0,0,LES 2 VACHES,0,LeMolay(FR),0085,0024 FR TOULOUSE (DC),886,1825,1179,1179,0,646,646,0,939,-105.98194130925508,105,100,96,96,0,4,4,0,-5,4.761904761904762,96.0,96.0,0.0,64.60273972602741,64.60273972602741,0.0,Previsions
2491,0,2019-01-17,79537,LES 2 VACHES FLAN BIO 100X4,0,0,0,LES 2 VACHES,0,LeMolay(FR),0083,0024 FR CHAPONNAY (DC),886,1825,1179,1179,0,646,646,0,939,-105.98194130925508,214,446,321,321,0,125,125,0,232,-108.41121495327103,71.97309417040358,71.97309417040358,0.0,64.60273972602741,64.60273972602741,0.0,Previsions
2492,0,2019-01-17,79537,LES 2 VACHES FLAN BIO 100X4,0,0,0,LES 2 VACHES,0,LeMolay(FR),0079,0024 FR PARIS SUD (DC),886,1825,1179,1179,0,646,646,0,939,-105.98194130925508,28,209,209,209,0,0,0,0,181,-646.4285714285714,100.0,100.0,0.0,64.60273972602741,64.60273972602741,0.0,Previsions
2493,0,2019-01-17,79537,LES 2 VACHES FLAN BIO 100X4,0,0,0,LES 2 VACHES,0,LeMolay(FR),0078,0024 FR PARIS NORD (DC),886,1825,1179,1179,0,646,646,0,939,-105.98194130925508,122,191,191,191,0,0,0,0,69,-56.557377049180324,100.0,100.0,0.0,64.60273972602741,64.60273972602741,0.0,Previsions
2494,0,2019-01-17,127910,GERVAIS GRIEGO 115X4 LEMON FR,0,0,0,GERVAIS,1,Rosenheim(ALL),0084,0024 FR AIX (DC),715,773,446,442,4,331,327,0,58,-8.111888111888112,122,115,59,59,0,56,56,0,-7,5.737704918032787,51.30434782608696,51.30434782608696,0.0,57.69728331177232,57.17981888745148,0.5174644243208348,Client
2495,0,2019-01-17,127910,GERVAIS GRIEGO 115X4 LEMON FR,0,0,0,GERVAIS,1,Rosenheim(ALL),0080,0024 FR METZ (DC),715,773,446,442,4,331,327,0,58,-8.111888111888112,84,75,75,75,0,0,0,0,-9,10.714285714285714,100.0,100.0,0.0,57.69728331177232,57.17981888745148,0.5174644243208348,Client
2496,0,2019-01-17,127910,GERVAIS GRIEGO 115X4 LEMON FR,0,0,0,GERVAIS,1,Rosenheim(ALL),0082,0024 FR VALLET (DC),715,773,446,442,4,331,327,0,58,-8.111888111888112,120,101,43,43,0,58,58,0,-19,15.833333333333334,42.57425742574257,42.57425742574257,0.0,57.69728331177232,57.17981888745148,0.5174644243208348,Client
2497,0,2019-01-17,127910,GERVAIS GRIEGO 115X4 LEMON FR,0,0,0,GERVAIS,1,Rosenheim(ALL),0077,0024 FR LILPARK (DC),715,773,446,442,4,331,327,0,58,-8.111888111888112,135,139,71,71,0,68,68,0,4,-2.962962962962963,51.07913669064749,51.07913669064749,0.0,57.69728331177232,57.17981888745148,0.5174644243208348,Client
2498,0,2019-01-17,127910,GERVAIS GRIEGO 115X4 LEMON FR,0,0,0,GERVAIS,1,Rosenheim(ALL),0085,0024 FR TOULOUSE (DC),715,773,446,442,4,331,327,0,58,-8.111888111888112,155,159,14,10,4,149,145,0,4,-2.5806451612903225,8.80503144654088,6.289308176100629,2.515723270440251,57.69728331177232,57.17981888745148,0.5174644243208348,Client
2499,0,2019-01-17,127910,GERVAIS GRIEGO 115X4 LEMON FR,0,0,0,GERVAIS,1,Rosenheim(ALL),0083,0024 FR CHAPONNAY (DC),715,773,446,442,4,331,327,0,58,-8.111888111888112,14,127,127,127,0,0,0,0,113,-807.1428571428571,100.0,100.0,0.0,57.69728331177232,57.17981888745148,0.5174644243208348,Client
2500,0,2019-01-17,127910,GERVAIS GRIEGO 115X4 LEMON FR,0,0,0,GERVAIS,1,Rosenheim(ALL),0078,0024 FR PARIS NORD (DC),715,773,446,442,4,331,327,0,58,-8.111888111888112,85,57,57,57,0,0,0,0,-28,32.94117647058823,100.0,100.0,0.0,57.69728331177232,57.17981888745148,0.5174644243208348,Client
2501,0,2019-01-18,2118,GERVITA NATUR 100gx4,0,0,0,GERVITA,0,Ferrières(FR),0084,0024 FR AIX (DC),6638,7195,5445,5151,294,2044,1750,0,557,-8.391081651099729,989,1388,1066,849,217,539,322,0,399,-40.343781597573305,76.80115273775216,61.1671469740634,15.634005763688762,75.67755385684504,71.591382904795,4.08617095205004,Production
2502,0,2019-01-18,2118,GERVITA NATUR 100gx4,0,0,0,GERVITA,0,Ferrières(FR),0080,0024 FR METZ (DC),6638,7195,5445,5151,294,2044,1750,0,557,-8.391081651099729,468,300,300,300,0,0,0,0,-168,35.8974358974359,100.0,100.0,0.0,75.67755385684504,71.591382904795,4.08617095205004,Production
2503,0,2019-01-18,2118,GERVITA NATUR 100gx4,0,0,0,GERVITA,0,Ferrières(FR),0081,0024 FR TOURS (DC),6638,7195,5445,5151,294,2044,1750,0,557,-8.391081651099729,867,697,631,631,0,66,66,0,-170,19.607843137254903,90.53084648493544,90.53084648493544,0.0,75.67755385684504,71.591382904795,4.08617095205004,Production
2504,0,2019-01-18,2118,GERVITA NATUR 100gx4,0,0,0,GERVITA,0,Ferrières(FR),0082,0024 FR VALLET (DC),6638,7195,5445,5151,294,2044,1750,0,557,-8.391081651099729,59,392,337,337,0,55,55,0,333,-564.4067796610169,85.96938775510205,85.96938775510205,0.0,75.67755385684504,71.591382904795,4.08617095205004,Production
2505,0,2019-01-18,2118,GERVITA NATUR 100gx4,0,0,0,GERVITA,0,Ferrières(FR),0077,0024 FR LILPARK (DC),6638,7195,5445,5151,294,2044,1750,0,557,-8.391081651099729,422,284,284,284,0,0,0,0,-138,32.70142180094787,100.0,100.0,0.0,75.67755385684504,71.591382904795,4.08617095205004,Production
2506,0,2019-01-18,2118,GERVITA NATUR 100gx4,0,0,0,GERVITA,0,Ferrières(FR),0085,0024 FR TOULOUSE (DC),6638,7195,5445,5151,294,2044,1750,0,557,-8.391081651099729,1081,1095,873,873,0,222,222,0,14,-1.2950971322849214,79.72602739726027,79.72602739726027,0.0,75.67755385684504,71.591382904795,4.08617095205004,Production
2507,0,2019-01-18,2118,GERVITA NATUR 100gx4,0,0,0,GERVITA,0,Ferrières(FR),0083,0024 FR CHAPONNAY (DC),6638,7195,5445,5151,294,2044,1750,0,557,-8.391081651099729,871,1091,795,795,0,296,296,0,220,-25.258323765786454,72.86892758936754,72.86892758936754,0.0,75.67755385684504,71.591382904795,4.08617095205004,Production
2508,0,2019-01-18,2118,GERVITA NATUR 100gx4,0,0,0,GERVITA,0,Ferrières(FR),0079,0024 FR PARIS SUD (DC),6638,7195,5445,5151,294,2044,1750,0,557,-8.391081651099729,1092,1137,882,882,0,255,255,0,45,-4.1208791208791204,77.57255936675462,77.57255936675462,0.0,75.67755385684504,71.591382904795,4.08617095205004,Production
2509,0,2019-01-18,2118,GERVITA NATUR 100gx4,0,0,0,GERVITA,0,Ferrières(FR),0078,0024 FR PARIS NORD (DC),6638,7195,5445,5151,294,2044,1750,0,557,-8.391081651099729,789,811,277,200,77,611,534,0,22,-2.788339670468948,34.1553637484587,24.66091245376079,9.494451294697907,75.67755385684504,71.591382904795,4.08617095205004,Production
2510,0,2019-01-18,32787,TAILLEF CHEESE PEACH 120GX4,0,0,0,TAILLEFINE,0,Ferrières(FR),0084,0024 FR AIX (DC),487,544,365,354,11,190,179,0,57,-11.704312114989733,60,95,91,86,5,9,4,0,35,-58.333333333333336,95.78947368421052,90.52631578947368,5.263157894736835,67.09558823529412,65.07352941176471,2.022058823529406,Previsions
2511,0,2019-01-18,32787,TAILLEF CHEESE PEACH 120GX4,0,0,0,TAILLEFINE,0,Ferrières(FR),0080,0024 FR METZ (DC),487,544,365,354,11,190,179,0,57,-11.704312114989733,56,64,2,1,1,63,62,0,8,-14.285714285714286,3.125,1.5625,1.5625,67.09558823529412,65.07352941176471,2.022058823529406,Previsions
2512,0,2019-01-18,32787,TAILLEF CHEESE PEACH 120GX4,0,0,0,TAILLEFINE,0,Ferrières(FR),0081,0024 FR TOURS (DC),487,544,365,354,11,190,179,0,57,-11.704312114989733,60,50,11,11,0,39,39,0,-10,16.666666666666668,22.0,22.0,0.0,67.09558823529412,65.07352941176471,2.022058823529406,Previsions
2513,0,2019-01-18,32787,TAILLEF CHEESE PEACH 120GX4,0,0,0,TAILLEFINE,0,Ferrières(FR),0082,0024 FR VALLET (DC),487,544,365,354,11,190,179,0,57,-11.704312114989733,61,59,59,59,0,0,0,0,-2,3.278688524590164,100.0,100.0,0.0,67.09558823529412,65.07352941176471,2.022058823529406,Previsions
2514,0,2019-01-18,32787,TAILLEF CHEESE PEACH 120GX4,0,0,0,TAILLEFINE,0,Ferrières(FR),0085,0024 FR TOULOUSE (DC),487,544,365,354,11,190,179,0,57,-11.704312114989733,44,48,48,48,0,0,0,0,4,-9.090909090909092,100.0,100.0,0.0,67.09558823529412,65.07352941176471,2.022058823529406,Previsions
2515,0,2019-01-18,32787,TAILLEF CHEESE PEACH 120GX4,0,0,0,TAILLEFINE,0,Ferrières(FR),0083,0024 FR CHAPONNAY (DC),487,544,365,354,11,190,179,0,57,-11.704312114989733,30,48,48,48,0,0,0,0,18,-60.0,100.0,100.0,0.0,67.09558823529412,65.07352941176471,2.022058823529406,Previsions
2516,0,2019-01-18,32787,TAILLEF CHEESE PEACH 120GX4,0,0,0,TAILLEFINE,0,Ferrières(FR),0079,0024 FR PARIS SUD (DC),487,544,365,354,11,190,179,0,57,-11.704312114989733,85,114,40,35,5,79,74,0,29,-34.11764705882353,35.08771929824561,30.701754385964914,4.385964912280695,67.09558823529412,65.07352941176471,2.022058823529406,Previsions
2517,0,2019-01-18,32787,TAILLEF CHEESE PEACH 120GX4,0,0,0,TAILLEFINE,0,Ferrières(FR),0078,0024 FR PARIS NORD (DC),487,544,365,354,11,190,179,0,57,-11.704312114989733,91,66,66,66,0,0,0,0,-25,27.47252747252747,100.0,100.0,0.0,67.09558823529412,65.07352941176471,2.022058823529406,Previsions
2518,0,2019-01-18,32788,TAILLEF CHEESE VANILLA 120X4,0,0,0,TAILLEFINE,0,Ferrières(FR),0084,0024 FR AIX (DC),2444,2464,1186,1183,3,1281,1278,0,20,-0.8183306055646481,291,408,136,136,0,272,272,0,117,-40.20618556701031,33.33333333333333,33.33333333333333,0.0,48.133116883116884,48.01136363636363,0.12175324675325072,Previsions
2519,0,2019-01-18,32788,TAILLEF CHEESE VANILLA 120X4,0,0,0,TAILLEFINE,0,Ferrières(FR),0080,0024 FR METZ (DC),2444,2464,1186,1183,3,1281,1278,0,20,-0.8183306055646481,177,202,198,198,0,4,4,0,25,-14.124293785310735,98.01980198019803,98.01980198019803,0.0,48.133116883116884,48.01136363636363,0.12175324675325072,Previsions
2520,0,2019-01-18,32788,TAILLEF CHEESE VANILLA 120X4,0,0,0,TAILLEFINE,0,Ferrières(FR),0081,0024 FR TOURS (DC),2444,2464,1186,1183,3,1281,1278,0,20,-0.8183306055646481,231,228,139,139,0,89,89,0,-3,1.2987012987012987,60.96491228070175,60.96491228070175,0.0,48.133116883116884,48.01136363636363,0.12175324675325072,Previsions
2521,0,2019-01-18,32788,TAILLEF CHEESE VANILLA 120X4,0,0,0,TAILLEFINE,0,Ferrières(FR),0082,0024 FR VALLET (DC),2444,2464,1186,1183,3,1281,1278,0,20,-0.8183306055646481,148,169,113,112,1,57,56,0,21,-14.18918918918919,66.86390532544378,66.27218934911244,0.5917159763313435,48.133116883116884,48.01136363636363,0.12175324675325072,Previsions
2522,0,2019-01-18,32788,TAILLEF CHEESE VANILLA 120X4,0,0,0,TAILLEFINE,0,Ferrières(FR),0077,0024 FR LILPARK (DC),2444,2464,1186,1183,3,1281,1278,0,20,-0.8183306055646481,201,197,127,127,0,70,70,0,-4,1.9900497512437811,64.46700507614213,64.46700507614213,0.0,48.133116883116884,48.01136363636363,0.12175324675325072,Previsions
2523,0,2019-01-18,32788,TAILLEF CHEESE VANILLA 120X4,0,0,0,TAILLEFINE,0,Ferrières(FR),0085,0024 FR TOULOUSE (DC),2444,2464,1186,1183,3,1281,1278,0,20,-0.8183306055646481,289,322,112,110,2,212,210,0,33,-11.418685121107266,34.78260869565217,34.161490683229815,0.6211180124223574,48.133116883116884,48.01136363636363,0.12175324675325072,Previsions
2524,0,2019-01-18,32788,TAILLEF CHEESE VANILLA 120X4,0,0,0,TAILLEFINE,0,Ferrières(FR),0083,0024 FR CHAPONNAY (DC),2444,2464,1186,1183,3,1281,1278,0,20,-0.8183306055646481,223,277,127,127,0,150,150,0,54,-24.2152466367713,45.84837545126354,45.84837545126354,0.0,48.133116883116884,48.01136363636363,0.12175324675325072,Previsions
2525,0,2019-01-18,32788,TAILLEF CHEESE VANILLA 120X4,0,0,0,TAILLEFINE,0,Ferrières(FR),0079,0024 FR PARIS SUD (DC),2444,2464,1186,1183,3,1281,1278,0,20,-0.8183306055646481,423,462,86,86,0,376,376,0,39,-9.21985815602837,18.614718614718615,18.614718614718615,0.0,48.133116883116884,48.01136363636363,0.12175324675325072,Previsions
2526,0,2019-01-18,32788,TAILLEF CHEESE VANILLA 120X4,0,0,0,TAILLEFINE,0,Ferrières(FR),0078,0024 FR PARIS NORD (DC),2444,2464,1186,1183,3,1281,1278,0,20,-0.8183306055646481,461,199,148,148,0,51,51,0,-262,56.83297180043384,74.37185929648241,74.37185929648241,0.0,48.133116883116884,48.01136363636363,0.12175324675325072,Previsions
2527,0,2019-01-18,79537,LES 2 VACHES FLAN BIO 100X4,0,0,0,LES 2 VACHES,0,LeMolay(FR),0084,0024 FR AIX (DC),1386,1615,826,795,31,820,789,0,229,-16.52236652236652,194,508,216,215,1,293,292,0,314,-161.8556701030928,42.51968503937008,42.322834645669296,0.19685039370078528,51.14551083591331,49.22600619195047,1.9195046439628456,Previsions
2528,0,2019-01-18,79537,LES 2 VACHES FLAN BIO 100X4,0,0,0,LES 2 VACHES,0,LeMolay(FR),0080,0024 FR METZ (DC),1386,1615,826,795,31,820,789,0,229,-16.52236652236652,11,66,66,66,0,0,0,0,55,-500.0,100.0,100.0,0.0,51.14551083591331,49.22600619195047,1.9195046439628456,Previsions
2529,0,2019-01-18,79537,LES 2 VACHES FLAN BIO 100X4,0,0,0,LES 2 VACHES,0,LeMolay(FR),0081,0024 FR TOURS (DC),1386,1615,826,795,31,820,789,0,229,-16.52236652236652,193,99,60,55,5,44,39,0,-94,48.704663212435236,60.60606060606061,55.55555555555556,5.050505050505052,51.14551083591331,49.22600619195047,1.9195046439628456,Previsions
2530,0,2019-01-18,79537,LES 2 VACHES FLAN BIO 100X4,0,0,0,LES 2 VACHES,0,LeMolay(FR),0082,0024 FR VALLET (DC),1386,1615,826,795,31,820,789,0,229,-16.52236652236652,15,118,103,103,0,15,15,0,103,-686.6666666666666,87.28813559322035,87.28813559322035,0.0,51.14551083591331,49.22600619195047,1.9195046439628456,Previsions
2531,0,2019-01-18,79537,LES 2 VACHES FLAN BIO 100X4,0,0,0,LES 2 VACHES,0,LeMolay(FR),0077,0024 FR LILPARK (DC),1386,1615,826,795,31,820,789,0,229,-16.52236652236652,9,51,51,51,0,0,0,0,42,-466.6666666666667,100.0,100.0,0.0,51.14551083591331,49.22600619195047,1.9195046439628456,Previsions
2532,0,2019-01-18,79537,LES 2 VACHES FLAN BIO 100X4,0,0,0,LES 2 VACHES,0,LeMolay(FR),0085,0024 FR TOULOUSE (DC),1386,1615,826,795,31,820,789,0,229,-16.52236652236652,203,135,135,135,0,0,0,0,-68,33.49753694581281,100.0,100.0,0.0,51.14551083591331,49.22600619195047,1.9195046439628456,Previsions
2533,0,2019-01-18,79537,LES 2 VACHES FLAN BIO 100X4,0,0,0,LES 2 VACHES,0,LeMolay(FR),0083,0024 FR CHAPONNAY (DC),1386,1615,826,795,31,820,789,0,229,-16.52236652236652,236,230,26,23,3,207,204,0,-6,2.542372881355932,11.304347826086957,10.0,1.304347826086957,51.14551083591331,49.22600619195047,1.9195046439628456,Previsions
2534,1,2019-01-18,79537,LES 2 VACHES FLAN BIO 100X4,0,0,0,LES 2 VACHES,0,LeMolay(FR),0083,0024 FR CHAPONNAY (DC),1386,1615,826,795,31,820,789,0,229,-16.52236652236652,236,230,26,23,3,207,204,0,-6,2.542372881355932,11.304347826086957,10.0,1.304347826086957,51.14551083591331,49.22600619195047,1.9195046439628456,Previsions
2535,0,2019-01-18,79537,LES 2 VACHES FLAN BIO 100X4,0,0,0,LES 2 VACHES,0,LeMolay(FR),0079,0024 FR PARIS SUD (DC),1386,1615,826,795,31,820,789,0,229,-16.52236652236652,160,197,140,119,21,78,57,0,37,-23.125,71.06598984771574,60.40609137055838,10.659898477157363,51.14551083591331,49.22600619195047,1.9195046439628456,Previsions
2536,0,2019-01-18,79537,LES 2 VACHES FLAN BIO 100X4,0,0,0,LES 2 VACHES,0,LeMolay(FR),0078,0024 FR PARIS NORD (DC),1386,1615,826,795,31,820,789,0,229,-16.52236652236652,129,211,29,28,1,183,182,0,82,-63.565891472868216,13.744075829383887,13.270142180094787,0.47393364928909953,51.14551083591331,49.22600619195047,1.9195046439628456,Previsions
2537,1,2019-01-18,83923,ACTIMEL NATU 3x(14x100g) FR,0,0,0,ACTIMEL,1,Rotselaar(BE),0082,0024 FR VALLET (DC),28,1463,1444,1440,4,23,19,0,1435,-5125.0,28,81,64,60,4,21,17,0,53,-189.28571428571428,79.01234567901234,74.07407407407408,4.938271604938265,98.7012987012987,98.4278879015721,0.2734107997265909,Transport
2538,0,2019-01-18,106828,TAILLEFINE FROMAGE NAT 100X8,0,0,0,TAILLEFINE,0,Ferrières(FR),0084,0024 FR AIX (DC),1635,1841,1479,1476,3,365,362,0,206,-12.599388379204893,230,257,224,224,0,33,33,0,27,-11.73913043478261,87.15953307392996,87.15953307392996,0.0,80.33677349266702,80.1738185768604,0.16295491580662258,Previsions
2539,0,2019-01-18,106828,TAILLEFINE FROMAGE NAT 100X8,0,0,0,TAILLEFINE,0,Ferrières(FR),0080,0024 FR METZ (DC),1635,1841,1479,1476,3,365,362,0,206,-12.599388379204893,126,136,99,99,0,37,37,0,10,-7.936507936507937,72.79411764705883,72.79411764705883,0.0,80.33677349266702,80.1738185768604,0.16295491580662258,Previsions
2540,0,2019-01-18,106828,TAILLEFINE FROMAGE NAT 100X8,0,0,0,TAILLEFINE,0,Ferrières(FR),0081,0024 FR TOURS (DC),1635,1841,1479,1476,3,365,362,0,206,-12.599388379204893,257,239,227,227,0,12,12,0,-18,7.003891050583658,94.97907949790795,94.97907949790795,0.0,80.33677349266702,80.1738185768604,0.16295491580662258,Previsions
2541,0,2019-01-18,106828,TAILLEFINE FROMAGE NAT 100X8,0,0,0,TAILLEFINE,0,Ferrières(FR),0082,0024 FR VALLET (DC),1635,1841,1479,1476,3,365,362,0,206,-12.599388379204893,181,128,120,120,0,8,8,0,-53,29.281767955801104,93.75,93.75,0.0,80.33677349266702,80.1738185768604,0.16295491580662258,Previsions
2542,0,2019-01-18,106828,TAILLEFINE FROMAGE NAT 100X8,0,0,0,TAILLEFINE,0,Ferrières(FR),0077,0024 FR LILPARK (DC),1635,1841,1479,1476,3,365,362,0,206,-12.599388379204893,171,151,151,151,0,0,0,0,-20,11.695906432748538,100.0,100.0,0.0,80.33677349266702,80.1738185768604,0.16295491580662258,Previsions
2543,0,2019-01-18,106828,TAILLEFINE FROMAGE NAT 100X8,0,0,0,TAILLEFINE,0,Ferrières(FR),0085,0024 FR TOULOUSE (DC),1635,1841,1479,1476,3,365,362,0,206,-12.599388379204893,256,239,94,91,3,148,145,0,-17,6.640625,39.33054393305439,38.07531380753138,1.2552301255230134,80.33677349266702,80.1738185768604,0.16295491580662258,Previsions
2544,0,2019-01-18,106828,TAILLEFINE FROMAGE NAT 100X8,0,0,0,TAILLEFINE,0,Ferrières(FR),0083,0024 FR CHAPONNAY (DC),1635,1841,1479,1476,3,365,362,0,206,-12.599388379204893,166,189,177,177,0,12,12,0,23,-13.855421686746988,93.65079365079364,93.65079365079364,0.0,80.33677349266702,80.1738185768604,0.16295491580662258,Previsions
2545,0,2019-01-18,106828,TAILLEFINE FROMAGE NAT 100X8,0,0,0,TAILLEFINE,0,Ferrières(FR),0079,0024 FR PARIS SUD (DC),1635,1841,1479,1476,3,365,362,0,206,-12.599388379204893,0,336,274,274,0,62,62,1,336,10000.0,81.54761904761905,81.54761904761905,0.0,80.33677349266702,80.1738185768604,0.16295491580662258,Previsions
2546,0,2019-01-18,106828,TAILLEFINE FROMAGE NAT 100X8,0,0,0,TAILLEFINE,0,Ferrières(FR),0078,0024 FR PARIS NORD (DC),1635,1841,1479,1476,3,365,362,0,206,-12.599388379204893,248,166,113,113,0,53,53,0,-82,33.064516129032256,68.07228915662651,68.07228915662651,0.0,80.33677349266702,80.1738185768604,0.16295491580662258,Previsions
2547,0,2019-01-18,134010,VELOUTE FRUIX PANACHE 125X16 OD,1,0,0,VELOUTE,0,Villecomtal(FR),0084,0024 FR AIX (DC),4127,7742,7721,7391,330,351,21,0,3615,-87.59389386963896,0,4,4,4,0,0,0,1,4,10000.0,100.0,100.0,0.0,99.72875226039784,95.46628778093516,4.262464479462679,Previsions
2548,0,2019-01-18,134010,VELOUTE FRUIX PANACHE 125X16 OD,1,0,0,VELOUTE,0,Villecomtal(FR),0080,0024 FR METZ (DC),4127,7742,7721,7391,330,351,21,0,3615,-87.59389386963896,142,1495,1495,1403,92,92,0,0,1353,-952.8169014084507,100.0,93.84615384615384,6.15384615384616,99.72875226039784,95.46628778093516,4.262464479462679,Previsions
2549,1,2019-01-18,134010,VELOUTE FRUIX PANACHE 125X16 OD,1,0,0,VELOUTE,0,Villecomtal(FR),0080,0024 FR METZ (DC),4127,7742,7721,7391,330,351,21,0,3615,-87.59389386963896,142,1495,1495,1403,92,92,0,0,1353,-952.8169014084507,100.0,93.84615384615384,6.15384615384616,99.72875226039784,95.46628778093516,4.262464479462679,Previsions
2550,0,2019-01-18,134010,VELOUTE FRUIX PANACHE 125X16 OD,1,0,0,VELOUTE,0,Villecomtal(FR),0082,0024 FR VALLET (DC),4127,7742,7721,7391,330,351,21,0,3615,-87.59389386963896,159,1777,1777,1777,0,0,0,0,1618,-1017.6100628930818,100.0,100.0,0.0,99.72875226039784,95.46628778093516,4.262464479462679,Previsions
2551,0,2019-01-18,134010,VELOUTE FRUIX PANACHE 125X16 OD,1,0,0,VELOUTE,0,Villecomtal(FR),0077,0024 FR LILPARK (DC),4127,7742,7721,7391,330,351,21,0,3615,-87.59389386963896,269,764,764,668,96,96,0,0,495,-184.01486988847583,100.0,87.43455497382199,12.565445026178011,99.72875226039784,95.46628778093516,4.262464479462679,Previsions
2552,1,2019-01-18,134010,VELOUTE FRUIX PANACHE 125X16 OD,1,0,0,VELOUTE,0,Villecomtal(FR),0077,0024 FR LILPARK (DC),4127,7742,7721,7391,330,351,21,0,3615,-87.59389386963896,269,764,764,668,96,96,0,0,495,-184.01486988847583,100.0,87.43455497382199,12.565445026178011,99.72875226039784,95.46628778093516,4.262464479462679,Previsions
2553,0,2019-01-18,134010,VELOUTE FRUIX PANACHE 125X16 OD,1,0,0,VELOUTE,0,Villecomtal(FR),0085,0024 FR TOULOUSE (DC),4127,7742,7721,7391,330,351,21,0,3615,-87.59389386963896,1369,1613,1613,1613,0,0,0,0,244,-17.823228634039445,100.0,100.0,0.0,99.72875226039784,95.46628778093516,4.262464479462679,Previsions
2554,0,2019-01-18,134010,VELOUTE FRUIX PANACHE 125X16 OD,1,0,0,VELOUTE,0,Villecomtal(FR),0083,0024 FR CHAPONNAY (DC),4127,7742,7721,7391,330,351,21,0,3615,-87.59389386963896,531,453,453,453,0,0,0,0,-78,14.689265536723164,100.0,100.0,0.0,99.72875226039784,95.46628778093516,4.262464479462679,Previsions
2555,0,2019-01-18,134010,VELOUTE FRUIX PANACHE 125X16 OD,1,0,0,VELOUTE,0,Villecomtal(FR),0079,0024 FR PARIS SUD (DC),4127,7742,7721,7391,330,351,21,0,3615,-87.59389386963896,1245,1606,1606,1464,142,142,0,0,361,-28.995983935742974,100.0,91.15815691158157,8.841843088418429,99.72875226039784,95.46628778093516,4.262464479462679,Previsions
2556,0,2019-01-18,134010,VELOUTE FRUIX PANACHE 125X16 OD,1,0,0,VELOUTE,0,Villecomtal(FR),0078,0024 FR PARIS NORD (DC),4127,7742,7721,7391,330,351,21,0,3615,-87.59389386963896,1,30,9,9,0,21,21,0,29,-2900.0,30.0,30.0,0.0,99.72875226039784,95.46628778093516,4.262464479462679,Previsions
2557,1,2019-01-19,79537,LES 2 VACHES FLAN BIO 100X4,0,0,0,LES 2 VACHES,0,LeMolay(FR),0084,0024 FR AIX (DC),129,692,692,611,81,81,0,0,563,-436.4341085271318,129,171,171,127,44,44,0,0,42,-32.55813953488372,100.0,74.26900584795322,25.730994152046776,100.0,88.29479768786128,11.705202312138724,Previsions
2558,0,2019-01-19,105287,DANET MOUS CHOC LIEG 80gx4 Lidl,0,0,0,DANETTE,1,Ochsenfurt(ALL),0081,0024 FR TOURS (DC),7,360,360,0,360,360,0,0,353,-5042.857142857143,7,360,360,0,360,360,0,0,353,-5042.857142857143,100.0,0.0,100.0,100.0,0.0,100.0,Previsions
2559,1,2019-01-19,121315,ACTIMEL NATU 4x(10x100g) FR,0,0,0,ACTIMEL,1,Rotselaar(BE),0078,0024 FR PARIS NORD (DC),333,1469,1469,1455,14,14,0,0,1136,-341.14114114114113,333,498,498,484,14,14,0,0,165,-49.549549549549546,100.0,97.18875502008032,2.811244979919678,100.0,99.04697072838667,0.9530292716133317,A Creuser
2560,0,2019-01-19,134010,VELOUTE FRUIX PANACHE 125X16 OD,1,0,0,VELOUTE,0,Villecomtal(FR),0080,0024 FR METZ (DC),4539,7356,6913,6911,2,445,443,0,2817,-62.062128222075344,55,220,220,220,0,0,0,0,165,-300.0,100.0,100.0,0.0,93.97770527460577,93.9505165851006,0.027188689505166508,Previsions
2561,0,2019-01-19,134010,VELOUTE FRUIX PANACHE 125X16 OD,1,0,0,VELOUTE,0,Villecomtal(FR),0081,0024 FR TOURS (DC),4539,7356,6913,6911,2,445,443,0,2817,-62.062128222075344,120,1442,1442,1442,0,0,0,0,1322,-1101.6666666666667,100.0,100.0,0.0,93.97770527460577,93.9505165851006,0.027188689505166508,Previsions
2562,0,2019-01-19,134010,VELOUTE FRUIX PANACHE 125X16 OD,1,0,0,VELOUTE,0,Villecomtal(FR),0077,0024 FR LILPARK (DC),4539,7356,6913,6911,2,445,443,0,2817,-62.062128222075344,57,523,205,205,0,318,318,0,466,-817.5438596491229,39.19694072657744,39.19694072657744,0.0,93.97770527460577,93.9505165851006,0.027188689505166508,Previsions
2563,0,2019-01-19,134010,VELOUTE FRUIX PANACHE 125X16 OD,1,0,0,VELOUTE,0,Villecomtal(FR),0085,0024 FR TOULOUSE (DC),4539,7356,6913,6911,2,445,443,0,2817,-62.062128222075344,1023,1204,1204,1204,0,0,0,0,181,-17.693059628543498,100.0,100.0,0.0,93.97770527460577,93.9505165851006,0.027188689505166508,Previsions
2564,0,2019-01-19,134010,VELOUTE FRUIX PANACHE 125X16 OD,1,0,0,VELOUTE,0,Villecomtal(FR),0083,0024 FR CHAPONNAY (DC),4539,7356,6913,6911,2,445,443,0,2817,-62.062128222075344,1141,1434,1434,1434,0,0,0,0,293,-25.67922874671341,100.0,100.0,0.0,93.97770527460577,93.9505165851006,0.027188689505166508,Previsions
2565,0,2019-01-19,134010,VELOUTE FRUIX PANACHE 125X16 OD,1,0,0,VELOUTE,0,Villecomtal(FR),0079,0024 FR PARIS SUD (DC),4539,7356,6913,6911,2,445,443,0,2817,-62.062128222075344,802,877,752,750,2,127,125,0,75,-9.351620947630924,85.74686431014823,85.5188141391106,0.22805017103762282,93.97770527460577,93.9505165851006,0.027188689505166508,Previsions
2566,0,2019-01-19,134010,VELOUTE FRUIX PANACHE 125X16 OD,1,0,0,VELOUTE,0,Villecomtal(FR),0078,0024 FR PARIS NORD (DC),4539,7356,6913,6911,2,445,443,0,2817,-62.062128222075344,1341,1656,1656,1656,0,0,0,0,315,-23.48993288590604,100.0,100.0,0.0,93.97770527460577,93.9505165851006,0.027188689505166508,Previsions
2567,0,2019-01-21,2118,GERVITA NATUR 100gx4,0,0,0,GERVITA,0,Ferrières(FR),0084,0024 FR AIX (DC),5922,6850,6161,5590,571,1260,689,0,928,-15.670381627828437,105,980,980,980,0,0,0,0,875,-833.3333333333334,100.0,100.0,0.0,89.94160583941606,81.60583941605839,8.335766423357668,Qualité
2568,0,2019-01-21,2118,GERVITA NATUR 100gx4,0,0,0,GERVITA,0,Ferrières(FR),0080,0024 FR METZ (DC),5922,6850,6161,5590,571,1260,689,0,928,-15.670381627828437,566,376,376,376,0,0,0,0,-190,33.56890459363957,100.0,100.0,0.0,89.94160583941606,81.60583941605839,8.335766423357668,Qualité
2569,0,2019-01-21,2118,GERVITA NATUR 100gx4,0,0,0,GERVITA,0,Ferrières(FR),0081,0024 FR TOURS (DC),5922,6850,6161,5590,571,1260,689,0,928,-15.670381627828437,615,575,575,575,0,0,0,0,-40,6.504065040650406,100.0,100.0,0.0,89.94160583941606,81.60583941605839,8.335766423357668,Qualité
2570,0,2019-01-21,2118,GERVITA NATUR 100gx4,0,0,0,GERVITA,0,Ferrières(FR),0082,0024 FR VALLET (DC),5922,6850,6161,5590,571,1260,689,0,928,-15.670381627828437,397,365,365,365,0,0,0,0,-32,8.060453400503778,100.0,100.0,0.0,89.94160583941606,81.60583941605839,8.335766423357668,Qualité
2571,0,2019-01-21,2118,GERVITA NATUR 100gx4,0,0,0,GERVITA,0,Ferrières(FR),0077,0024 FR LILPARK (DC),5922,6850,6161,5590,571,1260,689,0,928,-15.670381627828437,3,215,215,215,0,0,0,0,212,-7066.666666666667,100.0,100.0,0.0,89.94160583941606,81.60583941605839,8.335766423357668,Qualité
2572,0,2019-01-21,2118,GERVITA NATUR 100gx4,0,0,0,GERVITA,0,Ferrières(FR),0085,0024 FR TOULOUSE (DC),5922,6850,6161,5590,571,1260,689,0,928,-15.670381627828437,1382,1051,1051,1051,0,0,0,0,-331,23.950795947901593,100.0,100.0,0.0,89.94160583941606,81.60583941605839,8.335766423357668,Qualité
2573,0,2019-01-21,2118,GERVITA NATUR 100gx4,0,0,0,GERVITA,0,Ferrières(FR),0083,0024 FR CHAPONNAY (DC),5922,6850,6161,5590,571,1260,689,0,928,-15.670381627828437,834,871,871,300,571,571,0,0,37,-4.436450839328537,100.0,34.443168771526985,65.55683122847302,89.94160583941606,81.60583941605839,8.335766423357668,Qualité
2574,0,2019-01-21,2118,GERVITA NATUR 100gx4,0,0,0,GERVITA,0,Ferrières(FR),0079,0024 FR PARIS SUD (DC),5922,6850,6161,5590,571,1260,689,0,928,-15.670381627828437,871,957,957,957,0,0,0,0,86,-9.873708381171067,100.0,100.0,0.0,89.94160583941606,81.60583941605839,8.335766423357668,Qualité
2575,0,2019-01-21,2118,GERVITA NATUR 100gx4,0,0,0,GERVITA,0,Ferrières(FR),0078,0024 FR PARIS NORD (DC),5922,6850,6161,5590,571,1260,689,0,928,-15.670381627828437,1149,1460,771,771,0,689,689,0,311,-27.067014795474325,52.8082191780822,52.8082191780822,0.0,89.94160583941606,81.60583941605839,8.335766423357668,Qualité
2576,0,2019-01-21,69189,GERVITA NATURE 100G X 8,0,0,0,GERVITA,0,Ferrières(FR),0084,0024 FR AIX (DC),4447,3939,3646,3484,162,455,293,0,-508,11.423431526872049,752,746,746,746,0,0,0,0,-6,0.7978723404255319,100.0,100.0,0.0,92.56156384869256,88.44884488448845,4.112718964204106,Qualité
2577,0,2019-01-21,69189,GERVITA NATURE 100G X 8,0,0,0,GERVITA,0,Ferrières(FR),0080,0024 FR METZ (DC),4447,3939,3646,3484,162,455,293,0,-508,11.423431526872049,378,238,238,238,0,0,0,0,-140,37.03703703703704,100.0,100.0,0.0,92.56156384869256,88.44884488448845,4.112718964204106,Qualité
2578,0,2019-01-21,69189,GERVITA NATURE 100G X 8,0,0,0,GERVITA,0,Ferrières(FR),0081,0024 FR TOURS (DC),4447,3939,3646,3484,162,455,293,0,-508,11.423431526872049,383,376,376,376,0,0,0,0,-7,1.8276762402088773,100.0,100.0,0.0,92.56156384869256,88.44884488448845,4.112718964204106,Qualité
2579,0,2019-01-21,69189,GERVITA NATURE 100G X 8,0,0,0,GERVITA,0,Ferrières(FR),0082,0024 FR VALLET (DC),4447,3939,3646,3484,162,455,293,0,-508,11.423431526872049,321,190,190,190,0,0,0,0,-131,40.809968847352025,100.0,100.0,0.0,92.56156384869256,88.44884488448845,4.112718964204106,Qualité
2580,0,2019-01-21,69189,GERVITA NATURE 100G X 8,0,0,0,GERVITA,0,Ferrières(FR),0077,0024 FR LILPARK (DC),4447,3939,3646,3484,162,455,293,0,-508,11.423431526872049,131,130,130,130,0,0,0,0,-1,0.7633587786259542,100.0,100.0,0.0,92.56156384869256,88.44884488448845,4.112718964204106,Qualité
2581,0,2019-01-21,69189,GERVITA NATURE 100G X 8,0,0,0,GERVITA,0,Ferrières(FR),0085,0024 FR TOULOUSE (DC),4447,3939,3646,3484,162,455,293,0,-508,11.423431526872049,950,737,444,444,0,293,293,0,-213,22.42105263157895,60.24423337856174,60.24423337856174,0.0,92.56156384869256,88.44884488448845,4.112718964204106,Qualité
2582,0,2019-01-21,69189,GERVITA NATURE 100G X 8,0,0,0,GERVITA,0,Ferrières(FR),0083,0024 FR CHAPONNAY (DC),4447,3939,3646,3484,162,455,293,0,-508,11.423431526872049,550,628,628,466,162,162,0,0,78,-14.181818181818182,100.0,74.20382165605095,25.79617834394905,92.56156384869256,88.44884488448845,4.112718964204106,Qualité
2583,0,2019-01-21,69189,GERVITA NATURE 100G X 8,0,0,0,GERVITA,0,Ferrières(FR),0079,0024 FR PARIS SUD (DC),4447,3939,3646,3484,162,455,293,0,-508,11.423431526872049,518,487,487,487,0,0,0,0,-31,5.984555984555985,100.0,100.0,0.0,92.56156384869256,88.44884488448845,4.112718964204106,Qualité
2584,0,2019-01-21,69189,GERVITA NATURE 100G X 8,0,0,0,GERVITA,0,Ferrières(FR),0078,0024 FR PARIS NORD (DC),4447,3939,3646,3484,162,455,293,0,-508,11.423431526872049,464,407,407,407,0,0,0,0,-57,12.28448275862069,100.0,100.0,0.0,92.56156384869256,88.44884488448845,4.112718964204106,Qualité
2585,0,2019-01-21,83924,ACTIMEL STRA 3x(14x100g) FR,0,0,0,ACTIMEL,1,Rotselaar(BE),0084,0024 FR AIX (DC),3539,1660,1381,1177,204,483,279,0,-1879,53.09409437694264,504,302,186,183,3,119,116,0,-202,40.07936507936508,61.58940397350994,60.59602649006622,0.9933774834437159,83.19277108433735,70.90361445783132,12.289156626506028,Production
2586,0,2019-01-21,83924,ACTIMEL STRA 3x(14x100g) FR,0,0,0,ACTIMEL,1,Rotselaar(BE),0080,0024 FR METZ (DC),3539,1660,1381,1177,204,483,279,0,-1879,53.09409437694264,110,71,71,71,0,0,0,0,-39,35.45454545454545,100.0,100.0,0.0,83.19277108433735,70.90361445783132,12.289156626506028,Production
2587,0,2019-01-21,83924,ACTIMEL STRA 3x(14x100g) FR,0,0,0,ACTIMEL,1,Rotselaar(BE),0081,0024 FR TOURS (DC),3539,1660,1381,1177,204,483,279,0,-1879,53.09409437694264,116,75,75,75,0,0,0,0,-41,35.3448275862069,100.0,100.0,0.0,83.19277108433735,70.90361445783132,12.289156626506028,Production
2588,0,2019-01-21,83924,ACTIMEL STRA 3x(14x100g) FR,0,0,0,ACTIMEL,1,Rotselaar(BE),0077,0024 FR LILPARK (DC),3539,1660,1381,1177,204,483,279,0,-1879,53.09409437694264,576,357,357,357,0,0,0,0,-219,38.020833333333336,100.0,100.0,0.0,83.19277108433735,70.90361445783132,12.289156626506028,Production
2589,0,2019-01-21,83924,ACTIMEL STRA 3x(14x100g) FR,0,0,0,ACTIMEL,1,Rotselaar(BE),0083,0024 FR CHAPONNAY (DC),3539,1660,1381,1177,204,483,279,0,-1879,53.09409437694264,376,227,126,126,0,101,101,0,-149,39.62765957446808,55.50660792951542,55.50660792951542,0.0,83.19277108433735,70.90361445783132,12.289156626506028,Production
2590,0,2019-01-21,83924,ACTIMEL STRA 3x(14x100g) FR,0,0,0,ACTIMEL,1,Rotselaar(BE),0079,0024 FR PARIS SUD (DC),3539,1660,1381,1177,204,483,279,0,-1879,53.09409437694264,347,193,193,193,0,0,0,0,-154,44.38040345821326,100.0,100.0,0.0,83.19277108433735,70.90361445783132,12.289156626506028,Production
2591,1,2019-01-21,83924,ACTIMEL STRA 3x(14x100g) FR,0,0,0,ACTIMEL,1,Rotselaar(BE),0078,0024 FR PARIS NORD (DC),3539,1660,1381,1177,204,483,279,0,-1879,53.09409437694264,755,435,373,172,201,263,62,0,-320,42.384105960264904,85.74712643678161,39.54022988505747,46.20689655172414,83.19277108433735,70.90361445783132,12.289156626506028,A Creuser
2592,0,2019-01-21,83924,ACTIMEL STRA 3x(14x100g) FR,0,0,0,ACTIMEL,1,Rotselaar(BE),0078,0024 FR PARIS NORD (DC),3539,1660,1381,1177,204,483,279,0,-1879,53.09409437694264,755,435,373,172,201,263,62,0,-320,42.384105960264904,85.74712643678161,39.54022988505747,46.20689655172414,83.19277108433735,70.90361445783132,12.289156626506028,Production
2593,0,2019-01-22,121321,ACTIMEL MULTI 3x(8x100g) FR,0,0,0,ACTIMEL,1,Rotselaar(BE),0084,0024 FR AIX (DC),1837,1744,1437,1172,265,572,307,0,-93,5.062602068590093,188,147,10,6,4,141,137,0,-41,21.80851063829787,6.802721088435375,4.081632653061225,2.72108843537415,82.39678899082568,67.20183486238533,15.194954128440358,Transport
2594,0,2019-01-22,121321,ACTIMEL MULTI 3x(8x100g) FR,0,0,0,ACTIMEL,1,Rotselaar(BE),0080,0024 FR METZ (DC),1837,1744,1437,1172,265,572,307,0,-93,5.062602068590093,157,117,115,0,115,117,2,0,-40,25.477707006369428,98.29059829059828,0.0,98.29059829059828,82.39678899082568,67.20183486238533,15.194954128440358,Transport
2595,0,2019-01-22,121321,ACTIMEL MULTI 3x(8x100g) FR,0,0,0,ACTIMEL,1,Rotselaar(BE),0081,0024 FR TOURS (DC),1837,1744,1437,1172,265,572,307,0,-93,5.062602068590093,262,198,198,139,59,59,0,0,-64,24.427480916030536,100.0,70.2020202020202,29.797979797979806,82.39678899082568,67.20183486238533,15.194954128440358,Transport
2596,0,2019-01-22,121321,ACTIMEL MULTI 3x(8x100g) FR,0,0,0,ACTIMEL,1,Rotselaar(BE),0082,0024 FR VALLET (DC),1837,1744,1437,1172,265,572,307,0,-93,5.062602068590093,185,105,105,105,0,0,0,0,-80,43.24324324324324,100.0,100.0,0.0,82.39678899082568,67.20183486238533,15.194954128440358,Transport
2597,0,2019-01-22,121321,ACTIMEL MULTI 3x(8x100g) FR,0,0,0,ACTIMEL,1,Rotselaar(BE),0077,0024 FR LILPARK (DC),1837,1744,1437,1172,265,572,307,0,-93,5.062602068590093,182,205,205,205,0,0,0,0,23,-12.637362637362637,100.0,100.0,0.0,82.39678899082568,67.20183486238533,15.194954128440358,Transport
2598,0,2019-01-22,121321,ACTIMEL MULTI 3x(8x100g) FR,0,0,0,ACTIMEL,1,Rotselaar(BE),0085,0024 FR TOULOUSE (DC),1837,1744,1437,1172,265,572,307,0,-93,5.062602068590093,253,144,112,112,0,32,32,0,-109,43.08300395256917,77.77777777777779,77.77777777777779,0.0,82.39678899082568,67.20183486238533,15.194954128440358,Transport
2599,0,2019-01-22,121321,ACTIMEL MULTI 3x(8x100g) FR,0,0,0,ACTIMEL,1,Rotselaar(BE),0083,0024 FR CHAPONNAY (DC),1837,1744,1437,1172,265,572,307,0,-93,5.062602068590093,252,209,209,209,0,0,0,0,-43,17.063492063492063,100.0,100.0,0.0,82.39678899082568,67.20183486238533,15.194954128440358,Transport
2600,0,2019-01-22,121321,ACTIMEL MULTI 3x(8x100g) FR,0,0,0,ACTIMEL,1,Rotselaar(BE),0079,0024 FR PARIS SUD (DC),1837,1744,1437,1172,265,572,307,0,-93,5.062602068590093,326,309,309,309,0,0,0,0,-17,5.214723926380368,100.0,100.0,0.0,82.39678899082568,67.20183486238533,15.194954128440358,Transport
2601,0,2019-01-22,121321,ACTIMEL MULTI 3x(8x100g) FR,0,0,0,ACTIMEL,1,Rotselaar(BE),0078,0024 FR PARIS NORD (DC),1837,1744,1437,1172,265,572,307,0,-93,5.062602068590093,32,310,174,87,87,223,136,0,278,-868.75,56.12903225806451,28.064516129032256,28.064516129032256,82.39678899082568,67.20183486238533,15.194954128440358,Transport
2602,0,2019-01-22,130581,TAILLEFINE FRT PANACHE 125X16 OD,1,0,0,TAILLEFINE,0,Villecomtal(FR),0080,0024 FR METZ (DC),10089,4505,4505,4060,445,445,0,0,-5584,55.34740806819308,801,545,545,545,0,0,0,0,-256,31.960049937578027,100.0,100.0,0.0,100.0,90.12208657047725,9.87791342952275,Qualité
2603,0,2019-01-22,130581,TAILLEFINE FRT PANACHE 125X16 OD,1,0,0,TAILLEFINE,0,Villecomtal(FR),0081,0024 FR TOURS (DC),10089,4505,4505,4060,445,445,0,0,-5584,55.34740806819308,1911,1345,1345,1148,197,197,0,0,-566,29.618001046572473,100.0,85.35315985130111,14.646840148698885,100.0,90.12208657047725,9.87791342952275,Qualité
2604,1,2019-01-22,130581,TAILLEFINE FRT PANACHE 125X16 OD,1,0,0,TAILLEFINE,0,Villecomtal(FR),0081,0024 FR TOURS (DC),10089,4505,4505,4060,445,445,0,0,-5584,55.34740806819308,1911,1345,1345,1148,197,197,0,0,-566,29.618001046572473,100.0,85.35315985130111,14.646840148698885,100.0,90.12208657047725,9.87791342952275,Qualité
2605,0,2019-01-22,130581,TAILLEFINE FRT PANACHE 125X16 OD,1,0,0,TAILLEFINE,0,Villecomtal(FR),0082,0024 FR VALLET (DC),10089,4505,4505,4060,445,445,0,0,-5584,55.34740806819308,447,472,472,265,207,207,0,0,25,-5.592841163310962,100.0,56.144067796610166,43.855932203389834,100.0,90.12208657047725,9.87791342952275,Qualité
2606,1,2019-01-22,130581,TAILLEFINE FRT PANACHE 125X16 OD,1,0,0,TAILLEFINE,0,Villecomtal(FR),0082,0024 FR VALLET (DC),10089,4505,4505,4060,445,445,0,0,-5584,55.34740806819308,447,472,472,265,207,207,0,0,25,-5.592841163310962,100.0,56.144067796610166,43.855932203389834,100.0,90.12208657047725,9.87791342952275,Qualité
2607,0,2019-01-22,130581,TAILLEFINE FRT PANACHE 125X16 OD,1,0,0,TAILLEFINE,0,Villecomtal(FR),0077,0024 FR LILPARK (DC),10089,4505,4505,4060,445,445,0,0,-5584,55.34740806819308,396,246,246,238,8,8,0,0,-150,37.878787878787875,100.0,96.7479674796748,3.2520325203252014,100.0,90.12208657047725,9.87791342952275,Qualité
2608,0,2019-01-22,130581,TAILLEFINE FRT PANACHE 125X16 OD,1,0,0,TAILLEFINE,0,Villecomtal(FR),0085,0024 FR TOULOUSE (DC),10089,4505,4505,4060,445,445,0,0,-5584,55.34740806819308,287,195,195,195,0,0,0,0,-92,32.055749128919864,100.0,100.0,0.0,100.0,90.12208657047725,9.87791342952275,Qualité
2609,0,2019-01-22,130581,TAILLEFINE FRT PANACHE 125X16 OD,1,0,0,TAILLEFINE,0,Villecomtal(FR),0083,0024 FR CHAPONNAY (DC),10089,4505,4505,4060,445,445,0,0,-5584,55.34740806819308,948,625,625,622,3,3,0,0,-323,34.07172995780591,100.0,99.52,0.480000000000004,100.0,90.12208657047725,9.87791342952275,Qualité
2610,0,2019-01-22,130581,TAILLEFINE FRT PANACHE 125X16 OD,1,0,0,TAILLEFINE,0,Villecomtal(FR),0079,0024 FR PARIS SUD (DC),10089,4505,4505,4060,445,445,0,0,-5584,55.34740806819308,493,324,324,324,0,0,0,0,-169,34.27991886409736,100.0,100.0,0.0,100.0,90.12208657047725,9.87791342952275,Qualité
2611,0,2019-01-22,130581,TAILLEFINE FRT PANACHE 125X16 OD,1,0,0,TAILLEFINE,0,Villecomtal(FR),0078,0024 FR PARIS NORD (DC),10089,4505,4505,4060,445,445,0,0,-5584,55.34740806819308,1224,742,742,712,30,30,0,0,-482,39.37908496732026,100.0,95.95687331536388,4.043126684636121,100.0,90.12208657047725,9.87791342952275,Qualité
2612,1,2019-01-22,130581,TAILLEFINE FRT PANACHE 125X16 OD,1,0,0,TAILLEFINE,0,Villecomtal(FR),0078,0024 FR PARIS NORD (DC),10089,4505,4505,4060,445,445,0,0,-5584,55.34740806819308,1224,742,742,712,30,30,0,0,-482,39.37908496732026,100.0,95.95687331536388,4.043126684636121,100.0,90.12208657047725,9.87791342952275,Qualité
2613,1,2019-01-22,133134,LIGHT & FREE FRAMB GREN 120X4 OD,1,0,0,LIGHT & FREE,0,Ferrières(FR),0078,0024 FR PARIS NORD (DC),79,441,438,401,37,40,3,0,362,-458.2278481012658,79,48,48,21,27,27,0,0,-31,39.24050632911393,100.0,43.75,56.25,99.31972789115646,90.9297052154195,8.390022675736958,Probleme Copacking
2614,0,2019-01-22,134010,VELOUTE FRUIX PANACHE 125X16 OD,1,0,0,VELOUTE,0,Villecomtal(FR),0080,0024 FR METZ (DC),8884,7070,6510,6370,140,700,560,0,-1814,20.418730301665917,1349,1340,1340,1262,78,78,0,0,-9,0.6671608598962194,100.0,94.17910447761194,5.8208955223880565,92.07920792079209,90.0990099009901,1.980198019801989,Previsions
2615,1,2019-01-22,134010,VELOUTE FRUIX PANACHE 125X16 OD,1,0,0,VELOUTE,0,Villecomtal(FR),0080,0024 FR METZ (DC),8884,7070,6510,6370,140,700,560,0,-1814,20.418730301665917,1349,1340,1340,1262,78,78,0,0,-9,0.6671608598962194,100.0,94.17910447761194,5.8208955223880565,92.07920792079209,90.0990099009901,1.980198019801989,Previsions
2616,0,2019-01-22,134010,VELOUTE FRUIX PANACHE 125X16 OD,1,0,0,VELOUTE,0,Villecomtal(FR),0081,0024 FR TOURS (DC),8884,7070,6510,6370,140,700,560,0,-1814,20.418730301665917,727,904,904,904,0,0,0,0,177,-24.346629986244842,100.0,100.0,0.0,92.07920792079209,90.0990099009901,1.980198019801989,Previsions
2617,0,2019-01-22,134010,VELOUTE FRUIX PANACHE 125X16 OD,1,0,0,VELOUTE,0,Villecomtal(FR),0082,0024 FR VALLET (DC),8884,7070,6510,6370,140,700,560,0,-1814,20.418730301665917,201,254,254,254,0,0,0,0,53,-26.3681592039801,100.0,100.0,0.0,92.07920792079209,90.0990099009901,1.980198019801989,Previsions
2618,0,2019-01-22,134010,VELOUTE FRUIX PANACHE 125X16 OD,1,0,0,VELOUTE,0,Villecomtal(FR),0077,0024 FR LILPARK (DC),8884,7070,6510,6370,140,700,560,0,-1814,20.418730301665917,1120,682,682,622,60,60,0,0,-438,39.107142857142854,100.0,91.20234604105572,8.79765395894428,92.07920792079209,90.0990099009901,1.980198019801989,Previsions
2619,0,2019-01-22,134010,VELOUTE FRUIX PANACHE 125X16 OD,1,0,0,VELOUTE,0,Villecomtal(FR),0085,0024 FR TOULOUSE (DC),8884,7070,6510,6370,140,700,560,0,-1814,20.418730301665917,58,69,69,69,0,0,0,0,11,-18.96551724137931,100.0,100.0,0.0,92.07920792079209,90.0990099009901,1.980198019801989,Previsions
2620,0,2019-01-22,134010,VELOUTE FRUIX PANACHE 125X16 OD,1,0,0,VELOUTE,0,Villecomtal(FR),0083,0024 FR CHAPONNAY (DC),8884,7070,6510,6370,140,700,560,0,-1814,20.418730301665917,1319,1224,1224,1223,1,1,0,0,-95,7.202426080363912,100.0,99.91830065359477,0.08169934640523024,92.07920792079209,90.0990099009901,1.980198019801989,Previsions
2621,0,2019-01-22,134010,VELOUTE FRUIX PANACHE 125X16 OD,1,0,0,VELOUTE,0,Villecomtal(FR),0079,0024 FR PARIS SUD (DC),8884,7070,6510,6370,140,700,560,0,-1814,20.418730301665917,2761,2597,2037,2036,1,561,560,0,-164,5.939876856211518,78.4366576819407,78.3981517135156,0.03850596842509901,92.07920792079209,90.0990099009901,1.980198019801989,Previsions
2622,0,2019-01-23,69189,GERVITA NATURE 100G X 8,0,0,0,GERVITA,0,Ferrières(FR),0084,0024 FR AIX (DC),4668,4749,3486,2889,597,1860,1263,0,81,-1.7352185089974292,824,719,624,623,1,96,95,0,-105,12.742718446601941,86.78720445062586,86.6481223922114,0.1390820584144592,73.40492735312696,60.83385975994946,12.571067593177503,Qualité
2623,0,2019-01-23,69189,GERVITA NATURE 100G X 8,0,0,0,GERVITA,0,Ferrières(FR),0080,0024 FR METZ (DC),4668,4749,3486,2889,597,1860,1263,0,81,-1.7352185089974292,28,224,213,213,0,11,11,0,196,-700.0,95.08928571428571,95.08928571428571,0.0,73.40492735312696,60.83385975994946,12.571067593177503,Qualité
2624,0,2019-01-23,69189,GERVITA NATURE 100G X 8,0,0,0,GERVITA,0,Ferrières(FR),0081,0024 FR TOURS (DC),4668,4749,3486,2889,597,1860,1263,0,81,-1.7352185089974292,571,420,420,420,0,0,0,0,-151,26.444833625218916,100.0,100.0,0.0,73.40492735312696,60.83385975994946,12.571067593177503,Qualité
2625,0,2019-01-23,69189,GERVITA NATURE 100G X 8,0,0,0,GERVITA,0,Ferrières(FR),0082,0024 FR VALLET (DC),4668,4749,3486,2889,597,1860,1263,0,81,-1.7352185089974292,352,281,281,281,0,0,0,0,-71,20.170454545454547,100.0,100.0,0.0,73.40492735312696,60.83385975994946,12.571067593177503,Qualité
2626,0,2019-01-23,69189,GERVITA NATURE 100G X 8,0,0,0,GERVITA,0,Ferrières(FR),0077,0024 FR LILPARK (DC),4668,4749,3486,2889,597,1860,1263,0,81,-1.7352185089974292,170,229,229,229,0,0,0,0,59,-34.705882352941174,100.0,100.0,0.0,73.40492735312696,60.83385975994946,12.571067593177503,Qualité
2627,0,2019-01-23,69189,GERVITA NATURE 100G X 8,0,0,0,GERVITA,0,Ferrières(FR),0085,0024 FR TOULOUSE (DC),4668,4749,3486,2889,597,1860,1263,0,81,-1.7352185089974292,1074,1099,477,477,0,622,622,0,25,-2.3277467411545625,43.403093721565064,43.403093721565064,0.0,73.40492735312696,60.83385975994946,12.571067593177503,Qualité
2628,0,2019-01-23,69189,GERVITA NATURE 100G X 8,0,0,0,GERVITA,0,Ferrières(FR),0083,0024 FR CHAPONNAY (DC),4668,4749,3486,2889,597,1860,1263,0,81,-1.7352185089974292,681,865,865,269,596,596,0,0,184,-27.019089574155654,100.0,31.09826589595376,68.90173410404624,73.40492735312696,60.83385975994946,12.571067593177503,Qualité
2629,0,2019-01-23,69189,GERVITA NATURE 100G X 8,0,0,0,GERVITA,0,Ferrières(FR),0079,0024 FR PARIS SUD (DC),4668,4749,3486,2889,597,1860,1263,0,81,-1.7352185089974292,464,515,151,151,0,364,364,0,51,-10.991379310344827,29.320388349514566,29.320388349514566,0.0,73.40492735312696,60.83385975994946,12.571067593177503,Qualité
2630,0,2019-01-23,69189,GERVITA NATURE 100G X 8,0,0,0,GERVITA,0,Ferrières(FR),0078,0024 FR PARIS NORD (DC),4668,4749,3486,2889,597,1860,1263,0,81,-1.7352185089974292,504,397,226,226,0,171,171,0,-107,21.23015873015873,56.92695214105793,56.92695214105793,0.0,73.40492735312696,60.83385975994946,12.571067593177503,Qualité
2631,0,2019-01-23,79537,LES 2 VACHES FLAN BIO 100X4,0,0,0,LES 2 VACHES,0,LeMolay(FR),0084,0024 FR AIX (DC),1444,1822,1198,1198,0,624,624,0,378,-26.177285318559555,130,204,204,204,0,0,0,0,74,-56.92307692307692,100.0,100.0,0.0,65.75192096597145,65.75192096597145,0.0,Previsions
2632,0,2019-01-23,79537,LES 2 VACHES FLAN BIO 100X4,0,0,0,LES 2 VACHES,0,LeMolay(FR),0080,0024 FR METZ (DC),1444,1822,1198,1198,0,624,624,0,378,-26.177285318559555,10,139,139,139,0,0,0,0,129,-1290.0,100.0,100.0,0.0,65.75192096597145,65.75192096597145,0.0,Previsions
2633,0,2019-01-23,79537,LES 2 VACHES FLAN BIO 100X4,0,0,0,LES 2 VACHES,0,LeMolay(FR),0081,0024 FR TOURS (DC),1444,1822,1198,1198,0,624,624,0,378,-26.177285318559555,202,149,149,149,0,0,0,0,-53,26.237623762376238,100.0,100.0,0.0,65.75192096597145,65.75192096597145,0.0,Previsions
2634,0,2019-01-23,79537,LES 2 VACHES FLAN BIO 100X4,0,0,0,LES 2 VACHES,0,LeMolay(FR),0082,0024 FR VALLET (DC),1444,1822,1198,1198,0,624,624,0,378,-26.177285318559555,135,152,152,152,0,0,0,0,17,-12.592592592592593,100.0,100.0,0.0,65.75192096597145,65.75192096597145,0.0,Previsions
2635,0,2019-01-23,79537,LES 2 VACHES FLAN BIO 100X4,0,0,0,LES 2 VACHES,0,LeMolay(FR),0077,0024 FR LILPARK (DC),1444,1822,1198,1198,0,624,624,0,378,-26.177285318559555,53,38,38,38,0,0,0,0,-15,28.30188679245283,100.0,100.0,0.0,65.75192096597145,65.75192096597145,0.0,Previsions
2636,0,2019-01-23,79537,LES 2 VACHES FLAN BIO 100X4,0,0,0,LES 2 VACHES,0,LeMolay(FR),0085,0024 FR TOULOUSE (DC),1444,1822,1198,1198,0,624,624,0,378,-26.177285318559555,180,246,180,180,0,66,66,0,66,-36.666666666666664,73.17073170731707,73.17073170731707,0.0,65.75192096597145,65.75192096597145,0.0,Previsions
2637,0,2019-01-23,79537,LES 2 VACHES FLAN BIO 100X4,0,0,0,LES 2 VACHES,0,LeMolay(FR),0083,0024 FR CHAPONNAY (DC),1444,1822,1198,1198,0,624,624,0,378,-26.177285318559555,290,178,178,178,0,0,0,0,-112,38.62068965517241,100.0,100.0,0.0,65.75192096597145,65.75192096597145,0.0,Previsions
2638,0,2019-01-23,79537,LES 2 VACHES FLAN BIO 100X4,0,0,0,LES 2 VACHES,0,LeMolay(FR),0079,0024 FR PARIS SUD (DC),1444,1822,1198,1198,0,624,624,0,378,-26.177285318559555,96,150,150,150,0,0,0,0,54,-56.25,100.0,100.0,0.0,65.75192096597145,65.75192096597145,0.0,Previsions
2639,0,2019-01-23,79537,LES 2 VACHES FLAN BIO 100X4,0,0,0,LES 2 VACHES,0,LeMolay(FR),0078,0024 FR PARIS NORD (DC),1444,1822,1198,1198,0,624,624,0,378,-26.177285318559555,348,566,8,8,0,558,558,0,218,-62.64367816091954,1.4134275618374559,1.4134275618374559,0.0,65.75192096597145,65.75192096597145,0.0,Previsions
2640,0,2019-01-23,121321,ACTIMEL MULTI 3x(8x100g) FR,0,0,0,ACTIMEL,1,Rotselaar(BE),0080,0024 FR METZ (DC),1930,1631,1452,521,931,1110,179,0,-299,15.492227979274611,328,189,189,0,189,189,0,0,-139,42.3780487804878,100.0,0.0,100.0,89.02513795217658,31.943592887798893,57.081545064377686,Transport
2641,0,2019-01-23,121321,ACTIMEL MULTI 3x(8x100g) FR,0,0,0,ACTIMEL,1,Rotselaar(BE),0081,0024 FR TOURS (DC),1930,1631,1452,521,931,1110,179,0,-299,15.492227979274611,234,164,164,164,0,0,0,0,-70,29.914529914529915,100.0,100.0,0.0,89.02513795217658,31.943592887798893,57.081545064377686,Transport
2642,0,2019-01-23,121321,ACTIMEL MULTI 3x(8x100g) FR,0,0,0,ACTIMEL,1,Rotselaar(BE),0082,0024 FR VALLET (DC),1930,1631,1452,521,931,1110,179,0,-299,15.492227979274611,174,135,135,105,30,30,0,0,-39,22.413793103448278,100.0,77.77777777777779,22.222222222222214,89.02513795217658,31.943592887798893,57.081545064377686,Transport
2643,0,2019-01-23,121321,ACTIMEL MULTI 3x(8x100g) FR,0,0,0,ACTIMEL,1,Rotselaar(BE),0077,0024 FR LILPARK (DC),1930,1631,1452,521,931,1110,179,0,-299,15.492227979274611,83,55,28,28,0,27,27,0,-28,33.734939759036145,50.90909090909091,50.90909090909091,0.0,89.02513795217658,31.943592887798893,57.081545064377686,Transport
2644,0,2019-01-23,121321,ACTIMEL MULTI 3x(8x100g) FR,0,0,0,ACTIMEL,1,Rotselaar(BE),0085,0024 FR TOULOUSE (DC),1930,1631,1452,521,931,1110,179,0,-299,15.492227979274611,28,273,236,9,227,264,37,0,245,-875.0,86.44688644688645,3.296703296703297,83.15018315018315,89.02513795217658,31.943592887798893,57.081545064377686,Transport
2645,0,2019-01-23,121321,ACTIMEL MULTI 3x(8x100g) FR,0,0,0,ACTIMEL,1,Rotselaar(BE),0083,0024 FR CHAPONNAY (DC),1930,1631,1452,521,931,1110,179,0,-299,15.492227979274611,279,282,281,41,240,241,1,0,3,-1.075268817204301,99.64539007092199,14.539007092198581,85.10638297872342,89.02513795217658,31.943592887798893,57.081545064377686,Transport
2646,0,2019-01-23,121321,ACTIMEL MULTI 3x(8x100g) FR,0,0,0,ACTIMEL,1,Rotselaar(BE),0079,0024 FR PARIS SUD (DC),1930,1631,1452,521,931,1110,179,0,-299,15.492227979274611,245,174,174,174,0,0,0,0,-71,28.979591836734695,100.0,100.0,0.0,89.02513795217658,31.943592887798893,57.081545064377686,Transport
2647,0,2019-01-23,121321,ACTIMEL MULTI 3x(8x100g) FR,0,0,0,ACTIMEL,1,Rotselaar(BE),0078,0024 FR PARIS NORD (DC),1930,1631,1452,521,931,1110,179,0,-299,15.492227979274611,559,359,245,0,245,359,114,0,-200,35.77817531305904,68.24512534818942,0.0,68.24512534818942,89.02513795217658,31.943592887798893,57.081545064377686,Transport
2648,0,2019-01-23,133904,DANONE BIO NATURE SUCRE 125X4,0,0,0,DANONE,0,Bailleul(FR),0084,0024 FR AIX (DC),1154,1010,699,690,9,320,311,0,-144,12.478336221837088,67,114,114,114,0,0,0,0,47,-70.14925373134328,100.0,100.0,0.0,69.20792079207921,68.31683168316832,0.8910891089108901,Previsions
2649,0,2019-01-23,133904,DANONE BIO NATURE SUCRE 125X4,0,0,0,DANONE,0,Bailleul(FR),0080,0024 FR METZ (DC),1154,1010,699,690,9,320,311,0,-144,12.478336221837088,268,79,79,79,0,0,0,0,-189,70.5223880597015,100.0,100.0,0.0,69.20792079207921,68.31683168316832,0.8910891089108901,Previsions
2650,0,2019-01-23,133904,DANONE BIO NATURE SUCRE 125X4,0,0,0,DANONE,0,Bailleul(FR),0081,0024 FR TOURS (DC),1154,1010,699,690,9,320,311,0,-144,12.478336221837088,83,183,183,183,0,0,0,0,100,-120.48192771084338,100.0,100.0,0.0,69.20792079207921,68.31683168316832,0.8910891089108901,Previsions
2651,0,2019-01-23,133904,DANONE BIO NATURE SUCRE 125X4,0,0,0,DANONE,0,Bailleul(FR),0082,0024 FR VALLET (DC),1154,1010,699,690,9,320,311,0,-144,12.478336221837088,6,65,65,65,0,0,0,0,59,-983.3333333333334,100.0,100.0,0.0,69.20792079207921,68.31683168316832,0.8910891089108901,Previsions
2652,0,2019-01-23,133904,DANONE BIO NATURE SUCRE 125X4,0,0,0,DANONE,0,Bailleul(FR),0077,0024 FR LILPARK (DC),1154,1010,699,690,9,320,311,0,-144,12.478336221837088,348,71,71,70,1,1,0,0,-277,79.59770114942529,100.0,98.59154929577466,1.408450704225345,69.20792079207921,68.31683168316832,0.8910891089108901,Previsions
2653,0,2019-01-23,133904,DANONE BIO NATURE SUCRE 125X4,0,0,0,DANONE,0,Bailleul(FR),0085,0024 FR TOULOUSE (DC),1154,1010,699,690,9,320,311,0,-144,12.478336221837088,83,57,57,57,0,0,0,0,-26,31.325301204819276,100.0,100.0,0.0,69.20792079207921,68.31683168316832,0.8910891089108901,Previsions
2654,0,2019-01-23,133904,DANONE BIO NATURE SUCRE 125X4,0,0,0,DANONE,0,Bailleul(FR),0083,0024 FR CHAPONNAY (DC),1154,1010,699,690,9,320,311,0,-144,12.478336221837088,60,92,92,92,0,0,0,0,32,-53.333333333333336,100.0,100.0,0.0,69.20792079207921,68.31683168316832,0.8910891089108901,Previsions
2655,0,2019-01-23,133904,DANONE BIO NATURE SUCRE 125X4,0,0,0,DANONE,0,Bailleul(FR),0079,0024 FR PARIS SUD (DC),1154,1010,699,690,9,320,311,0,-144,12.478336221837088,49,30,30,30,0,0,0,0,-19,38.775510204081634,100.0,100.0,0.0,69.20792079207921,68.31683168316832,0.8910891089108901,Previsions
2656,0,2019-01-23,133904,DANONE BIO NATURE SUCRE 125X4,0,0,0,DANONE,0,Bailleul(FR),0078,0024 FR PARIS NORD (DC),1154,1010,699,690,9,320,311,0,-144,12.478336221837088,190,319,8,0,8,319,311,0,129,-67.89473684210526,2.507836990595611,0.0,2.507836990595611,69.20792079207921,68.31683168316832,0.8910891089108901,Previsions
2657,0,2019-01-24,79537,LES 2 VACHES FLAN BIO 100X4,0,0,0,LES 2 VACHES,0,LeMolay(FR),0084,0024 FR AIX (DC),1591,1588,895,712,183,876,693,0,-3,0.18856065367693275,224,258,114,111,3,147,144,0,34,-15.178571428571429,44.18604651162791,43.02325581395349,1.1627906976744171,56.36020151133502,44.83627204030227,11.523929471032751,Previsions
2658,0,2019-01-24,79537,LES 2 VACHES FLAN BIO 100X4,0,0,0,LES 2 VACHES,0,LeMolay(FR),0080,0024 FR METZ (DC),1591,1588,895,712,183,876,693,0,-3,0.18856065367693275,185,84,27,27,0,57,57,0,-101,54.5945945945946,32.142857142857146,32.142857142857146,0.0,56.36020151133502,44.83627204030227,11.523929471032751,Previsions
2659,0,2019-01-24,79537,LES 2 VACHES FLAN BIO 100X4,0,0,0,LES 2 VACHES,0,LeMolay(FR),0081,0024 FR TOURS (DC),1591,1588,895,712,183,876,693,0,-3,0.18856065367693275,144,111,111,111,0,0,0,0,-33,22.916666666666668,100.0,100.0,0.0,56.36020151133502,44.83627204030227,11.523929471032751,Previsions
2660,0,2019-01-24,79537,LES 2 VACHES FLAN BIO 100X4,0,0,0,LES 2 VACHES,0,LeMolay(FR),0082,0024 FR VALLET (DC),1591,1588,895,712,183,876,693,0,-3,0.18856065367693275,135,121,71,71,0,50,50,0,-14,10.37037037037037,58.67768595041323,58.67768595041323,0.0,56.36020151133502,44.83627204030227,11.523929471032751,Previsions
2661,0,2019-01-24,79537,LES 2 VACHES FLAN BIO 100X4,0,0,0,LES 2 VACHES,0,LeMolay(FR),0077,0024 FR LILPARK (DC),1591,1588,895,712,183,876,693,0,-3,0.18856065367693275,6,39,39,39,0,0,0,0,33,-550.0,100.0,100.0,0.0,56.36020151133502,44.83627204030227,11.523929471032751,Previsions
2662,0,2019-01-24,79537,LES 2 VACHES FLAN BIO 100X4,0,0,0,LES 2 VACHES,0,LeMolay(FR),0085,0024 FR TOULOUSE (DC),1591,1588,895,712,183,876,693,0,-3,0.18856065367693275,150,191,6,6,0,185,185,0,41,-27.333333333333332,3.1413612565445024,3.1413612565445024,0.0,56.36020151133502,44.83627204030227,11.523929471032751,Previsions
2663,0,2019-01-24,79537,LES 2 VACHES FLAN BIO 100X4,0,0,0,LES 2 VACHES,0,LeMolay(FR),0083,0024 FR CHAPONNAY (DC),1591,1588,895,712,183,876,693,0,-3,0.18856065367693275,165,155,155,155,0,0,0,0,-10,6.0606060606060606,100.0,100.0,0.0,56.36020151133502,44.83627204030227,11.523929471032751,Previsions
2664,0,2019-01-24,79537,LES 2 VACHES FLAN BIO 100X4,0,0,0,LES 2 VACHES,0,LeMolay(FR),0079,0024 FR PARIS SUD (DC),1591,1588,895,712,183,876,693,0,-3,0.18856065367693275,220,192,192,192,0,0,0,0,-28,12.727272727272727,100.0,100.0,0.0,56.36020151133502,44.83627204030227,11.523929471032751,Previsions
2665,0,2019-01-24,79537,LES 2 VACHES FLAN BIO 100X4,0,0,0,LES 2 VACHES,0,LeMolay(FR),0078,0024 FR PARIS NORD (DC),1591,1588,895,712,183,876,693,0,-3,0.18856065367693275,362,437,180,0,180,437,257,0,75,-20.718232044198896,41.18993135011442,0.0,41.18993135011442,56.36020151133502,44.83627204030227,11.523929471032751,Previsions
2666,0,2019-01-24,102483,JOCKEY FROM NATURE 100X8 3%,0,0,0,JOCKEY,0,Ferrières(FR),0084,0024 FR AIX (DC),1835,2432,2351,1756,595,676,81,0,597,-32.53405994550409,206,235,226,176,50,59,9,0,29,-14.077669902912621,96.17021276595744,74.8936170212766,21.276595744680847,96.66940789473685,72.20394736842105,24.465460526315795,Previsions
2667,0,2019-01-24,102483,JOCKEY FROM NATURE 100X8 3%,0,0,0,JOCKEY,0,Ferrières(FR),0080,0024 FR METZ (DC),1835,2432,2351,1756,595,676,81,0,597,-32.53405994550409,148,147,147,98,49,49,0,0,-1,0.6756756756756757,100.0,66.66666666666666,33.33333333333334,96.66940789473685,72.20394736842105,24.465460526315795,Previsions
2668,0,2019-01-24,102483,JOCKEY FROM NATURE 100X8 3%,0,0,0,JOCKEY,0,Ferrières(FR),0081,0024 FR TOURS (DC),1835,2432,2351,1756,595,676,81,0,597,-32.53405994550409,401,362,359,155,204,207,3,0,-39,9.72568578553616,99.17127071823204,42.81767955801105,56.35359116022099,96.66940789473685,72.20394736842105,24.465460526315795,Previsions
2669,0,2019-01-24,102483,JOCKEY FROM NATURE 100X8 3%,0,0,0,JOCKEY,0,Ferrières(FR),0082,0024 FR VALLET (DC),1835,2432,2351,1756,595,676,81,0,597,-32.53405994550409,204,163,163,163,0,0,0,0,-41,20.098039215686274,100.0,100.0,0.0,96.66940789473685,72.20394736842105,24.465460526315795,Previsions
2670,0,2019-01-24,102483,JOCKEY FROM NATURE 100X8 3%,0,0,0,JOCKEY,0,Ferrières(FR),0077,0024 FR LILPARK (DC),1835,2432,2351,1756,595,676,81,0,597,-32.53405994550409,191,168,168,168,0,0,0,0,-23,12.041884816753926,100.0,100.0,0.0,96.66940789473685,72.20394736842105,24.465460526315795,Previsions
2671,0,2019-01-24,102483,JOCKEY FROM NATURE 100X8 3%,0,0,0,JOCKEY,0,Ferrières(FR),0085,0024 FR TOULOUSE (DC),1835,2432,2351,1756,595,676,81,0,597,-32.53405994550409,330,364,350,281,69,83,14,0,34,-10.303030303030303,96.15384615384616,77.1978021978022,18.956043956043956,96.66940789473685,72.20394736842105,24.465460526315795,Previsions
2672,0,2019-01-24,102483,JOCKEY FROM NATURE 100X8 3%,0,0,0,JOCKEY,0,Ferrières(FR),0083,0024 FR CHAPONNAY (DC),1835,2432,2351,1756,595,676,81,0,597,-32.53405994550409,38,353,353,293,60,60,0,0,315,-828.9473684210526,100.0,83.0028328611898,16.997167138810198,96.66940789473685,72.20394736842105,24.465460526315795,Previsions
2673,0,2019-01-24,102483,JOCKEY FROM NATURE 100X8 3%,0,0,0,JOCKEY,0,Ferrières(FR),0079,0024 FR PARIS SUD (DC),1835,2432,2351,1756,595,676,81,0,597,-32.53405994550409,39,362,355,273,82,89,7,0,323,-828.2051282051282,98.06629834254143,75.41436464088397,22.651933701657455,96.66940789473685,72.20394736842105,24.465460526315795,Previsions
2674,0,2019-01-24,102483,JOCKEY FROM NATURE 100X8 3%,0,0,0,JOCKEY,0,Ferrières(FR),0078,0024 FR PARIS NORD (DC),1835,2432,2351,1756,595,676,81,0,597,-32.53405994550409,278,278,230,149,81,129,48,0,0,0.0,82.73381294964028,53.597122302158276,29.136690647482006,96.66940789473685,72.20394736842105,24.465460526315795,Previsions
2675,0,2019-01-24,121321,ACTIMEL MULTI 3x(8x100g) FR,0,0,0,ACTIMEL,1,Rotselaar(BE),0084,0024 FR AIX (DC),3346,2317,2317,582,1735,1735,0,0,-1029,30.753138075313807,343,258,258,0,258,258,0,0,-85,24.78134110787172,100.0,0.0,100.0,100.0,25.118687958567115,74.88131204143289,Transport
2676,0,2019-01-24,121321,ACTIMEL MULTI 3x(8x100g) FR,0,0,0,ACTIMEL,1,Rotselaar(BE),0080,0024 FR METZ (DC),3346,2317,2317,582,1735,1735,0,0,-1029,30.753138075313807,329,202,202,0,202,202,0,0,-127,38.60182370820669,100.0,0.0,100.0,100.0,25.118687958567115,74.88131204143289,Transport
2677,0,2019-01-24,121321,ACTIMEL MULTI 3x(8x100g) FR,0,0,0,ACTIMEL,1,Rotselaar(BE),0081,0024 FR TOURS (DC),3346,2317,2317,582,1735,1735,0,0,-1029,30.753138075313807,305,271,271,91,180,180,0,0,-34,11.147540983606557,100.0,33.579335793357934,66.42066420664207,100.0,25.118687958567115,74.88131204143289,Transport
2678,0,2019-01-24,121321,ACTIMEL MULTI 3x(8x100g) FR,0,0,0,ACTIMEL,1,Rotselaar(BE),0082,0024 FR VALLET (DC),3346,2317,2317,582,1735,1735,0,0,-1029,30.753138075313807,173,148,148,0,148,148,0,0,-25,14.45086705202312,100.0,0.0,100.0,100.0,25.118687958567115,74.88131204143289,Transport
2679,0,2019-01-24,121321,ACTIMEL MULTI 3x(8x100g) FR,0,0,0,ACTIMEL,1,Rotselaar(BE),0077,0024 FR LILPARK (DC),3346,2317,2317,582,1735,1735,0,0,-1029,30.753138075313807,224,179,179,50,129,129,0,0,-45,20.089285714285715,100.0,27.932960893854748,72.06703910614524,100.0,25.118687958567115,74.88131204143289,Transport
2680,0,2019-01-24,121321,ACTIMEL MULTI 3x(8x100g) FR,0,0,0,ACTIMEL,1,Rotselaar(BE),0085,0024 FR TOULOUSE (DC),3346,2317,2317,582,1735,1735,0,0,-1029,30.753138075313807,406,181,181,181,0,0,0,0,-225,55.41871921182266,100.0,100.0,0.0,100.0,25.118687958567115,74.88131204143289,Transport
2681,0,2019-01-24,121321,ACTIMEL MULTI 3x(8x100g) FR,0,0,0,ACTIMEL,1,Rotselaar(BE),0083,0024 FR CHAPONNAY (DC),3346,2317,2317,582,1735,1735,0,0,-1029,30.753138075313807,545,311,311,0,311,311,0,0,-234,42.93577981651376,100.0,0.0,100.0,100.0,25.118687958567115,74.88131204143289,Transport
2682,0,2019-01-24,121321,ACTIMEL MULTI 3x(8x100g) FR,0,0,0,ACTIMEL,1,Rotselaar(BE),0079,0024 FR PARIS SUD (DC),3346,2317,2317,582,1735,1735,0,0,-1029,30.753138075313807,434,349,349,132,217,217,0,0,-85,19.5852534562212,100.0,37.82234957020057,62.17765042979943,100.0,25.118687958567115,74.88131204143289,Transport
2683,0,2019-01-24,121321,ACTIMEL MULTI 3x(8x100g) FR,0,0,0,ACTIMEL,1,Rotselaar(BE),0078,0024 FR PARIS NORD (DC),3346,2317,2317,582,1735,1735,0,0,-1029,30.753138075313807,587,418,418,128,290,290,0,0,-169,28.79045996592845,100.0,30.62200956937799,69.377990430622,100.0,25.118687958567115,74.88131204143289,Transport
2684,1,2019-01-24,131420,DANONINO FRTS PANACHE 50X12+6,1,0,0,DANONINO,0,Ferrières(FR),0085,0024 FR TOULOUSE (DC),103,999,999,948,51,51,0,0,896,-869.9029126213592,103,58,58,48,10,10,0,0,-45,43.689320388349515,100.0,82.75862068965517,17.241379310344826,100.0,94.8948948948949,5.105105105105096,Probleme Copacking
2685,1,2019-01-24,131477,ACTIVIA FRT PEAR 125X4 OD,1,0,0,ACTIVIA,0,Villecomtal(FR),0085,0024 FR TOULOUSE (DC),178,1173,1173,1130,43,43,0,0,995,-558.9887640449438,178,139,139,108,31,31,0,0,-39,21.910112359550563,100.0,77.6978417266187,22.302158273381295,100.0,96.33418584825235,3.6658141517476537,A Creuser
2686,0,2019-01-24,140280,Activia chia/raspb/muesli 170g FR-copack,0,0,0,ACTIVIA,1,Roumanie(RO),0080,0024 FR METZ (DC),610,502,344,295,49,207,158,0,-108,17.704918032786885,72,52,45,0,45,52,7,0,-20,27.77777777777778,86.53846153846155,0.0,86.53846153846155,68.52589641434263,58.76494023904383,9.760956175298794,A Creuser
2687,0,2019-01-24,140280,Activia chia/raspb/muesli 170g FR-copack,0,0,0,ACTIVIA,1,Roumanie(RO),0081,0024 FR TOURS (DC),610,502,344,295,49,207,158,0,-108,17.704918032786885,150,70,9,9,0,61,61,0,-80,53.333333333333336,12.857142857142856,12.857142857142856,0.0,68.52589641434263,58.76494023904383,9.760956175298794,A Creuser
2688,0,2019-01-24,140280,Activia chia/raspb/muesli 170g FR-copack,0,0,0,ACTIVIA,1,Roumanie(RO),0082,0024 FR VALLET (DC),610,502,344,295,49,207,158,0,-108,17.704918032786885,91,58,58,58,0,0,0,0,-33,36.26373626373626,100.0,100.0,0.0,68.52589641434263,58.76494023904383,9.760956175298794,A Creuser
2689,0,2019-01-24,140280,Activia chia/raspb/muesli 170g FR-copack,0,0,0,ACTIVIA,1,Roumanie(RO),0077,0024 FR LILPARK (DC),610,502,344,295,49,207,158,0,-108,17.704918032786885,65,52,52,52,0,0,0,0,-13,20.0,100.0,100.0,0.0,68.52589641434263,58.76494023904383,9.760956175298794,A Creuser
2690,0,2019-01-24,140280,Activia chia/raspb/muesli 170g FR-copack,0,0,0,ACTIVIA,1,Roumanie(RO),0085,0024 FR TOULOUSE (DC),610,502,344,295,49,207,158,0,-108,17.704918032786885,57,71,71,71,0,0,0,0,14,-24.56140350877193,100.0,100.0,0.0,68.52589641434263,58.76494023904383,9.760956175298794,A Creuser
2691,0,2019-01-24,140280,Activia chia/raspb/muesli 170g FR-copack,0,0,0,ACTIVIA,1,Roumanie(RO),0083,0024 FR CHAPONNAY (DC),610,502,344,295,49,207,158,0,-108,17.704918032786885,61,94,37,35,2,59,57,0,33,-54.09836065573771,39.361702127659576,37.234042553191486,2.1276595744680904,68.52589641434263,58.76494023904383,9.760956175298794,A Creuser
2692,0,2019-01-24,140280,Activia chia/raspb/muesli 170g FR-copack,0,0,0,ACTIVIA,1,Roumanie(RO),0079,0024 FR PARIS SUD (DC),610,502,344,295,49,207,158,0,-108,17.704918032786885,66,63,63,63,0,0,0,0,-3,4.545454545454546,100.0,100.0,0.0,68.52589641434263,58.76494023904383,9.760956175298794,A Creuser
2693,0,2019-01-24,140280,Activia chia/raspb/muesli 170g FR-copack,0,0,0,ACTIVIA,1,Roumanie(RO),0078,0024 FR PARIS NORD (DC),610,502,344,295,49,207,158,0,-108,17.704918032786885,48,42,9,7,2,35,33,0,-6,12.5,21.428571428571427,16.666666666666664,4.761904761904763,68.52589641434263,58.76494023904383,9.760956175298794,A Creuser
2694,0,2019-01-25,32788,TAILLEF CHEESE VANILLA 120X4,0,0,0,TAILLEFINE,0,Ferrières(FR),0084,0024 FR AIX (DC),2171,2376,1827,1827,0,549,549,0,205,-9.442653155228006,327,338,250,250,0,88,88,0,11,-3.363914373088685,73.96449704142012,73.96449704142012,0.0,76.89393939393939,76.89393939393939,0.0,Previsions
2695,0,2019-01-25,32788,TAILLEF CHEESE VANILLA 120X4,0,0,0,TAILLEFINE,0,Ferrières(FR),0080,0024 FR METZ (DC),2171,2376,1827,1827,0,549,549,0,205,-9.442653155228006,186,202,202,202,0,0,0,0,16,-8.602150537634408,100.0,100.0,0.0,76.89393939393939,76.89393939393939,0.0,Previsions
2696,0,2019-01-25,32788,TAILLEF CHEESE VANILLA 120X4,0,0,0,TAILLEFINE,0,Ferrières(FR),0081,0024 FR TOURS (DC),2171,2376,1827,1827,0,549,549,0,205,-9.442653155228006,253,238,238,238,0,0,0,0,-15,5.928853754940712,100.0,100.0,0.0,76.89393939393939,76.89393939393939,0.0,Previsions
2697,0,2019-01-25,32788,TAILLEF CHEESE VANILLA 120X4,0,0,0,TAILLEFINE,0,Ferrières(FR),0082,0024 FR VALLET (DC),2171,2376,1827,1827,0,549,549,0,205,-9.442653155228006,155,171,171,171,0,0,0,0,16,-10.32258064516129,100.0,100.0,0.0,76.89393939393939,76.89393939393939,0.0,Previsions
2698,0,2019-01-25,32788,TAILLEF CHEESE VANILLA 120X4,0,0,0,TAILLEFINE,0,Ferrières(FR),0077,0024 FR LILPARK (DC),2171,2376,1827,1827,0,549,549,0,205,-9.442653155228006,21,192,192,192,0,0,0,0,171,-814.2857142857143,100.0,100.0,0.0,76.89393939393939,76.89393939393939,0.0,Previsions
2699,0,2019-01-25,32788,TAILLEF CHEESE VANILLA 120X4,0,0,0,TAILLEFINE,0,Ferrières(FR),0085,0024 FR TOULOUSE (DC),2171,2376,1827,1827,0,549,549,0,205,-9.442653155228006,301,286,92,92,0,194,194,0,-15,4.983388704318937,32.16783216783217,32.16783216783217,0.0,76.89393939393939,76.89393939393939,0.0,Previsions
2700,0,2019-01-25,32788,TAILLEF CHEESE VANILLA 120X4,0,0,0,TAILLEFINE,0,Ferrières(FR),0083,0024 FR CHAPONNAY (DC),2171,2376,1827,1827,0,549,549,0,205,-9.442653155228006,27,261,261,261,0,0,0,0,234,-866.6666666666666,100.0,100.0,0.0,76.89393939393939,76.89393939393939,0.0,Previsions
2701,0,2019-01-25,32788,TAILLEF CHEESE VANILLA 120X4,0,0,0,TAILLEFINE,0,Ferrières(FR),0079,0024 FR PARIS SUD (DC),2171,2376,1827,1827,0,549,549,0,205,-9.442653155228006,442,432,302,302,0,130,130,0,-10,2.262443438914027,69.9074074074074,69.9074074074074,0.0,76.89393939393939,76.89393939393939,0.0,Previsions
2702,0,2019-01-25,32788,TAILLEF CHEESE VANILLA 120X4,0,0,0,TAILLEFINE,0,Ferrières(FR),0078,0024 FR PARIS NORD (DC),2171,2376,1827,1827,0,549,549,0,205,-9.442653155228006,459,256,119,119,0,137,137,0,-203,44.226579520697165,46.484375,46.484375,0.0,76.89393939393939,76.89393939393939,0.0,Previsions
2703,0,2019-01-25,120168,VELOUTE FRUIX PANACHE 125X16,0,0,0,VELOUTE,0,Villecomtal(FR),0084,0024 FR AIX (DC),9135,8607,8017,8015,2,592,590,0,-528,5.779967159277504,864,804,804,804,0,0,0,0,-60,6.944444444444445,100.0,100.0,0.0,93.14511444173347,93.12187754153595,0.02323690019751723,Qualité
2704,0,2019-01-25,120168,VELOUTE FRUIX PANACHE 125X16,0,0,0,VELOUTE,0,Villecomtal(FR),0080,0024 FR METZ (DC),9135,8607,8017,8015,2,592,590,0,-528,5.779967159277504,689,523,523,523,0,0,0,0,-166,24.09288824383164,100.0,100.0,0.0,93.14511444173347,93.12187754153595,0.02323690019751723,Qualité
2705,0,2019-01-25,120168,VELOUTE FRUIX PANACHE 125X16,0,0,0,VELOUTE,0,Villecomtal(FR),0081,0024 FR TOURS (DC),9135,8607,8017,8015,2,592,590,0,-528,5.779967159277504,1556,1274,1274,1272,2,2,0,0,-282,18.123393316195372,100.0,99.84301412872841,0.15698587127158703,93.14511444173347,93.12187754153595,0.02323690019751723,Qualité
2706,0,2019-01-25,120168,VELOUTE FRUIX PANACHE 125X16,0,0,0,VELOUTE,0,Villecomtal(FR),0082,0024 FR VALLET (DC),9135,8607,8017,8015,2,592,590,0,-528,5.779967159277504,908,843,843,843,0,0,0,0,-65,7.158590308370044,100.0,100.0,0.0,93.14511444173347,93.12187754153595,0.02323690019751723,Qualité
2707,0,2019-01-25,120168,VELOUTE FRUIX PANACHE 125X16,0,0,0,VELOUTE,0,Villecomtal(FR),0077,0024 FR LILPARK (DC),9135,8607,8017,8015,2,592,590,0,-528,5.779967159277504,759,642,52,52,0,590,590,0,-117,15.41501976284585,8.09968847352025,8.09968847352025,0.0,93.14511444173347,93.12187754153595,0.02323690019751723,Qualité
2708,0,2019-01-25,120168,VELOUTE FRUIX PANACHE 125X16,0,0,0,VELOUTE,0,Villecomtal(FR),0085,0024 FR TOULOUSE (DC),9135,8607,8017,8015,2,592,590,0,-528,5.779967159277504,1034,916,916,916,0,0,0,0,-118,11.411992263056092,100.0,100.0,0.0,93.14511444173347,93.12187754153595,0.02323690019751723,Qualité
2709,0,2019-01-25,120168,VELOUTE FRUIX PANACHE 125X16,0,0,0,VELOUTE,0,Villecomtal(FR),0083,0024 FR CHAPONNAY (DC),9135,8607,8017,8015,2,592,590,0,-528,5.779967159277504,1536,1496,1496,1496,0,0,0,0,-40,2.6041666666666665,100.0,100.0,0.0,93.14511444173347,93.12187754153595,0.02323690019751723,Qualité
2710,0,2019-01-25,120168,VELOUTE FRUIX PANACHE 125X16,0,0,0,VELOUTE,0,Villecomtal(FR),0079,0024 FR PARIS SUD (DC),9135,8607,8017,8015,2,592,590,0,-528,5.779967159277504,144,928,928,928,0,0,0,0,784,-544.4444444444445,100.0,100.0,0.0,93.14511444173347,93.12187754153595,0.02323690019751723,Qualité
2711,0,2019-01-25,120168,VELOUTE FRUIX PANACHE 125X16,0,0,0,VELOUTE,0,Villecomtal(FR),0078,0024 FR PARIS NORD (DC),9135,8607,8017,8015,2,592,590,0,-528,5.779967159277504,1645,1181,1181,1181,0,0,0,0,-464,28.206686930091184,100.0,100.0,0.0,93.14511444173347,93.12187754153595,0.02323690019751723,Qualité
2712,0,2019-01-25,127086,DANONE SKYR 140X2,0,0,0,DANONE,0,Ferrières(FR),0084,0024 FR AIX (DC),3263,3025,2145,1953,192,1072,880,0,-238,7.2939013178057,364,373,373,373,0,0,0,0,9,-2.4725274725274726,100.0,100.0,0.0,70.9090909090909,64.56198347107438,6.347107438016522,Production
2713,0,2019-01-25,127086,DANONE SKYR 140X2,0,0,0,DANONE,0,Ferrières(FR),0080,0024 FR METZ (DC),3263,3025,2145,1953,192,1072,880,0,-238,7.2939013178057,195,189,189,189,0,0,0,0,-6,3.076923076923077,100.0,100.0,0.0,70.9090909090909,64.56198347107438,6.347107438016522,Production
2714,0,2019-01-25,127086,DANONE SKYR 140X2,0,0,0,DANONE,0,Ferrières(FR),0081,0024 FR TOURS (DC),3263,3025,2145,1953,192,1072,880,0,-238,7.2939013178057,377,310,72,72,0,238,238,0,-67,17.77188328912467,23.225806451612904,23.225806451612904,0.0,70.9090909090909,64.56198347107438,6.347107438016522,Production
2715,0,2019-01-25,127086,DANONE SKYR 140X2,0,0,0,DANONE,0,Ferrières(FR),0082,0024 FR VALLET (DC),3263,3025,2145,1953,192,1072,880,0,-238,7.2939013178057,276,296,278,278,0,18,18,0,20,-7.246376811594203,93.91891891891892,93.91891891891892,0.0,70.9090909090909,64.56198347107438,6.347107438016522,Production
2716,0,2019-01-25,127086,DANONE SKYR 140X2,0,0,0,DANONE,0,Ferrières(FR),0077,0024 FR LILPARK (DC),3263,3025,2145,1953,192,1072,880,0,-238,7.2939013178057,270,304,269,268,1,36,35,0,34,-12.592592592592593,88.48684210526315,88.1578947368421,0.3289473684210549,70.9090909090909,64.56198347107438,6.347107438016522,Production
2717,0,2019-01-25,127086,DANONE SKYR 140X2,0,0,0,DANONE,0,Ferrières(FR),0085,0024 FR TOULOUSE (DC),3263,3025,2145,1953,192,1072,880,0,-238,7.2939013178057,483,446,313,126,187,320,133,0,-37,7.6604554865424435,70.17937219730942,28.251121076233183,41.92825112107624,70.9090909090909,64.56198347107438,6.347107438016522,Production
2718,0,2019-01-25,127086,DANONE SKYR 140X2,0,0,0,DANONE,0,Ferrières(FR),0083,0024 FR CHAPONNAY (DC),3263,3025,2145,1953,192,1072,880,0,-238,7.2939013178057,376,321,163,163,0,158,158,0,-55,14.627659574468085,50.77881619937694,50.77881619937694,0.0,70.9090909090909,64.56198347107438,6.347107438016522,Production
2719,0,2019-01-25,127086,DANONE SKYR 140X2,0,0,0,DANONE,0,Ferrières(FR),0079,0024 FR PARIS SUD (DC),3263,3025,2145,1953,192,1072,880,0,-238,7.2939013178057,574,526,445,445,0,81,81,0,-48,8.362369337979095,84.60076045627376,84.60076045627376,0.0,70.9090909090909,64.56198347107438,6.347107438016522,Production
2720,0,2019-01-25,127086,DANONE SKYR 140X2,0,0,0,DANONE,0,Ferrières(FR),0078,0024 FR PARIS NORD (DC),3263,3025,2145,1953,192,1072,880,0,-238,7.2939013178057,348,260,43,39,4,221,217,0,-88,25.28735632183908,16.538461538461537,15.0,1.5384615384615365,70.9090909090909,64.56198347107438,6.347107438016522,Production
2721,1,2019-01-25,131483,ACTIVIA FRT STRAWBERRY 125X4 OD,1,0,0,ACTIVIA,0,Villecomtal(FR),0080,0024 FR METZ (DC),121,2479,2479,2399,80,80,0,0,2358,-1948.7603305785124,121,162,162,85,77,77,0,0,41,-33.88429752066116,100.0,52.46913580246913,47.53086419753087,100.0,96.77289229528036,3.227107704719643,Transport
2722,0,2019-01-26,2118,GERVITA NATUR 100gx4,0,0,0,GERVITA,0,Ferrières(FR),0084,0024 FR AIX (DC),6832,8172,7614,7614,0,558,558,0,1340,-19.6135831381733,937,1451,1451,1451,0,0,0,0,514,-54.85592315901814,100.0,100.0,0.0,93.17180616740089,93.17180616740089,0.0,Qualité
2723,0,2019-01-26,2118,GERVITA NATUR 100gx4,0,0,0,GERVITA,0,Ferrières(FR),0080,0024 FR METZ (DC),6832,8172,7614,7614,0,558,558,0,1340,-19.6135831381733,254,357,357,357,0,0,0,0,103,-40.55118110236221,100.0,100.0,0.0,93.17180616740089,93.17180616740089,0.0,Qualité
2724,0,2019-01-26,2118,GERVITA NATUR 100gx4,0,0,0,GERVITA,0,Ferrières(FR),0081,0024 FR TOURS (DC),6832,8172,7614,7614,0,558,558,0,1340,-19.6135831381733,958,1107,1107,1107,0,0,0,0,149,-15.553235908141962,100.0,100.0,0.0,93.17180616740089,93.17180616740089,0.0,Qualité
2725,0,2019-01-26,2118,GERVITA NATUR 100gx4,0,0,0,GERVITA,0,Ferrières(FR),0082,0024 FR VALLET (DC),6832,8172,7614,7614,0,558,558,0,1340,-19.6135831381733,416,360,360,360,0,0,0,0,-56,13.461538461538462,100.0,100.0,0.0,93.17180616740089,93.17180616740089,0.0,Qualité
2726,0,2019-01-26,2118,GERVITA NATUR 100gx4,0,0,0,GERVITA,0,Ferrières(FR),0077,0024 FR LILPARK (DC),6832,8172,7614,7614,0,558,558,0,1340,-19.6135831381733,373,468,468,468,0,0,0,0,95,-25.469168900804288,100.0,100.0,0.0,93.17180616740089,93.17180616740089,0.0,Qualité
2727,0,2019-01-26,2118,GERVITA NATUR 100gx4,0,0,0,GERVITA,0,Ferrières(FR),0085,0024 FR TOULOUSE (DC),6832,8172,7614,7614,0,558,558,0,1340,-19.6135831381733,1067,932,932,932,0,0,0,0,-135,12.652296157450797,100.0,100.0,0.0,93.17180616740089,93.17180616740089,0.0,Qualité
2728,0,2019-01-26,2118,GERVITA NATUR 100gx4,0,0,0,GERVITA,0,Ferrières(FR),0083,0024 FR CHAPONNAY (DC),6832,8172,7614,7614,0,558,558,0,1340,-19.6135831381733,789,602,602,602,0,0,0,0,-187,23.70088719898606,100.0,100.0,0.0,93.17180616740089,93.17180616740089,0.0,Qualité
2729,0,2019-01-26,2118,GERVITA NATUR 100gx4,0,0,0,GERVITA,0,Ferrières(FR),0079,0024 FR PARIS SUD (DC),6832,8172,7614,7614,0,558,558,0,1340,-19.6135831381733,983,1157,1157,1157,0,0,0,0,174,-17.70091556459817,100.0,100.0,0.0,93.17180616740089,93.17180616740089,0.0,Qualité
2730,0,2019-01-26,2118,GERVITA NATUR 100gx4,0,0,0,GERVITA,0,Ferrières(FR),0078,0024 FR PARIS NORD (DC),6832,8172,7614,7614,0,558,558,0,1340,-19.6135831381733,1055,1738,1180,1180,0,558,558,0,683,-64.739336492891,67.89413118527042,67.89413118527042,0.0,93.17180616740089,93.17180616740089,0.0,Qualité
2731,0,2019-01-26,121524,TAILLEFINE FRT MUR MYRT 125X4,0,0,0,TAILLEFINE,0,Villecomtal(FR),0084,0024 FR AIX (DC),726,1078,1078,796,282,282,0,0,352,-48.484848484848484,36,142,142,118,24,24,0,0,106,-294.44444444444446,100.0,83.09859154929578,16.901408450704224,100.0,73.8404452690167,26.159554730983302,Qualité
2732,0,2019-01-26,121524,TAILLEFINE FRT MUR MYRT 125X4,0,0,0,TAILLEFINE,0,Villecomtal(FR),0080,0024 FR METZ (DC),726,1078,1078,796,282,282,0,0,352,-48.484848484848484,46,23,23,23,0,0,0,0,-23,50.0,100.0,100.0,0.0,100.0,73.8404452690167,26.159554730983302,Qualité
2733,0,2019-01-26,121524,TAILLEFINE FRT MUR MYRT 125X4,0,0,0,TAILLEFINE,0,Villecomtal(FR),0081,0024 FR TOURS (DC),726,1078,1078,796,282,282,0,0,352,-48.484848484848484,71,73,73,0,73,73,0,0,2,-2.816901408450704,100.0,0.0,100.0,100.0,73.8404452690167,26.159554730983302,Qualité
2734,1,2019-01-26,121524,TAILLEFINE FRT MUR MYRT 125X4,0,0,0,TAILLEFINE,0,Villecomtal(FR),0081,0024 FR TOURS (DC),726,1078,1078,796,282,282,0,0,352,-48.484848484848484,71,73,73,0,73,73,0,0,2,-2.816901408450704,100.0,0.0,100.0,100.0,73.8404452690167,26.159554730983302,Qualité
2735,0,2019-01-26,121524,TAILLEFINE FRT MUR MYRT 125X4,0,0,0,TAILLEFINE,0,Villecomtal(FR),0082,0024 FR VALLET (DC),726,1078,1078,796,282,282,0,0,352,-48.484848484848484,40,88,88,0,88,88,0,0,48,-120.0,100.0,0.0,100.0,100.0,73.8404452690167,26.159554730983302,Qualité
2736,1,2019-01-26,121524,TAILLEFINE FRT MUR MYRT 125X4,0,0,0,TAILLEFINE,0,Villecomtal(FR),0082,0024 FR VALLET (DC),726,1078,1078,796,282,282,0,0,352,-48.484848484848484,40,88,88,0,88,88,0,0,48,-120.0,100.0,0.0,100.0,100.0,73.8404452690167,26.159554730983302,Qualité
2737,0,2019-01-26,121524,TAILLEFINE FRT MUR MYRT 125X4,0,0,0,TAILLEFINE,0,Villecomtal(FR),0077,0024 FR LILPARK (DC),726,1078,1078,796,282,282,0,0,352,-48.484848484848484,58,90,90,90,0,0,0,0,32,-55.172413793103445,100.0,100.0,0.0,100.0,73.8404452690167,26.159554730983302,Qualité
2738,0,2019-01-26,121524,TAILLEFINE FRT MUR MYRT 125X4,0,0,0,TAILLEFINE,0,Villecomtal(FR),0085,0024 FR TOULOUSE (DC),726,1078,1078,796,282,282,0,0,352,-48.484848484848484,57,92,92,69,23,23,0,0,35,-61.40350877192982,100.0,75.0,25.0,100.0,73.8404452690167,26.159554730983302,Qualité
2739,0,2019-01-26,121524,TAILLEFINE FRT MUR MYRT 125X4,0,0,0,TAILLEFINE,0,Villecomtal(FR),0083,0024 FR CHAPONNAY (DC),726,1078,1078,796,282,282,0,0,352,-48.484848484848484,76,134,134,134,0,0,0,0,58,-76.3157894736842,100.0,100.0,0.0,100.0,73.8404452690167,26.159554730983302,Qualité
2740,0,2019-01-26,121524,TAILLEFINE FRT MUR MYRT 125X4,0,0,0,TAILLEFINE,0,Villecomtal(FR),0079,0024 FR PARIS SUD (DC),726,1078,1078,796,282,282,0,0,352,-48.484848484848484,115,162,162,88,74,74,0,0,47,-40.869565217391305,100.0,54.32098765432099,45.67901234567901,100.0,73.8404452690167,26.159554730983302,Qualité
2741,0,2019-01-26,121524,TAILLEFINE FRT MUR MYRT 125X4,0,0,0,TAILLEFINE,0,Villecomtal(FR),0078,0024 FR PARIS NORD (DC),726,1078,1078,796,282,282,0,0,352,-48.484848484848484,116,274,274,274,0,0,0,0,158,-136.20689655172413,100.0,100.0,0.0,100.0,73.8404452690167,26.159554730983302,Qualité
2742,0,2019-01-28,2118,GERVITA NATUR 100gx4,0,0,0,GERVITA,0,Ferrières(FR),0084,0024 FR AIX (DC),6891,7465,6129,6129,0,1336,1336,0,574,-8.32970541285735,970,1161,1161,1161,0,0,0,0,191,-19.690721649484537,100.0,100.0,0.0,82.10314802411253,82.10314802411253,0.0,Qualité
2743,0,2019-01-28,2118,GERVITA NATUR 100gx4,0,0,0,GERVITA,0,Ferrières(FR),0080,0024 FR METZ (DC),6891,7465,6129,6129,0,1336,1336,0,574,-8.32970541285735,449,422,422,422,0,0,0,0,-27,6.013363028953229,100.0,100.0,0.0,82.10314802411253,82.10314802411253,0.0,Qualité
2744,0,2019-01-28,2118,GERVITA NATUR 100gx4,0,0,0,GERVITA,0,Ferrières(FR),0081,0024 FR TOURS (DC),6891,7465,6129,6129,0,1336,1336,0,574,-8.32970541285735,608,629,29,29,0,600,600,0,21,-3.4539473684210527,4.610492845786964,4.610492845786964,0.0,82.10314802411253,82.10314802411253,0.0,Qualité
2745,0,2019-01-28,2118,GERVITA NATUR 100gx4,0,0,0,GERVITA,0,Ferrières(FR),0082,0024 FR VALLET (DC),6891,7465,6129,6129,0,1336,1336,0,574,-8.32970541285735,353,348,348,348,0,0,0,0,-5,1.4164305949008498,100.0,100.0,0.0,82.10314802411253,82.10314802411253,0.0,Qualité
2746,0,2019-01-28,2118,GERVITA NATUR 100gx4,0,0,0,GERVITA,0,Ferrières(FR),0077,0024 FR LILPARK (DC),6891,7465,6129,6129,0,1336,1336,0,574,-8.32970541285735,226,274,274,274,0,0,0,0,48,-21.238938053097346,100.0,100.0,0.0,82.10314802411253,82.10314802411253,0.0,Qualité
2747,0,2019-01-28,2118,GERVITA NATUR 100gx4,0,0,0,GERVITA,0,Ferrières(FR),0085,0024 FR TOULOUSE (DC),6891,7465,6129,6129,0,1336,1336,0,574,-8.32970541285735,1323,1224,1224,1224,0,0,0,0,-99,7.482993197278912,100.0,100.0,0.0,82.10314802411253,82.10314802411253,0.0,Qualité
2748,0,2019-01-28,2118,GERVITA NATUR 100gx4,0,0,0,GERVITA,0,Ferrières(FR),0083,0024 FR CHAPONNAY (DC),6891,7465,6129,6129,0,1336,1336,0,574,-8.32970541285735,962,1283,1283,1283,0,0,0,0,321,-33.36798336798337,100.0,100.0,0.0,82.10314802411253,82.10314802411253,0.0,Qualité
2749,0,2019-01-28,2118,GERVITA NATUR 100gx4,0,0,0,GERVITA,0,Ferrières(FR),0079,0024 FR PARIS SUD (DC),6891,7465,6129,6129,0,1336,1336,0,574,-8.32970541285735,886,1279,1279,1279,0,0,0,0,393,-44.35665914221219,100.0,100.0,0.0,82.10314802411253,82.10314802411253,0.0,Qualité
2750,0,2019-01-28,2118,GERVITA NATUR 100gx4,0,0,0,GERVITA,0,Ferrières(FR),0078,0024 FR PARIS NORD (DC),6891,7465,6129,6129,0,1336,1336,0,574,-8.32970541285735,1114,845,109,109,0,736,736,0,-269,24.14721723518851,12.89940828402367,12.89940828402367,0.0,82.10314802411253,82.10314802411253,0.0,Qualité
2751,0,2019-01-28,121524,TAILLEFINE FRT MUR MYRT 125X4,0,0,0,TAILLEFINE,0,Villecomtal(FR),0084,0024 FR AIX (DC),708,739,656,415,241,324,83,0,31,-4.378531073446328,59,83,83,83,0,0,0,0,24,-40.67796610169491,100.0,100.0,0.0,88.76860622462787,56.156968876860624,32.61163734776725,Qualité
2752,0,2019-01-28,121524,TAILLEFINE FRT MUR MYRT 125X4,0,0,0,TAILLEFINE,0,Villecomtal(FR),0080,0024 FR METZ (DC),708,739,656,415,241,324,83,0,31,-4.378531073446328,70,60,60,60,0,0,0,0,-10,14.285714285714286,100.0,100.0,0.0,88.76860622462787,56.156968876860624,32.61163734776725,Qualité
2753,0,2019-01-28,121524,TAILLEFINE FRT MUR MYRT 125X4,0,0,0,TAILLEFINE,0,Villecomtal(FR),0081,0024 FR TOURS (DC),708,739,656,415,241,324,83,0,31,-4.378531073446328,62,49,48,0,48,49,1,0,-13,20.967741935483872,97.95918367346938,0.0,97.95918367346938,88.76860622462787,56.156968876860624,32.61163734776725,Qualité
2754,0,2019-01-28,121524,TAILLEFINE FRT MUR MYRT 125X4,0,0,0,TAILLEFINE,0,Villecomtal(FR),0082,0024 FR VALLET (DC),708,739,656,415,241,324,83,0,31,-4.378531073446328,35,54,37,0,37,54,17,0,19,-54.285714285714285,68.51851851851852,0.0,68.51851851851852,88.76860622462787,56.156968876860624,32.61163734776725,Qualité
2755,1,2019-01-28,121524,TAILLEFINE FRT MUR MYRT 125X4,0,0,0,TAILLEFINE,0,Villecomtal(FR),0082,0024 FR VALLET (DC),708,739,656,415,241,324,83,0,31,-4.378531073446328,35,54,37,0,37,54,17,0,19,-54.285714285714285,68.51851851851852,0.0,68.51851851851852,88.76860622462787,56.156968876860624,32.61163734776725,Qualité
2756,0,2019-01-28,121524,TAILLEFINE FRT MUR MYRT 125X4,0,0,0,TAILLEFINE,0,Villecomtal(FR),0077,0024 FR LILPARK (DC),708,739,656,415,241,324,83,0,31,-4.378531073446328,30,55,55,55,0,0,0,0,25,-83.33333333333333,100.0,100.0,0.0,88.76860622462787,56.156968876860624,32.61163734776725,Qualité
2757,0,2019-01-28,121524,TAILLEFINE FRT MUR MYRT 125X4,0,0,0,TAILLEFINE,0,Villecomtal(FR),0085,0024 FR TOULOUSE (DC),708,739,656,415,241,324,83,0,31,-4.378531073446328,68,62,58,0,58,62,4,0,-6,8.823529411764707,93.54838709677419,0.0,93.54838709677419,88.76860622462787,56.156968876860624,32.61163734776725,Qualité
2758,0,2019-01-28,121524,TAILLEFINE FRT MUR MYRT 125X4,0,0,0,TAILLEFINE,0,Villecomtal(FR),0083,0024 FR CHAPONNAY (DC),708,739,656,415,241,324,83,0,31,-4.378531073446328,9,128,128,128,0,0,0,0,119,-1322.2222222222222,100.0,100.0,0.0,88.76860622462787,56.156968876860624,32.61163734776725,Qualité
2759,0,2019-01-28,121524,TAILLEFINE FRT MUR MYRT 125X4,0,0,0,TAILLEFINE,0,Villecomtal(FR),0079,0024 FR PARIS SUD (DC),708,739,656,415,241,324,83,0,31,-4.378531073446328,114,159,98,0,98,159,61,0,45,-39.473684210526315,61.63522012578616,0.0,61.63522012578616,88.76860622462787,56.156968876860624,32.61163734776725,Qualité
2760,1,2019-01-28,121524,TAILLEFINE FRT MUR MYRT 125X4,0,0,0,TAILLEFINE,0,Villecomtal(FR),0079,0024 FR PARIS SUD (DC),708,739,656,415,241,324,83,0,31,-4.378531073446328,114,159,98,0,98,159,61,0,45,-39.473684210526315,61.63522012578616,0.0,61.63522012578616,88.76860622462787,56.156968876860624,32.61163734776725,Qualité
2761,0,2019-01-28,121524,TAILLEFINE FRT MUR MYRT 125X4,0,0,0,TAILLEFINE,0,Villecomtal(FR),0078,0024 FR PARIS NORD (DC),708,739,656,415,241,324,83,0,31,-4.378531073446328,112,89,89,89,0,0,0,0,-23,20.535714285714285,100.0,100.0,0.0,88.76860622462787,56.156968876860624,32.61163734776725,Qualité
2762,1,2019-01-28,131405,ACTIVIA RHUBARBE 125X4 OD,1,0,0,ACTIVIA,0,Villecomtal(FR),0079,0024 FR PARIS SUD (DC),46,395,393,343,50,52,2,0,349,-758.695652173913,46,72,72,27,45,45,0,0,26,-56.52173913043478,100.0,37.5,62.5,99.49367088607595,86.83544303797468,12.658227848101262,Qualité
2763,1,2019-01-28,131420,DANONINO FRTS PANACHE 50X12+6,1,0,0,DANONINO,0,Ferrières(FR),0085,0024 FR TOULOUSE (DC),157,552,552,430,122,122,0,0,395,-251.59235668789808,157,88,88,3,85,85,0,0,-69,43.94904458598726,100.0,3.4090909090909087,96.5909090909091,100.0,77.89855072463769,22.101449275362313,Previsions
2764,1,2019-01-28,131422,ACTIVIA ANA RHU FIG PRU 125X8 OD,1,0,0,ACTIVIA,0,Villecomtal(FR),0079,0024 FR PARIS SUD (DC),31,136,136,110,26,26,0,0,105,-338.7096774193548,31,18,18,0,18,18,0,0,-13,41.935483870967744,100.0,0.0,100.0,100.0,80.88235294117648,19.117647058823522,Previsions
2765,1,2019-01-28,131480,ACTIVIA POMME 125X4 OD,1,0,0,ACTIVIA,0,Villecomtal(FR),0083,0024 FR CHAPONNAY (DC),41,181,177,108,69,73,4,0,140,-341.4634146341463,18,24,24,4,20,20,0,0,6,-33.333333333333336,100.0,16.666666666666664,83.33333333333334,97.79005524861878,59.66850828729282,38.12154696132596,Probleme Copacking
2766,1,2019-01-28,131480,ACTIVIA POMME 125X4 OD,1,0,0,ACTIVIA,0,Villecomtal(FR),0078,0024 FR PARIS NORD (DC),41,181,177,108,69,73,4,0,140,-341.4634146341463,23,29,29,0,29,29,0,0,6,-26.08695652173913,100.0,0.0,100.0,97.79005524861878,59.66850828729282,38.12154696132596,Expe usine
2767,0,2019-01-28,134010,VELOUTE FRUIX PANACHE 125X16 OD,1,0,0,VELOUTE,0,Villecomtal(FR),0080,0024 FR METZ (DC),3635,2115,1457,1457,0,658,658,0,-1520,41.81568088033012,645,358,358,358,0,0,0,0,-287,44.49612403100775,100.0,100.0,0.0,68.88888888888889,68.88888888888889,0.0,Previsions
2768,0,2019-01-28,134010,VELOUTE FRUIX PANACHE 125X16 OD,1,0,0,VELOUTE,0,Villecomtal(FR),0077,0024 FR LILPARK (DC),3635,2115,1457,1457,0,658,658,0,-1520,41.81568088033012,756,424,424,424,0,0,0,0,-332,43.91534391534392,100.0,100.0,0.0,68.88888888888889,68.88888888888889,0.0,Previsions
2769,0,2019-01-28,134010,VELOUTE FRUIX PANACHE 125X16 OD,1,0,0,VELOUTE,0,Villecomtal(FR),0083,0024 FR CHAPONNAY (DC),3635,2115,1457,1457,0,658,658,0,-1520,41.81568088033012,429,237,237,237,0,0,0,0,-192,44.75524475524475,100.0,100.0,0.0,68.88888888888889,68.88888888888889,0.0,Previsions
2770,0,2019-01-28,134010,VELOUTE FRUIX PANACHE 125X16 OD,1,0,0,VELOUTE,0,Villecomtal(FR),0079,0024 FR PARIS SUD (DC),3635,2115,1457,1457,0,658,658,0,-1520,41.81568088033012,1805,1096,438,438,0,658,658,0,-709,39.2797783933518,39.96350364963504,39.96350364963504,0.0,68.88888888888889,68.88888888888889,0.0,Previsions
2771,1,2019-01-28,136436,ACTIVIA FRT CERISE 125X4 OD,1,0,0,ACTIVIA,0,Villecomtal(FR),0079,0024 FR PARIS SUD (DC),56,907,907,828,79,79,0,0,851,-1519.642857142857,56,87,87,8,79,79,0,0,31,-55.357142857142854,100.0,9.195402298850574,90.80459770114942,100.0,91.28996692392502,8.710033076074978,Client
2772,0,2019-01-28,140280,Activia chia/raspb/muesli 170g FR-copack,0,0,0,ACTIVIA,1,Roumanie(RO),0084,0024 FR AIX (DC),944,1022,786,135,651,887,236,0,78,-8.26271186440678,195,117,117,0,117,117,0,0,-78,40.0,100.0,0.0,100.0,76.90802348336595,13.209393346379647,63.6986301369863,Transport
2773,0,2019-01-28,140280,Activia chia/raspb/muesli 170g FR-copack,0,0,0,ACTIVIA,1,Roumanie(RO),0080,0024 FR METZ (DC),944,1022,786,135,651,887,236,0,78,-8.26271186440678,102,125,74,0,74,125,51,0,23,-22.54901960784314,59.199999999999996,0.0,59.199999999999996,76.90802348336595,13.209393346379647,63.6986301369863,Transport
2774,0,2019-01-28,140280,Activia chia/raspb/muesli 170g FR-copack,0,0,0,ACTIVIA,1,Roumanie(RO),0081,0024 FR TOURS (DC),944,1022,786,135,651,887,236,0,78,-8.26271186440678,117,78,9,0,9,78,69,0,-39,33.333333333333336,11.538461538461538,0.0,11.538461538461538,76.90802348336595,13.209393346379647,63.6986301369863,Transport
2775,0,2019-01-28,140280,Activia chia/raspb/muesli 170g FR-copack,0,0,0,ACTIVIA,1,Roumanie(RO),0082,0024 FR VALLET (DC),944,1022,786,135,651,887,236,0,78,-8.26271186440678,7,70,6,0,6,70,64,0,63,-900.0,8.571428571428571,0.0,8.571428571428571,76.90802348336595,13.209393346379647,63.6986301369863,Transport
2776,0,2019-01-28,140280,Activia chia/raspb/muesli 170g FR-copack,0,0,0,ACTIVIA,1,Roumanie(RO),0077,0024 FR LILPARK (DC),944,1022,786,135,651,887,236,0,78,-8.26271186440678,80,108,108,0,108,108,0,0,28,-35.0,100.0,0.0,100.0,76.90802348336595,13.209393346379647,63.6986301369863,Transport
2777,0,2019-01-28,140280,Activia chia/raspb/muesli 170g FR-copack,0,0,0,ACTIVIA,1,Roumanie(RO),0085,0024 FR TOULOUSE (DC),944,1022,786,135,651,887,236,0,78,-8.26271186440678,100,112,112,0,112,112,0,0,12,-12.0,100.0,0.0,100.0,76.90802348336595,13.209393346379647,63.6986301369863,Transport
2778,0,2019-01-28,140280,Activia chia/raspb/muesli 170g FR-copack,0,0,0,ACTIVIA,1,Roumanie(RO),0083,0024 FR CHAPONNAY (DC),944,1022,786,135,651,887,236,0,78,-8.26271186440678,105,135,135,135,0,0,0,0,30,-28.571428571428573,100.0,100.0,0.0,76.90802348336595,13.209393346379647,63.6986301369863,Transport
2779,0,2019-01-28,140280,Activia chia/raspb/muesli 170g FR-copack,0,0,0,ACTIVIA,1,Roumanie(RO),0079,0024 FR PARIS SUD (DC),944,1022,786,135,651,887,236,0,78,-8.26271186440678,82,75,23,0,23,75,52,0,-7,8.536585365853659,30.666666666666664,0.0,30.666666666666664,76.90802348336595,13.209393346379647,63.6986301369863,Transport
2780,0,2019-01-28,140280,Activia chia/raspb/muesli 170g FR-copack,0,0,0,ACTIVIA,1,Roumanie(RO),0078,0024 FR PARIS NORD (DC),944,1022,786,135,651,887,236,0,78,-8.26271186440678,156,202,202,0,202,202,0,0,46,-29.487179487179485,100.0,0.0,100.0,76.90802348336595,13.209393346379647,63.6986301369863,Transport
2781,0,2019-01-28,142615,ACTIMEL STRAWBERRY 4x(8+4x100g) FR,1,1,0,ACTIMEL,1,Rotselaar(BE),0084,0024 FR AIX (DC),2928,1242,1242,903,339,339,0,0,-1686,57.58196721311475,188,103,103,95,8,8,0,0,-85,45.212765957446805,100.0,92.23300970873787,7.7669902912621325,100.0,72.70531400966183,27.294685990338166,Production
2782,0,2019-01-28,142615,ACTIMEL STRAWBERRY 4x(8+4x100g) FR,1,1,0,ACTIMEL,1,Rotselaar(BE),0080,0024 FR METZ (DC),2928,1242,1242,903,339,339,0,0,-1686,57.58196721311475,137,73,73,73,0,0,0,0,-64,46.715328467153284,100.0,100.0,0.0,100.0,72.70531400966183,27.294685990338166,Production
2783,0,2019-01-28,142615,ACTIMEL STRAWBERRY 4x(8+4x100g) FR,1,1,0,ACTIMEL,1,Rotselaar(BE),0081,0024 FR TOURS (DC),2928,1242,1242,903,339,339,0,0,-1686,57.58196721311475,155,84,84,81,3,3,0,0,-71,45.806451612903224,100.0,96.42857142857143,3.5714285714285694,100.0,72.70531400966183,27.294685990338166,Production
2784,0,2019-01-28,142615,ACTIMEL STRAWBERRY 4x(8+4x100g) FR,1,1,0,ACTIMEL,1,Rotselaar(BE),0077,0024 FR LILPARK (DC),2928,1242,1242,903,339,339,0,0,-1686,57.58196721311475,773,423,423,100,323,323,0,0,-350,45.278137128072444,100.0,23.64066193853428,76.35933806146572,100.0,72.70531400966183,27.294685990338166,Production
2785,1,2019-01-28,142615,ACTIMEL STRAWBERRY 4x(8+4x100g) FR,1,1,0,ACTIMEL,1,Rotselaar(BE),0077,0024 FR LILPARK (DC),2928,1242,1242,903,339,339,0,0,-1686,57.58196721311475,773,423,423,100,323,323,0,0,-350,45.278137128072444,100.0,23.64066193853428,76.35933806146572,100.0,72.70531400966183,27.294685990338166,Production
2786,0,2019-01-28,142615,ACTIMEL STRAWBERRY 4x(8+4x100g) FR,1,1,0,ACTIMEL,1,Rotselaar(BE),0085,0024 FR TOULOUSE (DC),2928,1242,1242,903,339,339,0,0,-1686,57.58196721311475,115,62,62,60,2,2,0,0,-53,46.08695652173913,100.0,96.7741935483871,3.225806451612897,100.0,72.70531400966183,27.294685990338166,Production
2787,0,2019-01-28,142615,ACTIMEL STRAWBERRY 4x(8+4x100g) FR,1,1,0,ACTIMEL,1,Rotselaar(BE),0083,0024 FR CHAPONNAY (DC),2928,1242,1242,903,339,339,0,0,-1686,57.58196721311475,213,179,179,176,3,3,0,0,-34,15.96244131455399,100.0,98.32402234636871,1.6759776536312927,100.0,72.70531400966183,27.294685990338166,Production
2788,0,2019-01-28,142615,ACTIMEL STRAWBERRY 4x(8+4x100g) FR,1,1,0,ACTIMEL,1,Rotselaar(BE),0079,0024 FR PARIS SUD (DC),2928,1242,1242,903,339,339,0,0,-1686,57.58196721311475,219,122,122,122,0,0,0,0,-97,44.29223744292238,100.0,100.0,0.0,100.0,72.70531400966183,27.294685990338166,Production
2789,0,2019-01-28,142615,ACTIMEL STRAWBERRY 4x(8+4x100g) FR,1,1,0,ACTIMEL,1,Rotselaar(BE),0078,0024 FR PARIS NORD (DC),2928,1242,1242,903,339,339,0,0,-1686,57.58196721311475,355,196,196,196,0,0,0,0,-159,44.7887323943662,100.0,100.0,0.0,100.0,72.70531400966183,27.294685990338166,Production
2790,0,2019-01-29,90919,TAILLEFINE MOUSSE CHOCO 60X4,0,0,0,TAILLEFINE,1,Eurodesserts(BE),0084,0024 FR AIX (DC),737,738,673,466,207,272,65,0,1,-0.13568521031207598,150,97,97,0,97,97,0,0,-53,35.333333333333336,100.0,0.0,100.0,91.19241192411924,63.143631436314365,28.048780487804876,Expe usine
2791,0,2019-01-29,90919,TAILLEFINE MOUSSE CHOCO 60X4,0,0,0,TAILLEFINE,1,Eurodesserts(BE),0080,0024 FR METZ (DC),737,738,673,466,207,272,65,0,1,-0.13568521031207598,27,37,37,37,0,0,0,0,10,-37.03703703703704,100.0,100.0,0.0,91.19241192411924,63.143631436314365,28.048780487804876,Expe usine
2792,0,2019-01-29,90919,TAILLEFINE MOUSSE CHOCO 60X4,0,0,0,TAILLEFINE,1,Eurodesserts(BE),0081,0024 FR TOURS (DC),737,738,673,466,207,272,65,0,1,-0.13568521031207598,60,49,49,49,0,0,0,0,-11,18.333333333333332,100.0,100.0,0.0,91.19241192411924,63.143631436314365,28.048780487804876,Expe usine
2793,0,2019-01-29,90919,TAILLEFINE MOUSSE CHOCO 60X4,0,0,0,TAILLEFINE,1,Eurodesserts(BE),0082,0024 FR VALLET (DC),737,738,673,466,207,272,65,0,1,-0.13568521031207598,58,43,14,0,14,43,29,0,-15,25.862068965517242,32.55813953488372,0.0,32.55813953488372,91.19241192411924,63.143631436314365,28.048780487804876,Expe usine
2794,0,2019-01-29,90919,TAILLEFINE MOUSSE CHOCO 60X4,0,0,0,TAILLEFINE,1,Eurodesserts(BE),0077,0024 FR LILPARK (DC),737,738,673,466,207,272,65,0,1,-0.13568521031207598,124,147,147,147,0,0,0,0,23,-18.548387096774192,100.0,100.0,0.0,91.19241192411924,63.143631436314365,28.048780487804876,Expe usine
2795,0,2019-01-29,90919,TAILLEFINE MOUSSE CHOCO 60X4,0,0,0,TAILLEFINE,1,Eurodesserts(BE),0085,0024 FR TOULOUSE (DC),737,738,673,466,207,272,65,0,1,-0.13568521031207598,75,61,29,0,29,61,32,0,-14,18.666666666666668,47.540983606557376,0.0,47.540983606557376,91.19241192411924,63.143631436314365,28.048780487804876,Expe usine
2796,0,2019-01-29,90919,TAILLEFINE MOUSSE CHOCO 60X4,0,0,0,TAILLEFINE,1,Eurodesserts(BE),0083,0024 FR CHAPONNAY (DC),737,738,673,466,207,272,65,0,1,-0.13568521031207598,49,71,67,0,67,71,4,0,22,-44.89795918367347,94.36619718309859,0.0,94.36619718309859,91.19241192411924,63.143631436314365,28.048780487804876,Expe usine
2797,0,2019-01-29,90919,TAILLEFINE MOUSSE CHOCO 60X4,0,0,0,TAILLEFINE,1,Eurodesserts(BE),0079,0024 FR PARIS SUD (DC),737,738,673,466,207,272,65,0,1,-0.13568521031207598,134,159,159,159,0,0,0,0,25,-18.65671641791045,100.0,100.0,0.0,91.19241192411924,63.143631436314365,28.048780487804876,Expe usine
2798,0,2019-01-29,90919,TAILLEFINE MOUSSE CHOCO 60X4,0,0,0,TAILLEFINE,1,Eurodesserts(BE),0078,0024 FR PARIS NORD (DC),737,738,673,466,207,272,65,0,1,-0.13568521031207598,60,74,74,74,0,0,0,0,14,-23.333333333333332,100.0,100.0,0.0,91.19241192411924,63.143631436314365,28.048780487804876,Expe usine
2799,0,2019-01-29,133904,DANONE BIO NATURE SUCRE 125X4,0,0,0,DANONE,0,Bailleul(FR),0084,0024 FR AIX (DC),631,873,528,522,6,351,345,0,242,-38.35182250396196,111,128,128,128,0,0,0,0,17,-15.315315315315315,100.0,100.0,0.0,60.48109965635739,59.79381443298969,0.6872852233676952,Previsions
2800,0,2019-01-29,133904,DANONE BIO NATURE SUCRE 125X4,0,0,0,DANONE,0,Bailleul(FR),0080,0024 FR METZ (DC),631,873,528,522,6,351,345,0,242,-38.35182250396196,44,50,50,50,0,0,0,0,6,-13.636363636363637,100.0,100.0,0.0,60.48109965635739,59.79381443298969,0.6872852233676952,Previsions
2801,0,2019-01-29,133904,DANONE BIO NATURE SUCRE 125X4,0,0,0,DANONE,0,Bailleul(FR),0081,0024 FR TOURS (DC),631,873,528,522,6,351,345,0,242,-38.35182250396196,50,85,85,85,0,0,0,0,35,-70.0,100.0,100.0,0.0,60.48109965635739,59.79381443298969,0.6872852233676952,Previsions
2802,0,2019-01-29,133904,DANONE BIO NATURE SUCRE 125X4,0,0,0,DANONE,0,Bailleul(FR),0082,0024 FR VALLET (DC),631,873,528,522,6,351,345,0,242,-38.35182250396196,23,21,21,21,0,0,0,0,-2,8.695652173913043,100.0,100.0,0.0,60.48109965635739,59.79381443298969,0.6872852233676952,Previsions
2803,0,2019-01-29,133904,DANONE BIO NATURE SUCRE 125X4,0,0,0,DANONE,0,Bailleul(FR),0077,0024 FR LILPARK (DC),631,873,528,522,6,351,345,0,242,-38.35182250396196,87,25,25,25,0,0,0,0,-62,71.26436781609195,100.0,100.0,0.0,60.48109965635739,59.79381443298969,0.6872852233676952,Previsions
2804,0,2019-01-29,133904,DANONE BIO NATURE SUCRE 125X4,0,0,0,DANONE,0,Bailleul(FR),0085,0024 FR TOULOUSE (DC),631,873,528,522,6,351,345,0,242,-38.35182250396196,161,133,133,133,0,0,0,0,-28,17.391304347826086,100.0,100.0,0.0,60.48109965635739,59.79381443298969,0.6872852233676952,Previsions
2805,0,2019-01-29,133904,DANONE BIO NATURE SUCRE 125X4,0,0,0,DANONE,0,Bailleul(FR),0079,0024 FR PARIS SUD (DC),631,873,528,522,6,351,345,0,242,-38.35182250396196,41,22,22,22,0,0,0,0,-19,46.34146341463415,100.0,100.0,0.0,60.48109965635739,59.79381443298969,0.6872852233676952,Previsions
2806,0,2019-01-29,133904,DANONE BIO NATURE SUCRE 125X4,0,0,0,DANONE,0,Bailleul(FR),0078,0024 FR PARIS NORD (DC),631,873,528,522,6,351,345,0,242,-38.35182250396196,114,351,6,0,6,351,345,0,237,-207.89473684210526,1.7094017094017095,0.0,1.7094017094017095,60.48109965635739,59.79381443298969,0.6872852233676952,Previsions
2807,0,2019-01-29,140280,Activia chia/raspb/muesli 170g FR-copack,0,0,0,ACTIVIA,1,Roumanie(RO),0084,0024 FR AIX (DC),748,715,680,240,440,475,35,0,-33,4.411764705882353,16,141,141,30,111,111,0,0,125,-781.25,100.0,21.27659574468085,78.72340425531915,95.1048951048951,33.56643356643357,61.53846153846154,Transport
2808,0,2019-01-29,140280,Activia chia/raspb/muesli 170g FR-copack,0,0,0,ACTIVIA,1,Roumanie(RO),0080,0024 FR METZ (DC),748,715,680,240,440,475,35,0,-33,4.411764705882353,132,76,76,0,76,76,0,0,-56,42.42424242424242,100.0,0.0,100.0,95.1048951048951,33.56643356643357,61.53846153846154,Transport
2809,0,2019-01-29,140280,Activia chia/raspb/muesli 170g FR-copack,0,0,0,ACTIVIA,1,Roumanie(RO),0077,0024 FR LILPARK (DC),748,715,680,240,440,475,35,0,-33,4.411764705882353,165,114,79,0,79,114,35,0,-51,30.90909090909091,69.2982456140351,0.0,69.2982456140351,95.1048951048951,33.56643356643357,61.53846153846154,Transport
2810,0,2019-01-29,140280,Activia chia/raspb/muesli 170g FR-copack,0,0,0,ACTIVIA,1,Roumanie(RO),0085,0024 FR TOULOUSE (DC),748,715,680,240,440,475,35,0,-33,4.411764705882353,110,82,82,82,0,0,0,0,-28,25.454545454545453,100.0,100.0,0.0,95.1048951048951,33.56643356643357,61.53846153846154,Transport
2811,0,2019-01-29,140280,Activia chia/raspb/muesli 170g FR-copack,0,0,0,ACTIVIA,1,Roumanie(RO),0079,0024 FR PARIS SUD (DC),748,715,680,240,440,475,35,0,-33,4.411764705882353,105,110,110,0,110,110,0,0,5,-4.761904761904762,100.0,0.0,100.0,95.1048951048951,33.56643356643357,61.53846153846154,Transport
2812,0,2019-01-29,140280,Activia chia/raspb/muesli 170g FR-copack,0,0,0,ACTIVIA,1,Roumanie(RO),0078,0024 FR PARIS NORD (DC),748,715,680,240,440,475,35,0,-33,4.411764705882353,220,192,192,128,64,64,0,0,-28,12.727272727272727,100.0,66.66666666666666,33.33333333333334,95.1048951048951,33.56643356643357,61.53846153846154,Transport
2813,1,2019-01-29,142600,ACTIMEL MULT-PEA/RO.JEL 4x(8+4x100g) FR,1,1,0,ACTIMEL,1,Rotselaar(BE),0078,0024 FR PARIS NORD (DC),221,866,779,639,140,227,87,0,645,-291.8552036199095,221,140,140,0,140,140,0,0,-81,36.65158371040724,100.0,0.0,100.0,89.95381062355659,73.78752886836027,16.166281755196323,Production
2814,1,2019-01-29,142614,ACTIMEL NATURE 0% 4x(8+4x100g) FR,1,1,0,ACTIMEL,1,Rotselaar(BE),0085,0024 FR TOULOUSE (DC),345,1027,953,904,49,123,74,0,682,-197.68115942028984,345,195,195,169,26,26,0,0,-150,43.47826086956522,100.0,86.66666666666667,13.333333333333329,92.79454722492697,88.02336903602726,4.771178188899711,Production
2815,0,2019-01-29,142615,ACTIMEL STRAWBERRY 4x(8+4x100g) FR,1,1,0,ACTIMEL,1,Rotselaar(BE),0084,0024 FR AIX (DC),1618,1446,1344,1152,192,294,102,0,-172,10.630407911001235,124,68,68,43,25,25,0,0,-56,45.16129032258065,100.0,63.23529411764706,36.76470588235294,92.9460580912863,79.66804979253112,13.278008298755182,Production
2816,0,2019-01-29,142615,ACTIMEL STRAWBERRY 4x(8+4x100g) FR,1,1,0,ACTIMEL,1,Rotselaar(BE),0080,0024 FR METZ (DC),1618,1446,1344,1152,192,294,102,0,-172,10.630407911001235,123,86,86,86,0,0,0,0,-37,30.08130081300813,100.0,100.0,0.0,92.9460580912863,79.66804979253112,13.278008298755182,Production
2817,0,2019-01-29,142615,ACTIMEL STRAWBERRY 4x(8+4x100g) FR,1,1,0,ACTIMEL,1,Rotselaar(BE),0081,0024 FR TOURS (DC),1618,1446,1344,1152,192,294,102,0,-172,10.630407911001235,128,109,83,26,57,83,26,0,-19,14.84375,76.14678899082568,23.853211009174313,52.29357798165137,92.9460580912863,79.66804979253112,13.278008298755182,Production
2818,0,2019-01-29,142615,ACTIMEL STRAWBERRY 4x(8+4x100g) FR,1,1,0,ACTIMEL,1,Rotselaar(BE),0077,0024 FR LILPARK (DC),1618,1446,1344,1152,192,294,102,0,-172,10.630407911001235,611,355,355,282,73,73,0,0,-256,41.89852700490999,100.0,79.43661971830987,20.56338028169013,92.9460580912863,79.66804979253112,13.278008298755182,Production
2819,0,2019-01-29,142615,ACTIMEL STRAWBERRY 4x(8+4x100g) FR,1,1,0,ACTIMEL,1,Rotselaar(BE),0085,0024 FR TOULOUSE (DC),1618,1446,1344,1152,192,294,102,0,-172,10.630407911001235,20,120,120,118,2,2,0,0,100,-500.0,100.0,98.33333333333333,1.6666666666666714,92.9460580912863,79.66804979253112,13.278008298755182,Production
2820,0,2019-01-29,142615,ACTIMEL STRAWBERRY 4x(8+4x100g) FR,1,1,0,ACTIMEL,1,Rotselaar(BE),0083,0024 FR CHAPONNAY (DC),1618,1446,1344,1152,192,294,102,0,-172,10.630407911001235,242,128,128,124,4,4,0,0,-114,47.107438016528924,100.0,96.875,3.125,92.9460580912863,79.66804979253112,13.278008298755182,Production
2821,0,2019-01-29,142615,ACTIMEL STRAWBERRY 4x(8+4x100g) FR,1,1,0,ACTIMEL,1,Rotselaar(BE),0079,0024 FR PARIS SUD (DC),1618,1446,1344,1152,192,294,102,0,-172,10.630407911001235,47,382,306,275,31,107,76,0,335,-712.7659574468086,80.10471204188482,71.98952879581152,8.1151832460733,92.9460580912863,79.66804979253112,13.278008298755182,Production
2822,0,2019-01-29,142615,ACTIMEL STRAWBERRY 4x(8+4x100g) FR,1,1,0,ACTIMEL,1,Rotselaar(BE),0078,0024 FR PARIS NORD (DC),1618,1446,1344,1152,192,294,102,0,-172,10.630407911001235,323,198,198,198,0,0,0,0,-125,38.69969040247678,100.0,100.0,0.0,92.9460580912863,79.66804979253112,13.278008298755182,Production
2823,0,2019-01-30,102483,JOCKEY FROM NATURE 100X8 3%,0,0,0,JOCKEY,0,Ferrières(FR),0084,0024 FR AIX (DC),1783,2202,1988,1979,9,223,214,0,419,-23.499719573752103,205,205,205,205,0,0,0,0,0,0.0,100.0,100.0,0.0,90.28156221616712,89.87284287011808,0.4087193460490397,Previsions
2824,0,2019-01-30,102483,JOCKEY FROM NATURE 100X8 3%,0,0,0,JOCKEY,0,Ferrières(FR),0080,0024 FR METZ (DC),1783,2202,1988,1979,9,223,214,0,419,-23.499719573752103,221,217,217,217,0,0,0,0,-4,1.8099547511312217,100.0,100.0,0.0,90.28156221616712,89.87284287011808,0.4087193460490397,Previsions
2825,0,2019-01-30,102483,JOCKEY FROM NATURE 100X8 3%,0,0,0,JOCKEY,0,Ferrières(FR),0081,0024 FR TOURS (DC),1783,2202,1988,1979,9,223,214,0,419,-23.499719573752103,298,308,308,308,0,0,0,0,10,-3.3557046979865772,100.0,100.0,0.0,90.28156221616712,89.87284287011808,0.4087193460490397,Previsions
2826,0,2019-01-30,102483,JOCKEY FROM NATURE 100X8 3%,0,0,0,JOCKEY,0,Ferrières(FR),0082,0024 FR VALLET (DC),1783,2202,1988,1979,9,223,214,0,419,-23.499719573752103,218,239,239,239,0,0,0,0,21,-9.63302752293578,100.0,100.0,0.0,90.28156221616712,89.87284287011808,0.4087193460490397,Previsions
2827,0,2019-01-30,102483,JOCKEY FROM NATURE 100X8 3%,0,0,0,JOCKEY,0,Ferrières(FR),0077,0024 FR LILPARK (DC),1783,2202,1988,1979,9,223,214,0,419,-23.499719573752103,93,71,71,71,0,0,0,0,-22,23.655913978494624,100.0,100.0,0.0,90.28156221616712,89.87284287011808,0.4087193460490397,Previsions
2828,0,2019-01-30,102483,JOCKEY FROM NATURE 100X8 3%,0,0,0,JOCKEY,0,Ferrières(FR),0085,0024 FR TOULOUSE (DC),1783,2202,1988,1979,9,223,214,0,419,-23.499719573752103,32,363,363,363,0,0,0,0,331,-1034.375,100.0,100.0,0.0,90.28156221616712,89.87284287011808,0.4087193460490397,Previsions
2829,0,2019-01-30,102483,JOCKEY FROM NATURE 100X8 3%,0,0,0,JOCKEY,0,Ferrières(FR),0083,0024 FR CHAPONNAY (DC),1783,2202,1988,1979,9,223,214,0,419,-23.499719573752103,248,235,235,235,0,0,0,0,-13,5.241935483870968,100.0,100.0,0.0,90.28156221616712,89.87284287011808,0.4087193460490397,Previsions
2830,0,2019-01-30,102483,JOCKEY FROM NATURE 100X8 3%,0,0,0,JOCKEY,0,Ferrières(FR),0079,0024 FR PARIS SUD (DC),1783,2202,1988,1979,9,223,214,0,419,-23.499719573752103,226,234,102,102,0,132,132,0,8,-3.5398230088495577,43.58974358974359,43.58974358974359,0.0,90.28156221616712,89.87284287011808,0.4087193460490397,Previsions
2831,0,2019-01-30,102483,JOCKEY FROM NATURE 100X8 3%,0,0,0,JOCKEY,0,Ferrières(FR),0078,0024 FR PARIS NORD (DC),1783,2202,1988,1979,9,223,214,0,419,-23.499719573752103,242,330,248,239,9,91,82,0,88,-36.36363636363637,75.15151515151514,72.42424242424242,2.7272727272727195,90.28156221616712,89.87284287011808,0.4087193460490397,Previsions
2832,0,2019-01-30,121526,TAILLEFINE RED FRUIT 125X8,0,0,0,TAILLEFINE,0,Villecomtal(FR),0084,0024 FR AIX (DC),1295,1334,1197,1196,1,138,137,0,39,-3.011583011583012,126,147,147,147,0,0,0,0,21,-16.666666666666668,100.0,100.0,0.0,89.73013493253373,89.65517241379311,0.07496251874061954,Previsions
2833,0,2019-01-30,121526,TAILLEFINE RED FRUIT 125X8,0,0,0,TAILLEFINE,0,Villecomtal(FR),0080,0024 FR METZ (DC),1295,1334,1197,1196,1,138,137,0,39,-3.011583011583012,174,160,160,160,0,0,0,0,-14,8.045977011494253,100.0,100.0,0.0,89.73013493253373,89.65517241379311,0.07496251874061954,Previsions
2834,0,2019-01-30,121526,TAILLEFINE RED FRUIT 125X8,0,0,0,TAILLEFINE,0,Villecomtal(FR),0081,0024 FR TOURS (DC),1295,1334,1197,1196,1,138,137,0,39,-3.011583011583012,139,113,113,113,0,0,0,0,-26,18.705035971223023,100.0,100.0,0.0,89.73013493253373,89.65517241379311,0.07496251874061954,Previsions
2835,0,2019-01-30,121526,TAILLEFINE RED FRUIT 125X8,0,0,0,TAILLEFINE,0,Villecomtal(FR),0082,0024 FR VALLET (DC),1295,1334,1197,1196,1,138,137,0,39,-3.011583011583012,116,100,100,100,0,0,0,0,-16,13.793103448275861,100.0,100.0,0.0,89.73013493253373,89.65517241379311,0.07496251874061954,Previsions
2836,0,2019-01-30,121526,TAILLEFINE RED FRUIT 125X8,0,0,0,TAILLEFINE,0,Villecomtal(FR),0077,0024 FR LILPARK (DC),1295,1334,1197,1196,1,138,137,0,39,-3.011583011583012,264,122,96,96,0,26,26,0,-142,53.78787878787879,78.68852459016394,78.68852459016394,0.0,89.73013493253373,89.65517241379311,0.07496251874061954,Previsions
2837,0,2019-01-30,121526,TAILLEFINE RED FRUIT 125X8,0,0,0,TAILLEFINE,0,Villecomtal(FR),0085,0024 FR TOULOUSE (DC),1295,1334,1197,1196,1,138,137,0,39,-3.011583011583012,19,168,168,168,0,0,0,0,149,-784.2105263157895,100.0,100.0,0.0,89.73013493253373,89.65517241379311,0.07496251874061954,Previsions
2838,0,2019-01-30,121526,TAILLEFINE RED FRUIT 125X8,0,0,0,TAILLEFINE,0,Villecomtal(FR),0083,0024 FR CHAPONNAY (DC),1295,1334,1197,1196,1,138,137,0,39,-3.011583011583012,243,261,182,181,1,80,79,0,18,-7.407407407407407,69.73180076628353,69.34865900383141,0.3831417624521123,89.73013493253373,89.65517241379311,0.07496251874061954,Previsions
2839,0,2019-01-30,121526,TAILLEFINE RED FRUIT 125X8,0,0,0,TAILLEFINE,0,Villecomtal(FR),0078,0024 FR PARIS NORD (DC),1295,1334,1197,1196,1,138,137,0,39,-3.011583011583012,214,263,231,231,0,32,32,0,49,-22.897196261682243,87.83269961977186,87.83269961977186,0.0,89.73013493253373,89.65517241379311,0.07496251874061954,Previsions
2840,0,2019-01-30,139104,ALPRO COCONUT-ALMOND DRINK 8X1L,0,0,0,ALPRO,1,Wevelgem(BE),0080,0024 FR METZ (DC),34,355,341,125,216,230,14,0,321,-944.1176470588235,14,26,12,12,0,14,14,0,12,-85.71428571428571,46.15384615384615,46.15384615384615,0.0,96.05633802816902,35.2112676056338,60.84507042253522,A Creuser
2841,0,2019-01-30,139104,ALPRO COCONUT-ALMOND DRINK 8X1L,0,0,0,ALPRO,1,Wevelgem(BE),0081,0024 FR TOURS (DC),34,355,341,125,216,230,14,0,321,-944.1176470588235,5,4,4,4,0,0,0,0,-1,20.0,100.0,100.0,0.0,96.05633802816902,35.2112676056338,60.84507042253522,A Creuser
2842,0,2019-01-30,139104,ALPRO COCONUT-ALMOND DRINK 8X1L,0,0,0,ALPRO,1,Wevelgem(BE),0085,0024 FR TOULOUSE (DC),34,355,341,125,216,230,14,0,321,-944.1176470588235,7,3,3,3,0,0,0,0,-4,57.142857142857146,100.0,100.0,0.0,96.05633802816902,35.2112676056338,60.84507042253522,A Creuser
2843,0,2019-01-30,139104,ALPRO COCONUT-ALMOND DRINK 8X1L,0,0,0,ALPRO,1,Wevelgem(BE),0083,0024 FR CHAPONNAY (DC),34,355,341,125,216,230,14,0,321,-944.1176470588235,4,1,1,1,0,0,0,0,-3,75.0,100.0,100.0,0.0,96.05633802816902,35.2112676056338,60.84507042253522,A Creuser
2844,0,2019-01-30,139104,ALPRO COCONUT-ALMOND DRINK 8X1L,0,0,0,ALPRO,1,Wevelgem(BE),0079,0024 FR PARIS SUD (DC),34,355,341,125,216,230,14,0,321,-944.1176470588235,4,5,5,5,0,0,0,0,1,-25.0,100.0,100.0,0.0,96.05633802816902,35.2112676056338,60.84507042253522,A Creuser
2845,0,2019-01-30,139611,ALPRO OAT-ALMOND DRINK 1LX8,0,0,0,ALPRO,1,Wevelgem(BE),0080,0024 FR METZ (DC),35,224,220,71,149,153,4,0,189,-540.0,10,16,16,16,0,0,0,0,6,-60.0,100.0,100.0,0.0,98.21428571428571,31.69642857142857,66.51785714285714,A Creuser
2846,0,2019-01-30,139611,ALPRO OAT-ALMOND DRINK 1LX8,0,0,0,ALPRO,1,Wevelgem(BE),0081,0024 FR TOURS (DC),35,224,220,71,149,153,4,0,189,-540.0,6,5,5,5,0,0,0,0,-1,16.666666666666668,100.0,100.0,0.0,98.21428571428571,31.69642857142857,66.51785714285714,A Creuser
2847,0,2019-01-30,139611,ALPRO OAT-ALMOND DRINK 1LX8,0,0,0,ALPRO,1,Wevelgem(BE),0082,0024 FR VALLET (DC),35,224,220,71,149,153,4,0,189,-540.0,4,1,1,1,0,0,0,0,-3,75.0,100.0,100.0,0.0,98.21428571428571,31.69642857142857,66.51785714285714,A Creuser
2848,0,2019-01-30,139611,ALPRO OAT-ALMOND DRINK 1LX8,0,0,0,ALPRO,1,Wevelgem(BE),0085,0024 FR TOULOUSE (DC),35,224,220,71,149,153,4,0,189,-540.0,5,3,3,3,0,0,0,0,-2,40.0,100.0,100.0,0.0,98.21428571428571,31.69642857142857,66.51785714285714,A Creuser
2849,0,2019-01-30,139611,ALPRO OAT-ALMOND DRINK 1LX8,0,0,0,ALPRO,1,Wevelgem(BE),0083,0024 FR CHAPONNAY (DC),35,224,220,71,149,153,4,0,189,-540.0,5,3,3,3,0,0,0,0,-2,40.0,100.0,100.0,0.0,98.21428571428571,31.69642857142857,66.51785714285714,A Creuser
2850,0,2019-01-30,139611,ALPRO OAT-ALMOND DRINK 1LX8,0,0,0,ALPRO,1,Wevelgem(BE),0079,0024 FR PARIS SUD (DC),35,224,220,71,149,153,4,0,189,-540.0,4,3,3,3,0,0,0,0,-1,25.0,100.0,100.0,0.0,98.21428571428571,31.69642857142857,66.51785714285714,A Creuser
2851,0,2019-01-30,139611,ALPRO OAT-ALMOND DRINK 1LX8,0,0,0,ALPRO,1,Wevelgem(BE),0078,0024 FR PARIS NORD (DC),35,224,220,71,149,153,4,0,189,-540.0,1,8,4,4,0,4,4,0,7,-700.0,50.0,50.0,0.0,98.21428571428571,31.69642857142857,66.51785714285714,A Creuser
2852,0,2019-01-30,140278,Activia almond/muesli/chia 170g FR-copac,0,0,0,ACTIVIA,1,Roumanie(RO),0084,0024 FR AIX (DC),710,558,403,336,67,222,155,0,-152,21.408450704225352,91,58,58,58,0,0,0,0,-33,36.26373626373626,100.0,100.0,0.0,72.22222222222221,60.215053763440864,12.00716845878135,Transport
2853,0,2019-01-30,140278,Activia almond/muesli/chia 170g FR-copac,0,0,0,ACTIVIA,1,Roumanie(RO),0080,0024 FR METZ (DC),710,558,403,336,67,222,155,0,-152,21.408450704225352,58,74,74,74,0,0,0,0,16,-27.586206896551722,100.0,100.0,0.0,72.22222222222221,60.215053763440864,12.00716845878135,Transport
2854,0,2019-01-30,140278,Activia almond/muesli/chia 170g FR-copac,0,0,0,ACTIVIA,1,Roumanie(RO),0081,0024 FR TOURS (DC),710,558,403,336,67,222,155,0,-152,21.408450704225352,65,67,61,0,61,67,6,0,2,-3.076923076923077,91.04477611940298,0.0,91.04477611940298,72.22222222222221,60.215053763440864,12.00716845878135,Transport
2855,0,2019-01-30,140278,Activia almond/muesli/chia 170g FR-copac,0,0,0,ACTIVIA,1,Roumanie(RO),0082,0024 FR VALLET (DC),710,558,403,336,67,222,155,0,-152,21.408450704225352,57,59,59,59,0,0,0,0,2,-3.508771929824561,100.0,100.0,0.0,72.22222222222221,60.215053763440864,12.00716845878135,Transport
2856,0,2019-01-30,140278,Activia almond/muesli/chia 170g FR-copac,0,0,0,ACTIVIA,1,Roumanie(RO),0077,0024 FR LILPARK (DC),710,558,403,336,67,222,155,0,-152,21.408450704225352,100,6,6,6,0,0,0,0,-94,94.0,100.0,100.0,0.0,72.22222222222221,60.215053763440864,12.00716845878135,Transport
2857,0,2019-01-30,140278,Activia almond/muesli/chia 170g FR-copac,0,0,0,ACTIVIA,1,Roumanie(RO),0085,0024 FR TOULOUSE (DC),710,558,403,336,67,222,155,0,-152,21.408450704225352,66,54,54,54,0,0,0,0,-12,18.181818181818183,100.0,100.0,0.0,72.22222222222221,60.215053763440864,12.00716845878135,Transport
2858,0,2019-01-30,140278,Activia almond/muesli/chia 170g FR-copac,0,0,0,ACTIVIA,1,Roumanie(RO),0083,0024 FR CHAPONNAY (DC),710,558,403,336,67,222,155,0,-152,21.408450704225352,60,58,38,38,0,20,20,0,-2,3.3333333333333335,65.51724137931035,65.51724137931035,0.0,72.22222222222221,60.215053763440864,12.00716845878135,Transport
2859,0,2019-01-30,140278,Activia almond/muesli/chia 170g FR-copac,0,0,0,ACTIVIA,1,Roumanie(RO),0079,0024 FR PARIS SUD (DC),710,558,403,336,67,222,155,0,-152,21.408450704225352,84,52,37,31,6,21,15,0,-32,38.095238095238095,71.15384615384616,59.61538461538461,11.538461538461547,72.22222222222221,60.215053763440864,12.00716845878135,Transport
2860,0,2019-01-30,140278,Activia almond/muesli/chia 170g FR-copac,0,0,0,ACTIVIA,1,Roumanie(RO),0078,0024 FR PARIS NORD (DC),710,558,403,336,67,222,155,0,-152,21.408450704225352,129,130,16,16,0,114,114,0,1,-0.7751937984496124,12.307692307692308,12.307692307692308,0.0,72.22222222222221,60.215053763440864,12.00716845878135,Transport
2861,0,2019-01-31,79537,LES 2 VACHES FLAN BIO 100X4,0,0,0,LES 2 VACHES,0,LeMolay(FR),0084,0024 FR AIX (DC),2128,1355,1055,1053,2,302,300,0,-773,36.32518796992481,385,259,259,259,0,0,0,0,-126,32.72727272727273,100.0,100.0,0.0,77.85977859778598,77.71217712177122,0.14760147601475637,Previsions
2862,0,2019-01-31,79537,LES 2 VACHES FLAN BIO 100X4,0,0,0,LES 2 VACHES,0,LeMolay(FR),0080,0024 FR METZ (DC),2128,1355,1055,1053,2,302,300,0,-773,36.32518796992481,172,160,153,153,0,7,7,0,-12,6.976744186046512,95.625,95.625,0.0,77.85977859778598,77.71217712177122,0.14760147601475637,Previsions
2863,0,2019-01-31,79537,LES 2 VACHES FLAN BIO 100X4,0,0,0,LES 2 VACHES,0,LeMolay(FR),0081,0024 FR TOURS (DC),2128,1355,1055,1053,2,302,300,0,-773,36.32518796992481,162,125,110,108,2,17,15,0,-37,22.839506172839506,88.0,86.4,1.5999999999999943,77.85977859778598,77.71217712177122,0.14760147601475637,Previsions
2864,0,2019-01-31,79537,LES 2 VACHES FLAN BIO 100X4,0,0,0,LES 2 VACHES,0,LeMolay(FR),0077,0024 FR LILPARK (DC),2128,1355,1055,1053,2,302,300,0,-773,36.32518796992481,91,69,66,66,0,3,3,0,-22,24.175824175824175,95.65217391304348,95.65217391304348,0.0,77.85977859778598,77.71217712177122,0.14760147601475637,Previsions
2865,0,2019-01-31,79537,LES 2 VACHES FLAN BIO 100X4,0,0,0,LES 2 VACHES,0,LeMolay(FR),0085,0024 FR TOULOUSE (DC),2128,1355,1055,1053,2,302,300,0,-773,36.32518796992481,105,111,111,111,0,0,0,0,6,-5.714285714285714,100.0,100.0,0.0,77.85977859778598,77.71217712177122,0.14760147601475637,Previsions
2866,0,2019-01-31,79537,LES 2 VACHES FLAN BIO 100X4,0,0,0,LES 2 VACHES,0,LeMolay(FR),0083,0024 FR CHAPONNAY (DC),2128,1355,1055,1053,2,302,300,0,-773,36.32518796992481,268,149,149,149,0,0,0,0,-119,44.40298507462686,100.0,100.0,0.0,77.85977859778598,77.71217712177122,0.14760147601475637,Previsions
2867,0,2019-01-31,79537,LES 2 VACHES FLAN BIO 100X4,0,0,0,LES 2 VACHES,0,LeMolay(FR),0079,0024 FR PARIS SUD (DC),2128,1355,1055,1053,2,302,300,0,-773,36.32518796992481,286,157,155,155,0,2,2,0,-129,45.10489510489511,98.72611464968153,98.72611464968153,0.0,77.85977859778598,77.71217712177122,0.14760147601475637,Previsions
2868,0,2019-01-31,79537,LES 2 VACHES FLAN BIO 100X4,0,0,0,LES 2 VACHES,0,LeMolay(FR),0078,0024 FR PARIS NORD (DC),2128,1355,1055,1053,2,302,300,0,-773,36.32518796992481,659,325,52,52,0,273,273,0,-334,50.682852807283766,16.0,16.0,0.0,77.85977859778598,77.71217712177122,0.14760147601475637,Previsions
2869,0,2019-01-31,102483,JOCKEY FROM NATURE 100X8 3%,0,0,0,JOCKEY,0,Ferrières(FR),0084,0024 FR AIX (DC),2405,2526,2478,1977,501,549,48,0,121,-5.031185031185031,223,128,128,128,0,0,0,0,-95,42.600896860986545,100.0,100.0,0.0,98.09976247030879,78.26603325415678,19.83372921615201,Previsions
2870,0,2019-01-31,102483,JOCKEY FROM NATURE 100X8 3%,0,0,0,JOCKEY,0,Ferrières(FR),0080,0024 FR METZ (DC),2405,2526,2478,1977,501,549,48,0,121,-5.031185031185031,126,142,142,142,0,0,0,0,16,-12.698412698412698,100.0,100.0,0.0,98.09976247030879,78.26603325415678,19.83372921615201,Previsions
2871,0,2019-01-31,102483,JOCKEY FROM NATURE 100X8 3%,0,0,0,JOCKEY,0,Ferrières(FR),0081,0024 FR TOURS (DC),2405,2526,2478,1977,501,549,48,0,121,-5.031185031185031,368,363,363,232,131,131,0,0,-5,1.358695652173913,100.0,63.91184573002755,36.08815426997245,98.09976247030879,78.26603325415678,19.83372921615201,Previsions
2872,0,2019-01-31,102483,JOCKEY FROM NATURE 100X8 3%,0,0,0,JOCKEY,0,Ferrières(FR),0082,0024 FR VALLET (DC),2405,2526,2478,1977,501,549,48,0,121,-5.031185031185031,190,186,186,186,0,0,0,0,-4,2.1052631578947367,100.0,100.0,0.0,98.09976247030879,78.26603325415678,19.83372921615201,Previsions
2873,0,2019-01-31,102483,JOCKEY FROM NATURE 100X8 3%,0,0,0,JOCKEY,0,Ferrières(FR),0077,0024 FR LILPARK (DC),2405,2526,2478,1977,501,549,48,0,121,-5.031185031185031,189,192,192,192,0,0,0,0,3,-1.5873015873015872,100.0,100.0,0.0,98.09976247030879,78.26603325415678,19.83372921615201,Previsions
2874,0,2019-01-31,102483,JOCKEY FROM NATURE 100X8 3%,0,0,0,JOCKEY,0,Ferrières(FR),0085,0024 FR TOULOUSE (DC),2405,2526,2478,1977,501,549,48,0,121,-5.031185031185031,337,370,343,343,0,27,27,0,33,-9.792284866468842,92.7027027027027,92.7027027027027,0.0,98.09976247030879,78.26603325415678,19.83372921615201,Previsions
2875,0,2019-01-31,102483,JOCKEY FROM NATURE 100X8 3%,0,0,0,JOCKEY,0,Ferrières(FR),0083,0024 FR CHAPONNAY (DC),2405,2526,2478,1977,501,549,48,0,121,-5.031185031185031,369,418,402,402,0,16,16,0,49,-13.279132791327914,96.17224880382776,96.17224880382776,0.0,98.09976247030879,78.26603325415678,19.83372921615201,Previsions
2876,0,2019-01-31,102483,JOCKEY FROM NATURE 100X8 3%,0,0,0,JOCKEY,0,Ferrières(FR),0079,0024 FR PARIS SUD (DC),2405,2526,2478,1977,501,549,48,0,121,-5.031185031185031,380,364,364,197,167,167,0,0,-16,4.2105263157894735,100.0,54.12087912087912,45.87912087912088,98.09976247030879,78.26603325415678,19.83372921615201,Previsions
2877,0,2019-01-31,102483,JOCKEY FROM NATURE 100X8 3%,0,0,0,JOCKEY,0,Ferrières(FR),0078,0024 FR PARIS NORD (DC),2405,2526,2478,1977,501,549,48,0,121,-5.031185031185031,223,363,358,155,203,208,5,0,140,-62.780269058295964,98.62258953168043,42.69972451790633,55.9228650137741,98.09976247030879,78.26603325415678,19.83372921615201,Previsions
2878,0,2019-01-31,115511,LES 2 VACHES PEAR 115X4,0,0,0,LES 2 VACHES,0,LeMolay(FR),0084,0024 FR AIX (DC),653,1292,514,511,3,781,778,0,639,-97.85604900459418,110,44,44,44,0,0,0,0,-66,60.0,100.0,100.0,0.0,39.78328173374613,39.55108359133127,0.23219814241485892,Previsions
2879,0,2019-01-31,115511,LES 2 VACHES PEAR 115X4,0,0,0,LES 2 VACHES,0,LeMolay(FR),0080,0024 FR METZ (DC),653,1292,514,511,3,781,778,0,639,-97.85604900459418,74,50,50,50,0,0,0,0,-24,32.432432432432435,100.0,100.0,0.0,39.78328173374613,39.55108359133127,0.23219814241485892,Previsions
2880,0,2019-01-31,115511,LES 2 VACHES PEAR 115X4,0,0,0,LES 2 VACHES,0,LeMolay(FR),0081,0024 FR TOURS (DC),653,1292,514,511,3,781,778,0,639,-97.85604900459418,100,70,70,70,0,0,0,0,-30,30.0,100.0,100.0,0.0,39.78328173374613,39.55108359133127,0.23219814241485892,Previsions
2881,0,2019-01-31,115511,LES 2 VACHES PEAR 115X4,0,0,0,LES 2 VACHES,0,LeMolay(FR),0082,0024 FR VALLET (DC),653,1292,514,511,3,781,778,0,639,-97.85604900459418,78,53,53,53,0,0,0,0,-25,32.05128205128205,100.0,100.0,0.0,39.78328173374613,39.55108359133127,0.23219814241485892,Previsions
2882,0,2019-01-31,115511,LES 2 VACHES PEAR 115X4,0,0,0,LES 2 VACHES,0,LeMolay(FR),0077,0024 FR LILPARK (DC),653,1292,514,511,3,781,778,0,639,-97.85604900459418,3,77,77,77,0,0,0,0,74,-2466.6666666666665,100.0,100.0,0.0,39.78328173374613,39.55108359133127,0.23219814241485892,Previsions
2883,0,2019-01-31,115511,LES 2 VACHES PEAR 115X4,0,0,0,LES 2 VACHES,0,LeMolay(FR),0085,0024 FR TOULOUSE (DC),653,1292,514,511,3,781,778,0,639,-97.85604900459418,89,51,51,51,0,0,0,0,-38,42.69662921348315,100.0,100.0,0.0,39.78328173374613,39.55108359133127,0.23219814241485892,Previsions
2884,0,2019-01-31,115511,LES 2 VACHES PEAR 115X4,0,0,0,LES 2 VACHES,0,LeMolay(FR),0083,0024 FR CHAPONNAY (DC),653,1292,514,511,3,781,778,0,639,-97.85604900459418,138,70,70,70,0,0,0,0,-68,49.27536231884058,100.0,100.0,0.0,39.78328173374613,39.55108359133127,0.23219814241485892,Previsions
2885,0,2019-01-31,115511,LES 2 VACHES PEAR 115X4,0,0,0,LES 2 VACHES,0,LeMolay(FR),0079,0024 FR PARIS SUD (DC),653,1292,514,511,3,781,778,0,639,-97.85604900459418,16,101,96,96,0,5,5,0,85,-531.25,95.04950495049505,95.04950495049505,0.0,39.78328173374613,39.55108359133127,0.23219814241485892,Previsions
2886,0,2019-01-31,115511,LES 2 VACHES PEAR 115X4,0,0,0,LES 2 VACHES,0,LeMolay(FR),0078,0024 FR PARIS NORD (DC),653,1292,514,511,3,781,778,0,639,-97.85604900459418,45,776,3,0,3,776,773,0,731,-1624.4444444444443,0.3865979381443299,0.0,0.3865979381443299,39.78328173374613,39.55108359133127,0.23219814241485892,Previsions
2887,1,2019-01-31,131483,ACTIVIA FRT STRAWBERRY 125X4 OD,1,0,0,ACTIVIA,0,Villecomtal(FR),0085,0024 FR TOULOUSE (DC),123,961,960,828,132,133,1,0,838,-681.30081300813,55,39,39,13,26,26,0,0,-16,29.09090909090909,100.0,33.33333333333333,66.66666666666667,99.89594172736732,86.16024973985432,13.735691987512993,Probleme Copacking
2888,1,2019-01-31,131483,ACTIVIA FRT STRAWBERRY 125X4 OD,1,0,0,ACTIVIA,0,Villecomtal(FR),0083,0024 FR CHAPONNAY (DC),123,961,960,828,132,133,1,0,838,-681.30081300813,68,101,100,0,100,101,1,0,33,-48.529411764705884,99.00990099009901,0.0,99.00990099009901,99.89594172736732,86.16024973985432,13.735691987512993,Probleme Copacking
2889,1,2019-01-31,136051,ACTIVIA 4X120G(x6) GRANOLA FR PROMO,1,0,0,ACTIVIA,1,Ochsenfurt(ALL),0077,0024 FR LILPARK (DC),315,957,957,926,31,31,0,0,642,-203.8095238095238,315,189,189,158,31,31,0,0,-126,40.0,100.0,83.5978835978836,16.402116402116405,100.0,96.760710553814,3.2392894461860067,Transport
2890,1,2019-02-01,83923,ACTIMEL NATU 3x(14x100g) FR,0,0,0,ACTIMEL,1,Rotselaar(BE),0078,0024 FR PARIS NORD (DC),212,1129,1098,1083,15,46,31,0,917,-432.54716981132077,212,169,169,154,15,15,0,0,-43,20.28301886792453,100.0,91.12426035502959,8.875739644970409,97.25420726306466,95.92559787422498,1.3286093888396806,Previsions
2891,0,2019-02-01,102481,ACTIVIA CHEESE VANILLA 120X4,0,0,0,ACTIVIA,0,Ferrières(FR),0084,0024 FR AIX (DC),400,533,114,95,19,438,419,0,133,-33.25,89,103,20,17,3,86,83,0,14,-15.730337078651685,19.41747572815534,16.50485436893204,2.912621359223298,21.388367729831145,17.823639774859288,3.5647279549718576,Previsions
2892,0,2019-02-01,102481,ACTIVIA CHEESE VANILLA 120X4,0,0,0,ACTIVIA,0,Ferrières(FR),0080,0024 FR METZ (DC),400,533,114,95,19,438,419,0,133,-33.25,77,86,9,8,1,78,77,0,9,-11.688311688311689,10.465116279069768,9.30232558139535,1.162790697674419,21.388367729831145,17.823639774859288,3.5647279549718576,Previsions
2893,0,2019-02-01,102481,ACTIVIA CHEESE VANILLA 120X4,0,0,0,ACTIVIA,0,Ferrières(FR),0081,0024 FR TOURS (DC),400,533,114,95,19,438,419,0,133,-33.25,8,84,13,10,3,74,71,0,76,-950.0,15.476190476190476,11.904761904761903,3.571428571428573,21.388367729831145,17.823639774859288,3.5647279549718576,Previsions
2894,0,2019-02-01,102481,ACTIVIA CHEESE VANILLA 120X4,0,0,0,ACTIVIA,0,Ferrières(FR),0082,0024 FR VALLET (DC),400,533,114,95,19,438,419,0,133,-33.25,70,84,9,8,1,76,75,0,14,-20.0,10.714285714285714,9.523809523809524,1.1904761904761898,21.388367729831145,17.823639774859288,3.5647279549718576,Previsions
2895,0,2019-02-01,102481,ACTIVIA CHEESE VANILLA 120X4,0,0,0,ACTIVIA,0,Ferrières(FR),0085,0024 FR TOULOUSE (DC),400,533,114,95,19,438,419,0,133,-33.25,88,96,13,13,0,83,83,0,8,-9.090909090909092,13.541666666666666,13.541666666666666,0.0,21.388367729831145,17.823639774859288,3.5647279549718576,Previsions
2896,0,2019-02-01,102481,ACTIVIA CHEESE VANILLA 120X4,0,0,0,ACTIVIA,0,Ferrières(FR),0078,0024 FR PARIS NORD (DC),400,533,114,95,19,438,419,0,133,-33.25,68,80,50,39,11,41,30,0,12,-17.647058823529413,62.5,48.75,13.75,21.388367729831145,17.823639774859288,3.5647279549718576,Previsions
2897,0,2019-02-01,122050,VELOUTE FRUIX ROUGES 125X8 OD,1,0,0,VELOUTE,0,Villecomtal(FR),0084,0024 FR AIX (DC),7089,8064,8064,7831,233,233,0,0,975,-13.753702920016927,553,540,540,540,0,0,0,0,-13,2.3508137432188065,100.0,100.0,0.0,100.0,97.11061507936508,2.8893849206349245,Previsions
2898,0,2019-02-01,122050,VELOUTE FRUIX ROUGES 125X8 OD,1,0,0,VELOUTE,0,Villecomtal(FR),0080,0024 FR METZ (DC),7089,8064,8064,7831,233,233,0,0,975,-13.753702920016927,825,616,616,616,0,0,0,0,-209,25.333333333333332,100.0,100.0,0.0,100.0,97.11061507936508,2.8893849206349245,Previsions
2899,0,2019-02-01,122050,VELOUTE FRUIX ROUGES 125X8 OD,1,0,0,VELOUTE,0,Villecomtal(FR),0081,0024 FR TOURS (DC),7089,8064,8064,7831,233,233,0,0,975,-13.753702920016927,81,1046,1046,1046,0,0,0,0,965,-1191.358024691358,100.0,100.0,0.0,100.0,97.11061507936508,2.8893849206349245,Previsions
2900,0,2019-02-01,122050,VELOUTE FRUIX ROUGES 125X8 OD,1,0,0,VELOUTE,0,Villecomtal(FR),0082,0024 FR VALLET (DC),7089,8064,8064,7831,233,233,0,0,975,-13.753702920016927,245,333,333,333,0,0,0,0,88,-35.91836734693877,100.0,100.0,0.0,100.0,97.11061507936508,2.8893849206349245,Previsions
2901,1,2019-02-01,122050,VELOUTE FRUIX ROUGES 125X8 OD,1,0,0,VELOUTE,0,Villecomtal(FR),0077,0024 FR LILPARK (DC),7089,8064,8064,7831,233,233,0,0,975,-13.753702920016927,386,712,712,479,233,233,0,0,326,-84.4559585492228,100.0,67.2752808988764,32.7247191011236,100.0,97.11061507936508,2.8893849206349245,Transport
2902,0,2019-02-01,122050,VELOUTE FRUIX ROUGES 125X8 OD,1,0,0,VELOUTE,0,Villecomtal(FR),0077,0024 FR LILPARK (DC),7089,8064,8064,7831,233,233,0,0,975,-13.753702920016927,386,712,712,479,233,233,0,0,326,-84.4559585492228,100.0,67.2752808988764,32.7247191011236,100.0,97.11061507936508,2.8893849206349245,Previsions
2903,0,2019-02-01,122050,VELOUTE FRUIX ROUGES 125X8 OD,1,0,0,VELOUTE,0,Villecomtal(FR),0085,0024 FR TOULOUSE (DC),7089,8064,8064,7831,233,233,0,0,975,-13.753702920016927,1491,1351,1351,1351,0,0,0,0,-140,9.389671361502348,100.0,100.0,0.0,100.0,97.11061507936508,2.8893849206349245,Previsions
2904,0,2019-02-01,122050,VELOUTE FRUIX ROUGES 125X8 OD,1,0,0,VELOUTE,0,Villecomtal(FR),0083,0024 FR CHAPONNAY (DC),7089,8064,8064,7831,233,233,0,0,975,-13.753702920016927,1154,1372,1372,1372,0,0,0,0,218,-18.890814558058924,100.0,100.0,0.0,100.0,97.11061507936508,2.8893849206349245,Previsions
2905,0,2019-02-01,122050,VELOUTE FRUIX ROUGES 125X8 OD,1,0,0,VELOUTE,0,Villecomtal(FR),0079,0024 FR PARIS SUD (DC),7089,8064,8064,7831,233,233,0,0,975,-13.753702920016927,723,1010,1010,1010,0,0,0,0,287,-39.695712309820195,100.0,100.0,0.0,100.0,97.11061507936508,2.8893849206349245,Previsions
2906,0,2019-02-01,122050,VELOUTE FRUIX ROUGES 125X8 OD,1,0,0,VELOUTE,0,Villecomtal(FR),0078,0024 FR PARIS NORD (DC),7089,8064,8064,7831,233,233,0,0,975,-13.753702920016927,1245,1084,1084,1084,0,0,0,0,-161,12.931726907630521,100.0,100.0,0.0,100.0,97.11061507936508,2.8893849206349245,Previsions
2907,0,2019-02-01,133904,DANONE BIO NATURE SUCRE 125X4,0,0,0,DANONE,0,Bailleul(FR),0084,0024 FR AIX (DC),528,1135,848,844,4,291,287,0,607,-114.96212121212122,35,61,61,61,0,0,0,0,26,-74.28571428571429,100.0,100.0,0.0,74.7136563876652,74.36123348017621,0.35242290748898597,Previsions
2908,0,2019-02-01,133904,DANONE BIO NATURE SUCRE 125X4,0,0,0,DANONE,0,Bailleul(FR),0080,0024 FR METZ (DC),528,1135,848,844,4,291,287,0,607,-114.96212121212122,48,43,43,43,0,0,0,0,-5,10.416666666666666,100.0,100.0,0.0,74.7136563876652,74.36123348017621,0.35242290748898597,Previsions
2909,0,2019-02-01,133904,DANONE BIO NATURE SUCRE 125X4,0,0,0,DANONE,0,Bailleul(FR),0081,0024 FR TOURS (DC),528,1135,848,844,4,291,287,0,607,-114.96212121212122,20,41,41,41,0,0,0,0,21,-105.0,100.0,100.0,0.0,74.7136563876652,74.36123348017621,0.35242290748898597,Previsions
2910,0,2019-02-01,133904,DANONE BIO NATURE SUCRE 125X4,0,0,0,DANONE,0,Bailleul(FR),0082,0024 FR VALLET (DC),528,1135,848,844,4,291,287,0,607,-114.96212121212122,175,174,174,174,0,0,0,0,-1,0.5714285714285714,100.0,100.0,0.0,74.7136563876652,74.36123348017621,0.35242290748898597,Previsions
2911,0,2019-02-01,133904,DANONE BIO NATURE SUCRE 125X4,0,0,0,DANONE,0,Bailleul(FR),0077,0024 FR LILPARK (DC),528,1135,848,844,4,291,287,0,607,-114.96212121212122,41,20,20,20,0,0,0,0,-21,51.21951219512195,100.0,100.0,0.0,74.7136563876652,74.36123348017621,0.35242290748898597,Previsions
2912,0,2019-02-01,133904,DANONE BIO NATURE SUCRE 125X4,0,0,0,DANONE,0,Bailleul(FR),0085,0024 FR TOULOUSE (DC),528,1135,848,844,4,291,287,0,607,-114.96212121212122,28,53,53,53,0,0,0,0,25,-89.28571428571429,100.0,100.0,0.0,74.7136563876652,74.36123348017621,0.35242290748898597,Previsions
2913,0,2019-02-01,133904,DANONE BIO NATURE SUCRE 125X4,0,0,0,DANONE,0,Bailleul(FR),0083,0024 FR CHAPONNAY (DC),528,1135,848,844,4,291,287,0,607,-114.96212121212122,158,162,162,162,0,0,0,0,4,-2.5316455696202533,100.0,100.0,0.0,74.7136563876652,74.36123348017621,0.35242290748898597,Previsions
2914,0,2019-02-01,133904,DANONE BIO NATURE SUCRE 125X4,0,0,0,DANONE,0,Bailleul(FR),0079,0024 FR PARIS SUD (DC),528,1135,848,844,4,291,287,0,607,-114.96212121212122,5,78,78,78,0,0,0,0,73,-1460.0,100.0,100.0,0.0,74.7136563876652,74.36123348017621,0.35242290748898597,Previsions
2915,0,2019-02-01,133904,DANONE BIO NATURE SUCRE 125X4,0,0,0,DANONE,0,Bailleul(FR),0078,0024 FR PARIS NORD (DC),528,1135,848,844,4,291,287,0,607,-114.96212121212122,18,503,216,212,4,291,287,0,485,-2694.4444444444443,42.94234592445328,42.14711729622266,0.7952286282306176,74.7136563876652,74.36123348017621,0.35242290748898597,Previsions
2916,0,2019-02-01,142579,DANONE FERM NAT 125X12+4,1,1,0,DANONE,0,Bailleul(FR),0084,0024 FR AIX (DC),2000,2285,2136,1818,318,467,149,0,285,-14.25,243,300,300,300,0,0,0,0,57,-23.45679012345679,100.0,100.0,0.0,93.47921225382933,79.56236323851203,13.916849015317297,Previsions
2917,0,2019-02-01,142579,DANONE FERM NAT 125X12+4,1,1,0,DANONE,0,Bailleul(FR),0080,0024 FR METZ (DC),2000,2285,2136,1818,318,467,149,0,285,-14.25,119,106,106,106,0,0,0,0,-13,10.92436974789916,100.0,100.0,0.0,93.47921225382933,79.56236323851203,13.916849015317297,Previsions
2918,0,2019-02-01,142579,DANONE FERM NAT 125X12+4,1,1,0,DANONE,0,Bailleul(FR),0081,0024 FR TOURS (DC),2000,2285,2136,1818,318,467,149,0,285,-14.25,211,366,366,310,56,56,0,0,155,-73.45971563981043,100.0,84.69945355191257,15.300546448087431,93.47921225382933,79.56236323851203,13.916849015317297,Previsions
2919,0,2019-02-01,142579,DANONE FERM NAT 125X12+4,1,1,0,DANONE,0,Bailleul(FR),0085,0024 FR TOULOUSE (DC),2000,2285,2136,1818,318,467,149,0,285,-14.25,120,204,204,204,0,0,0,0,84,-70.0,100.0,100.0,0.0,93.47921225382933,79.56236323851203,13.916849015317297,Previsions
2920,0,2019-02-01,142579,DANONE FERM NAT 125X12+4,1,1,0,DANONE,0,Bailleul(FR),0083,0024 FR CHAPONNAY (DC),2000,2285,2136,1818,318,467,149,0,285,-14.25,471,521,372,341,31,180,149,0,50,-10.615711252653927,71.40115163147792,65.4510556621881,5.950095969289819,93.47921225382933,79.56236323851203,13.916849015317297,Previsions
2921,0,2019-02-01,142579,DANONE FERM NAT 125X12+4,1,1,0,DANONE,0,Bailleul(FR),0079,0024 FR PARIS SUD (DC),2000,2285,2136,1818,318,467,149,0,285,-14.25,463,432,432,431,1,1,0,0,-31,6.695464362850972,100.0,99.76851851851852,0.23148148148148096,93.47921225382933,79.56236323851203,13.916849015317297,Previsions
2922,0,2019-02-01,142579,DANONE FERM NAT 125X12+4,1,1,0,DANONE,0,Bailleul(FR),0078,0024 FR PARIS NORD (DC),2000,2285,2136,1818,318,467,149,0,285,-14.25,373,356,356,126,230,230,0,0,-17,4.557640750670242,100.0,35.39325842696629,64.6067415730337,93.47921225382933,79.56236323851203,13.916849015317297,Previsions
2923,0,2019-02-02,102481,ACTIVIA CHEESE VANILLA 120X4,0,0,0,ACTIVIA,0,Ferrières(FR),0084,0024 FR AIX (DC),550,613,585,295,290,318,28,0,63,-11.454545454545455,27,28,28,5,23,23,0,0,1,-3.7037037037037037,100.0,17.857142857142858,82.14285714285714,95.43230016313214,48.12398042414356,47.30831973898858,Previsions
2924,0,2019-02-02,102481,ACTIVIA CHEESE VANILLA 120X4,0,0,0,ACTIVIA,0,Ferrières(FR),0081,0024 FR TOURS (DC),550,613,585,295,290,318,28,0,63,-11.454545454545455,64,80,80,2,78,78,0,0,16,-25.0,100.0,2.5,97.5,95.43230016313214,48.12398042414356,47.30831973898858,Previsions
2925,0,2019-02-02,102481,ACTIVIA CHEESE VANILLA 120X4,0,0,0,ACTIVIA,0,Ferrières(FR),0082,0024 FR VALLET (DC),550,613,585,295,290,318,28,0,63,-11.454545454545455,56,29,1,0,1,29,28,0,-27,48.214285714285715,3.4482758620689653,0.0,3.4482758620689653,95.43230016313214,48.12398042414356,47.30831973898858,Previsions
2926,0,2019-02-02,102481,ACTIVIA CHEESE VANILLA 120X4,0,0,0,ACTIVIA,0,Ferrières(FR),0077,0024 FR LILPARK (DC),550,613,585,295,290,318,28,0,63,-11.454545454545455,94,96,96,33,63,63,0,0,2,-2.127659574468085,100.0,34.375,65.625,95.43230016313214,48.12398042414356,47.30831973898858,Previsions
2927,0,2019-02-02,102481,ACTIVIA CHEESE VANILLA 120X4,0,0,0,ACTIVIA,0,Ferrières(FR),0085,0024 FR TOULOUSE (DC),550,613,585,295,290,318,28,0,63,-11.454545454545455,104,102,102,84,18,18,0,0,-2,1.9230769230769231,100.0,82.35294117647058,17.64705882352942,95.43230016313214,48.12398042414356,47.30831973898858,Previsions
2928,0,2019-02-02,102481,ACTIVIA CHEESE VANILLA 120X4,0,0,0,ACTIVIA,0,Ferrières(FR),0083,0024 FR CHAPONNAY (DC),550,613,585,295,290,318,28,0,63,-11.454545454545455,4,75,75,10,65,65,0,0,71,-1775.0,100.0,13.333333333333334,86.66666666666667,95.43230016313214,48.12398042414356,47.30831973898858,Previsions
2929,0,2019-02-02,102481,ACTIVIA CHEESE VANILLA 120X4,0,0,0,ACTIVIA,0,Ferrières(FR),0079,0024 FR PARIS SUD (DC),550,613,585,295,290,318,28,0,63,-11.454545454545455,121,126,126,100,26,26,0,0,5,-4.132231404958677,100.0,79.36507936507937,20.634920634920633,95.43230016313214,48.12398042414356,47.30831973898858,Previsions
2930,0,2019-02-02,102481,ACTIVIA CHEESE VANILLA 120X4,0,0,0,ACTIVIA,0,Ferrières(FR),0078,0024 FR PARIS NORD (DC),550,613,585,295,290,318,28,0,63,-11.454545454545455,80,77,77,61,16,16,0,0,-3,3.75,100.0,79.22077922077922,20.77922077922078,95.43230016313214,48.12398042414356,47.30831973898858,Previsions
2931,0,2019-02-02,102497,ACTIVIA CHEESE STRAWBERRY 120X4,0,0,0,ACTIVIA,0,Ferrières(FR),0084,0024 FR AIX (DC),867,1065,955,778,177,287,110,0,198,-22.837370242214533,84,77,77,72,5,5,0,0,-7,8.333333333333334,100.0,93.5064935064935,6.493506493506501,89.67136150234741,73.05164319248826,16.619718309859152,Previsions
2932,0,2019-02-02,102497,ACTIVIA CHEESE STRAWBERRY 120X4,0,0,0,ACTIVIA,0,Ferrières(FR),0080,0024 FR METZ (DC),867,1065,955,778,177,287,110,0,198,-22.837370242214533,3,36,5,2,3,34,31,0,33,-1100.0,13.88888888888889,5.555555555555555,8.333333333333334,89.67136150234741,73.05164319248826,16.619718309859152,Previsions
2933,0,2019-02-02,102497,ACTIVIA CHEESE STRAWBERRY 120X4,0,0,0,ACTIVIA,0,Ferrières(FR),0081,0024 FR TOURS (DC),867,1065,955,778,177,287,110,0,198,-22.837370242214533,110,113,113,19,94,94,0,0,3,-2.727272727272727,100.0,16.8141592920354,83.1858407079646,89.67136150234741,73.05164319248826,16.619718309859152,Previsions
2934,0,2019-02-02,102497,ACTIVIA CHEESE STRAWBERRY 120X4,0,0,0,ACTIVIA,0,Ferrières(FR),0082,0024 FR VALLET (DC),867,1065,955,778,177,287,110,0,198,-22.837370242214533,10,88,9,0,9,88,79,0,78,-780.0,10.227272727272728,0.0,10.227272727272728,89.67136150234741,73.05164319248826,16.619718309859152,Previsions
2935,0,2019-02-02,102497,ACTIVIA CHEESE STRAWBERRY 120X4,0,0,0,ACTIVIA,0,Ferrières(FR),0077,0024 FR LILPARK (DC),867,1065,955,778,177,287,110,0,198,-22.837370242214533,108,132,132,86,46,46,0,0,24,-22.22222222222222,100.0,65.15151515151516,34.848484848484844,89.67136150234741,73.05164319248826,16.619718309859152,Previsions
2936,0,2019-02-02,102497,ACTIVIA CHEESE STRAWBERRY 120X4,0,0,0,ACTIVIA,0,Ferrières(FR),0085,0024 FR TOULOUSE (DC),867,1065,955,778,177,287,110,0,198,-22.837370242214533,147,160,160,140,20,20,0,0,13,-8.843537414965986,100.0,87.5,12.5,89.67136150234741,73.05164319248826,16.619718309859152,Previsions
2937,0,2019-02-02,102497,ACTIVIA CHEESE STRAWBERRY 120X4,0,0,0,ACTIVIA,0,Ferrières(FR),0083,0024 FR CHAPONNAY (DC),867,1065,955,778,177,287,110,0,198,-22.837370242214533,123,132,132,132,0,0,0,0,9,-7.317073170731708,100.0,100.0,0.0,89.67136150234741,73.05164319248826,16.619718309859152,Previsions
2938,0,2019-02-02,102497,ACTIVIA CHEESE STRAWBERRY 120X4,0,0,0,ACTIVIA,0,Ferrières(FR),0079,0024 FR PARIS SUD (DC),867,1065,955,778,177,287,110,0,198,-22.837370242214533,168,208,208,208,0,0,0,0,40,-23.80952380952381,100.0,100.0,0.0,89.67136150234741,73.05164319248826,16.619718309859152,Previsions
2939,0,2019-02-02,102497,ACTIVIA CHEESE STRAWBERRY 120X4,0,0,0,ACTIVIA,0,Ferrières(FR),0078,0024 FR PARIS NORD (DC),867,1065,955,778,177,287,110,0,198,-22.837370242214533,114,119,119,119,0,0,0,0,5,-4.385964912280702,100.0,100.0,0.0,89.67136150234741,73.05164319248826,16.619718309859152,Previsions
2940,0,2019-02-02,121320,ACTIMEL NATU 4x(12x100g) FR,0,0,0,ACTIMEL,1,Rotselaar(BE),0084,0024 FR AIX (DC),2516,2223,2223,1601,622,622,0,0,-293,11.645468998410175,312,300,300,300,0,0,0,0,-12,3.8461538461538463,100.0,100.0,0.0,100.0,72.01979307242465,27.980206927575352,A Creuser
2941,0,2019-02-02,121320,ACTIMEL NATU 4x(12x100g) FR,0,0,0,ACTIMEL,1,Rotselaar(BE),0080,0024 FR METZ (DC),2516,2223,2223,1601,622,622,0,0,-293,11.645468998410175,114,136,136,136,0,0,0,0,22,-19.29824561403509,100.0,100.0,0.0,100.0,72.01979307242465,27.980206927575352,A Creuser
2942,0,2019-02-02,121320,ACTIMEL NATU 4x(12x100g) FR,0,0,0,ACTIMEL,1,Rotselaar(BE),0081,0024 FR TOURS (DC),2516,2223,2223,1601,622,622,0,0,-293,11.645468998410175,270,266,266,266,0,0,0,0,-4,1.4814814814814814,100.0,100.0,0.0,100.0,72.01979307242465,27.980206927575352,A Creuser
2943,0,2019-02-02,121320,ACTIMEL NATU 4x(12x100g) FR,0,0,0,ACTIMEL,1,Rotselaar(BE),0082,0024 FR VALLET (DC),2516,2223,2223,1601,622,622,0,0,-293,11.645468998410175,182,116,116,116,0,0,0,0,-66,36.26373626373626,100.0,100.0,0.0,100.0,72.01979307242465,27.980206927575352,A Creuser
2944,0,2019-02-02,121320,ACTIMEL NATU 4x(12x100g) FR,0,0,0,ACTIMEL,1,Rotselaar(BE),0077,0024 FR LILPARK (DC),2516,2223,2223,1601,622,622,0,0,-293,11.645468998410175,196,150,150,150,0,0,0,0,-46,23.46938775510204,100.0,100.0,0.0,100.0,72.01979307242465,27.980206927575352,A Creuser
2945,0,2019-02-02,121320,ACTIMEL NATU 4x(12x100g) FR,0,0,0,ACTIMEL,1,Rotselaar(BE),0085,0024 FR TOULOUSE (DC),2516,2223,2223,1601,622,622,0,0,-293,11.645468998410175,335,304,304,271,33,33,0,0,-31,9.253731343283581,100.0,89.14473684210526,10.85526315789474,100.0,72.01979307242465,27.980206927575352,A Creuser
2946,0,2019-02-02,121320,ACTIMEL NATU 4x(12x100g) FR,0,0,0,ACTIMEL,1,Rotselaar(BE),0083,0024 FR CHAPONNAY (DC),2516,2223,2223,1601,622,622,0,0,-293,11.645468998410175,470,344,344,344,0,0,0,0,-126,26.80851063829787,100.0,100.0,0.0,100.0,72.01979307242465,27.980206927575352,A Creuser
2947,0,2019-02-02,121320,ACTIMEL NATU 4x(12x100g) FR,0,0,0,ACTIMEL,1,Rotselaar(BE),0079,0024 FR PARIS SUD (DC),2516,2223,2223,1601,622,622,0,0,-293,11.645468998410175,409,433,433,18,415,415,0,0,24,-5.8679706601467,100.0,4.157043879907621,95.84295612009238,100.0,72.01979307242465,27.980206927575352,A Creuser
2948,0,2019-02-02,121320,ACTIMEL NATU 4x(12x100g) FR,0,0,0,ACTIMEL,1,Rotselaar(BE),0078,0024 FR PARIS NORD (DC),2516,2223,2223,1601,622,622,0,0,-293,11.645468998410175,228,174,174,0,174,174,0,0,-54,23.68421052631579,100.0,0.0,100.0,100.0,72.01979307242465,27.980206927575352,A Creuser
2949,0,2019-02-02,122425,ACTIVIA 0% NATURE 125X12,0,0,0,ACTIVIA,0,Bailleul(FR),0084,0024 FR AIX (DC),202,293,153,145,8,148,140,0,91,-45.04950495049505,26,27,10,10,0,17,17,0,1,-3.8461538461538463,37.03703703703704,37.03703703703704,0.0,52.218430034129696,49.48805460750853,2.7303754266211655,Previsions
2950,0,2019-02-02,122425,ACTIVIA 0% NATURE 125X12,0,0,0,ACTIVIA,0,Bailleul(FR),0080,0024 FR METZ (DC),202,293,153,145,8,148,140,0,91,-45.04950495049505,21,22,6,4,2,18,16,0,1,-4.761904761904762,27.27272727272727,18.181818181818183,9.090909090909086,52.218430034129696,49.48805460750853,2.7303754266211655,Previsions
2951,0,2019-02-02,122425,ACTIVIA 0% NATURE 125X12,0,0,0,ACTIVIA,0,Bailleul(FR),0081,0024 FR TOURS (DC),202,293,153,145,8,148,140,0,91,-45.04950495049505,5,54,20,20,0,34,34,0,49,-980.0,37.03703703703704,37.03703703703704,0.0,52.218430034129696,49.48805460750853,2.7303754266211655,Previsions
2952,0,2019-02-02,122425,ACTIVIA 0% NATURE 125X12,0,0,0,ACTIVIA,0,Bailleul(FR),0082,0024 FR VALLET (DC),202,293,153,145,8,148,140,0,91,-45.04950495049505,24,31,31,31,0,0,0,0,7,-29.166666666666668,100.0,100.0,0.0,52.218430034129696,49.48805460750853,2.7303754266211655,Previsions
2953,0,2019-02-02,122425,ACTIVIA 0% NATURE 125X12,0,0,0,ACTIVIA,0,Bailleul(FR),0077,0024 FR LILPARK (DC),202,293,153,145,8,148,140,0,91,-45.04950495049505,26,32,32,32,0,0,0,0,6,-23.076923076923077,100.0,100.0,0.0,52.218430034129696,49.48805460750853,2.7303754266211655,Previsions
2954,0,2019-02-02,122425,ACTIVIA 0% NATURE 125X12,0,0,0,ACTIVIA,0,Bailleul(FR),0085,0024 FR TOULOUSE (DC),202,293,153,145,8,148,140,0,91,-45.04950495049505,21,23,23,23,0,0,0,0,2,-9.523809523809524,100.0,100.0,0.0,52.218430034129696,49.48805460750853,2.7303754266211655,Previsions
2955,0,2019-02-02,122425,ACTIVIA 0% NATURE 125X12,0,0,0,ACTIVIA,0,Bailleul(FR),0083,0024 FR CHAPONNAY (DC),202,293,153,145,8,148,140,0,91,-45.04950495049505,24,35,9,9,0,26,26,0,11,-45.833333333333336,25.71428571428571,25.71428571428571,0.0,52.218430034129696,49.48805460750853,2.7303754266211655,Previsions
2956,0,2019-02-02,122425,ACTIVIA 0% NATURE 125X12,0,0,0,ACTIVIA,0,Bailleul(FR),0079,0024 FR PARIS SUD (DC),202,293,153,145,8,148,140,0,91,-45.04950495049505,31,42,19,16,3,26,23,0,11,-35.483870967741936,45.23809523809524,38.095238095238095,7.142857142857146,52.218430034129696,49.48805460750853,2.7303754266211655,Previsions
2957,0,2019-02-02,122425,ACTIVIA 0% NATURE 125X12,0,0,0,ACTIVIA,0,Bailleul(FR),0078,0024 FR PARIS NORD (DC),202,293,153,145,8,148,140,0,91,-45.04950495049505,24,27,3,0,3,27,24,0,3,-12.5,11.11111111111111,0.0,11.11111111111111,52.218430034129696,49.48805460750853,2.7303754266211655,Previsions
2958,0,2019-02-02,131413,DANONINO FRTS PANACHE 50X18 OD,1,0,0,DANONINO,0,Ferrières(FR),0084,0024 FR AIX (DC),6230,3369,3369,3215,154,154,0,0,-2861,45.92295345104334,661,429,429,275,154,154,0,0,-232,35.09833585476551,100.0,64.1025641025641,35.8974358974359,100.0,95.428910655981,4.571089344019001,Transport
2959,1,2019-02-02,131413,DANONINO FRTS PANACHE 50X18 OD,1,0,0,DANONINO,0,Ferrières(FR),0084,0024 FR AIX (DC),6230,3369,3369,3215,154,154,0,0,-2861,45.92295345104334,661,429,429,275,154,154,0,0,-232,35.09833585476551,100.0,64.1025641025641,35.8974358974359,100.0,95.428910655981,4.571089344019001,Transport
2960,0,2019-02-02,131413,DANONINO FRTS PANACHE 50X18 OD,1,0,0,DANONINO,0,Ferrières(FR),0081,0024 FR TOURS (DC),6230,3369,3369,3215,154,154,0,0,-2861,45.92295345104334,52,28,28,28,0,0,0,0,-24,46.15384615384615,100.0,100.0,0.0,100.0,95.428910655981,4.571089344019001,Transport
2961,0,2019-02-02,131413,DANONINO FRTS PANACHE 50X18 OD,1,0,0,DANONINO,0,Ferrières(FR),0082,0024 FR VALLET (DC),6230,3369,3369,3215,154,154,0,0,-2861,45.92295345104334,512,306,306,306,0,0,0,0,-206,40.234375,100.0,100.0,0.0,100.0,95.428910655981,4.571089344019001,Transport
2962,0,2019-02-02,131413,DANONINO FRTS PANACHE 50X18 OD,1,0,0,DANONINO,0,Ferrières(FR),0077,0024 FR LILPARK (DC),6230,3369,3369,3215,154,154,0,0,-2861,45.92295345104334,525,249,249,249,0,0,0,0,-276,52.57142857142857,100.0,100.0,0.0,100.0,95.428910655981,4.571089344019001,Transport
2963,0,2019-02-02,131413,DANONINO FRTS PANACHE 50X18 OD,1,0,0,DANONINO,0,Ferrières(FR),0085,0024 FR TOULOUSE (DC),6230,3369,3369,3215,154,154,0,0,-2861,45.92295345104334,212,142,142,142,0,0,0,0,-70,33.0188679245283,100.0,100.0,0.0,100.0,95.428910655981,4.571089344019001,Transport
2964,0,2019-02-02,131413,DANONINO FRTS PANACHE 50X18 OD,1,0,0,DANONINO,0,Ferrières(FR),0083,0024 FR CHAPONNAY (DC),6230,3369,3369,3215,154,154,0,0,-2861,45.92295345104334,1262,792,792,792,0,0,0,0,-470,37.24247226624406,100.0,100.0,0.0,100.0,95.428910655981,4.571089344019001,Transport
2965,0,2019-02-02,131413,DANONINO FRTS PANACHE 50X18 OD,1,0,0,DANONINO,0,Ferrières(FR),0079,0024 FR PARIS SUD (DC),6230,3369,3369,3215,154,154,0,0,-2861,45.92295345104334,927,541,541,541,0,0,0,0,-386,41.63969795037756,100.0,100.0,0.0,100.0,95.428910655981,4.571089344019001,Transport
2966,0,2019-02-02,131413,DANONINO FRTS PANACHE 50X18 OD,1,0,0,DANONINO,0,Ferrières(FR),0078,0024 FR PARIS NORD (DC),6230,3369,3369,3215,154,154,0,0,-2861,45.92295345104334,1418,882,882,882,0,0,0,0,-536,37.79971791255289,100.0,100.0,0.0,100.0,95.428910655981,4.571089344019001,Transport
2967,0,2019-02-02,133398,LIGHT & FREE FRAMB GREN 120X4,0,0,0,LIGHT & FREE,0,Ferrières(FR),0084,0024 FR AIX (DC),488,610,610,512,98,98,0,0,122,-25.0,61,51,51,51,0,0,0,0,-10,16.39344262295082,100.0,100.0,0.0,100.0,83.93442622950819,16.06557377049181,Transport
2968,0,2019-02-02,133398,LIGHT & FREE FRAMB GREN 120X4,0,0,0,LIGHT & FREE,0,Ferrières(FR),0080,0024 FR METZ (DC),488,610,610,512,98,98,0,0,122,-25.0,36,44,44,44,0,0,0,0,8,-22.22222222222222,100.0,100.0,0.0,100.0,83.93442622950819,16.06557377049181,Transport
2969,0,2019-02-02,133398,LIGHT & FREE FRAMB GREN 120X4,0,0,0,LIGHT & FREE,0,Ferrières(FR),0081,0024 FR TOURS (DC),488,610,610,512,98,98,0,0,122,-25.0,110,102,102,10,92,92,0,0,-8,7.2727272727272725,100.0,9.803921568627452,90.19607843137254,100.0,83.93442622950819,16.06557377049181,Transport
2970,0,2019-02-02,133398,LIGHT & FREE FRAMB GREN 120X4,0,0,0,LIGHT & FREE,0,Ferrières(FR),0082,0024 FR VALLET (DC),488,610,610,512,98,98,0,0,122,-25.0,6,59,59,59,0,0,0,0,53,-883.3333333333334,100.0,100.0,0.0,100.0,83.93442622950819,16.06557377049181,Transport
2971,0,2019-02-02,133398,LIGHT & FREE FRAMB GREN 120X4,0,0,0,LIGHT & FREE,0,Ferrières(FR),0077,0024 FR LILPARK (DC),488,610,610,512,98,98,0,0,122,-25.0,63,64,64,64,0,0,0,0,1,-1.5873015873015872,100.0,100.0,0.0,100.0,83.93442622950819,16.06557377049181,Transport
2972,0,2019-02-02,133398,LIGHT & FREE FRAMB GREN 120X4,0,0,0,LIGHT & FREE,0,Ferrières(FR),0085,0024 FR TOULOUSE (DC),488,610,610,512,98,98,0,0,122,-25.0,81,84,84,78,6,6,0,0,3,-3.7037037037037037,100.0,92.85714285714286,7.142857142857139,100.0,83.93442622950819,16.06557377049181,Transport
2973,0,2019-02-02,133398,LIGHT & FREE FRAMB GREN 120X4,0,0,0,LIGHT & FREE,0,Ferrières(FR),0083,0024 FR CHAPONNAY (DC),488,610,610,512,98,98,0,0,122,-25.0,65,64,64,64,0,0,0,0,-1,1.5384615384615385,100.0,100.0,0.0,100.0,83.93442622950819,16.06557377049181,Transport
2974,0,2019-02-02,133398,LIGHT & FREE FRAMB GREN 120X4,0,0,0,LIGHT & FREE,0,Ferrières(FR),0079,0024 FR PARIS SUD (DC),488,610,610,512,98,98,0,0,122,-25.0,8,86,86,86,0,0,0,0,78,-975.0,100.0,100.0,0.0,100.0,83.93442622950819,16.06557377049181,Transport
2975,0,2019-02-02,133398,LIGHT & FREE FRAMB GREN 120X4,0,0,0,LIGHT & FREE,0,Ferrières(FR),0078,0024 FR PARIS NORD (DC),488,610,610,512,98,98,0,0,122,-25.0,58,56,56,56,0,0,0,0,-2,3.4482758620689653,100.0,100.0,0.0,100.0,83.93442622950819,16.06557377049181,Transport
2976,0,2019-02-02,135066,ACTIVIA SAV VANILLE 125X12 OD,1,0,0,ACTIVIA,0,Bailleul(FR),0084,0024 FR AIX (DC),1091,2006,1908,1884,24,122,98,0,915,-83.86801099908341,189,312,274,274,0,38,38,0,123,-65.07936507936508,87.82051282051282,87.82051282051282,0.0,95.11465603190429,93.91824526420737,1.1964107676969178,Client
2977,0,2019-02-02,135066,ACTIVIA SAV VANILLE 125X12 OD,1,0,0,ACTIVIA,0,Bailleul(FR),0081,0024 FR TOURS (DC),1091,2006,1908,1884,24,122,98,0,915,-83.86801099908341,21,13,13,13,0,0,0,0,-8,38.095238095238095,100.0,100.0,0.0,95.11465603190429,93.91824526420737,1.1964107676969178,Client
2978,0,2019-02-02,135066,ACTIVIA SAV VANILLE 125X12 OD,1,0,0,ACTIVIA,0,Bailleul(FR),0082,0024 FR VALLET (DC),1091,2006,1908,1884,24,122,98,0,915,-83.86801099908341,121,170,170,170,0,0,0,0,49,-40.49586776859504,100.0,100.0,0.0,95.11465603190429,93.91824526420737,1.1964107676969178,Client
2979,0,2019-02-02,135066,ACTIVIA SAV VANILLE 125X12 OD,1,0,0,ACTIVIA,0,Bailleul(FR),0077,0024 FR LILPARK (DC),1091,2006,1908,1884,24,122,98,0,915,-83.86801099908341,64,96,96,96,0,0,0,0,32,-50.0,100.0,100.0,0.0,95.11465603190429,93.91824526420737,1.1964107676969178,Client
2980,0,2019-02-02,135066,ACTIVIA SAV VANILLE 125X12 OD,1,0,0,ACTIVIA,0,Bailleul(FR),0085,0024 FR TOULOUSE (DC),1091,2006,1908,1884,24,122,98,0,915,-83.86801099908341,103,138,116,105,11,33,22,0,35,-33.980582524271846,84.05797101449275,76.08695652173914,7.971014492753611,95.11465603190429,93.91824526420737,1.1964107676969178,Client
2981,0,2019-02-02,135066,ACTIVIA SAV VANILLE 125X12 OD,1,0,0,ACTIVIA,0,Bailleul(FR),0083,0024 FR CHAPONNAY (DC),1091,2006,1908,1884,24,122,98,0,915,-83.86801099908341,36,500,486,486,0,14,14,0,464,-1288.888888888889,97.2,97.2,0.0,95.11465603190429,93.91824526420737,1.1964107676969178,Client
2982,0,2019-02-02,135066,ACTIVIA SAV VANILLE 125X12 OD,1,0,0,ACTIVIA,0,Bailleul(FR),0079,0024 FR PARIS SUD (DC),1091,2006,1908,1884,24,122,98,0,915,-83.86801099908341,161,250,250,237,13,13,0,0,89,-55.27950310559006,100.0,94.8,5.200000000000003,95.11465603190429,93.91824526420737,1.1964107676969178,Client
2983,0,2019-02-02,135066,ACTIVIA SAV VANILLE 125X12 OD,1,0,0,ACTIVIA,0,Bailleul(FR),0078,0024 FR PARIS NORD (DC),1091,2006,1908,1884,24,122,98,0,915,-83.86801099908341,396,527,503,503,0,24,24,0,131,-33.08080808080808,95.44592030360532,95.44592030360532,0.0,95.11465603190429,93.91824526420737,1.1964107676969178,Client
2984,0,2019-02-04,32787,TAILLEF CHEESE PEACH 120GX4,0,0,0,TAILLEFINE,0,Ferrières(FR),0084,0024 FR AIX (DC),514,530,410,371,39,159,120,0,16,-3.11284046692607,65,75,75,75,0,0,0,0,10,-15.384615384615385,100.0,100.0,0.0,77.35849056603774,70.0,7.358490566037744,Qualité
2985,0,2019-02-04,32787,TAILLEF CHEESE PEACH 120GX4,0,0,0,TAILLEFINE,0,Ferrières(FR),0080,0024 FR METZ (DC),514,530,410,371,39,159,120,0,16,-3.11284046692607,69,81,32,24,8,57,49,0,12,-17.391304347826086,39.50617283950617,29.629629629629626,9.876543209876544,77.35849056603774,70.0,7.358490566037744,Qualité
2986,0,2019-02-04,32787,TAILLEF CHEESE PEACH 120GX4,0,0,0,TAILLEFINE,0,Ferrières(FR),0081,0024 FR TOURS (DC),514,530,410,371,39,159,120,0,16,-3.11284046692607,37,25,1,1,0,24,24,0,-12,32.432432432432435,4.0,4.0,0.0,77.35849056603774,70.0,7.358490566037744,Qualité
2987,0,2019-02-04,32787,TAILLEF CHEESE PEACH 120GX4,0,0,0,TAILLEFINE,0,Ferrières(FR),0082,0024 FR VALLET (DC),514,530,410,371,39,159,120,0,16,-3.11284046692607,50,41,41,41,0,0,0,0,-9,18.0,100.0,100.0,0.0,77.35849056603774,70.0,7.358490566037744,Qualité
2988,0,2019-02-04,32787,TAILLEF CHEESE PEACH 120GX4,0,0,0,TAILLEFINE,0,Ferrières(FR),0077,0024 FR LILPARK (DC),514,530,410,371,39,159,120,0,16,-3.11284046692607,35,47,47,47,0,0,0,0,12,-34.285714285714285,100.0,100.0,0.0,77.35849056603774,70.0,7.358490566037744,Qualité
2989,0,2019-02-04,32787,TAILLEF CHEESE PEACH 120GX4,0,0,0,TAILLEFINE,0,Ferrières(FR),0085,0024 FR TOULOUSE (DC),514,530,410,371,39,159,120,0,16,-3.11284046692607,88,89,89,89,0,0,0,0,1,-1.1363636363636365,100.0,100.0,0.0,77.35849056603774,70.0,7.358490566037744,Qualité
2990,0,2019-02-04,32787,TAILLEF CHEESE PEACH 120GX4,0,0,0,TAILLEFINE,0,Ferrières(FR),0083,0024 FR CHAPONNAY (DC),514,530,410,371,39,159,120,0,16,-3.11284046692607,45,46,7,0,7,46,39,0,1,-2.2222222222222223,15.217391304347828,0.0,15.217391304347828,77.35849056603774,70.0,7.358490566037744,Qualité
2991,0,2019-02-04,32787,TAILLEF CHEESE PEACH 120GX4,0,0,0,TAILLEFINE,0,Ferrières(FR),0079,0024 FR PARIS SUD (DC),514,530,410,371,39,159,120,0,16,-3.11284046692607,64,75,67,43,24,32,8,0,11,-17.1875,89.33333333333333,57.333333333333336,31.999999999999993,77.35849056603774,70.0,7.358490566037744,Qualité
2992,0,2019-02-04,32787,TAILLEF CHEESE PEACH 120GX4,0,0,0,TAILLEFINE,0,Ferrières(FR),0078,0024 FR PARIS NORD (DC),514,530,410,371,39,159,120,0,16,-3.11284046692607,61,51,51,51,0,0,0,0,-10,16.39344262295082,100.0,100.0,0.0,77.35849056603774,70.0,7.358490566037744,Qualité
2993,0,2019-02-04,83924,ACTIMEL STRA 3x(14x100g) FR,0,0,0,ACTIMEL,1,Rotselaar(BE),0084,0024 FR AIX (DC),3643,1949,1936,1757,179,192,13,0,-1694,46.500137249519625,407,245,245,245,0,0,0,0,-162,39.8034398034398,100.0,100.0,0.0,99.33299127757824,90.14879425346332,9.184197024114923,Client
2994,0,2019-02-04,83924,ACTIMEL STRA 3x(14x100g) FR,0,0,0,ACTIMEL,1,Rotselaar(BE),0081,0024 FR TOURS (DC),3643,1949,1936,1757,179,192,13,0,-1694,46.500137249519625,17,43,43,17,26,26,0,0,26,-152.94117647058823,100.0,39.53488372093023,60.46511627906977,99.33299127757824,90.14879425346332,9.184197024114923,Client
2995,0,2019-02-04,83924,ACTIMEL STRA 3x(14x100g) FR,0,0,0,ACTIMEL,1,Rotselaar(BE),0082,0024 FR VALLET (DC),3643,1949,1936,1757,179,192,13,0,-1694,46.500137249519625,156,96,96,96,0,0,0,0,-60,38.46153846153846,100.0,100.0,0.0,99.33299127757824,90.14879425346332,9.184197024114923,Client
2996,0,2019-02-04,83924,ACTIMEL STRA 3x(14x100g) FR,0,0,0,ACTIMEL,1,Rotselaar(BE),0077,0024 FR LILPARK (DC),3643,1949,1936,1757,179,192,13,0,-1694,46.500137249519625,178,172,172,170,2,2,0,0,-6,3.3707865168539324,100.0,98.83720930232558,1.1627906976744242,99.33299127757824,90.14879425346332,9.184197024114923,Client
2997,0,2019-02-04,83924,ACTIMEL STRA 3x(14x100g) FR,0,0,0,ACTIMEL,1,Rotselaar(BE),0083,0024 FR CHAPONNAY (DC),3643,1949,1936,1757,179,192,13,0,-1694,46.500137249519625,56,316,316,237,79,79,0,0,260,-464.2857142857143,100.0,75.0,25.0,99.33299127757824,90.14879425346332,9.184197024114923,Client
2998,1,2019-02-04,83924,ACTIMEL STRA 3x(14x100g) FR,0,0,0,ACTIMEL,1,Rotselaar(BE),0083,0024 FR CHAPONNAY (DC),3643,1949,1936,1757,179,192,13,0,-1694,46.500137249519625,56,316,316,237,79,79,0,0,260,-464.2857142857143,100.0,75.0,25.0,99.33299127757824,90.14879425346332,9.184197024114923,Expe usine
2999,0,2019-02-04,83924,ACTIMEL STRA 3x(14x100g) FR,0,0,0,ACTIMEL,1,Rotselaar(BE),0079,0024 FR PARIS SUD (DC),3643,1949,1936,1757,179,192,13,0,-1694,46.500137249519625,603,377,377,375,2,2,0,0,-226,37.47927031509121,100.0,99.46949602122017,0.5305039787798336,99.33299127757824,90.14879425346332,9.184197024114923,Client
3000,0,2019-02-04,83924,ACTIMEL STRA 3x(14x100g) FR,0,0,0,ACTIMEL,1,Rotselaar(BE),0078,0024 FR PARIS NORD (DC),3643,1949,1936,1757,179,192,13,0,-1694,46.500137249519625,1085,700,687,617,70,83,13,0,-385,35.483870967741936,98.14285714285714,88.14285714285714,10.0,99.33299127757824,90.14879425346332,9.184197024114923,Client
3001,1,2019-02-04,83924,ACTIMEL STRA 3x(14x100g) FR,0,0,0,ACTIMEL,1,Rotselaar(BE),0078,0024 FR PARIS NORD (DC),3643,1949,1936,1757,179,192,13,0,-1694,46.500137249519625,1085,700,687,617,70,83,13,0,-385,35.483870967741936,98.14285714285714,88.14285714285714,10.0,99.33299127757824,90.14879425346332,9.184197024114923,Client
3002,0,2019-02-04,121320,ACTIMEL NATU 4x(12x100g) FR,0,0,0,ACTIMEL,1,Rotselaar(BE),0084,0024 FR AIX (DC),2502,2287,2287,2116,171,171,0,0,-215,8.593125499600319,214,235,235,235,0,0,0,0,21,-9.813084112149532,100.0,100.0,0.0,100.0,92.5229558373415,7.477044162658501,A Creuser
3003,0,2019-02-04,121320,ACTIMEL NATU 4x(12x100g) FR,0,0,0,ACTIMEL,1,Rotselaar(BE),0080,0024 FR METZ (DC),2502,2287,2287,2116,171,171,0,0,-215,8.593125499600319,243,268,268,268,0,0,0,0,25,-10.2880658436214,100.0,100.0,0.0,100.0,92.5229558373415,7.477044162658501,A Creuser
3004,0,2019-02-04,121320,ACTIMEL NATU 4x(12x100g) FR,0,0,0,ACTIMEL,1,Rotselaar(BE),0081,0024 FR TOURS (DC),2502,2287,2287,2116,171,171,0,0,-215,8.593125499600319,185,204,204,204,0,0,0,0,19,-10.27027027027027,100.0,100.0,0.0,100.0,92.5229558373415,7.477044162658501,A Creuser
3005,0,2019-02-04,121320,ACTIMEL NATU 4x(12x100g) FR,0,0,0,ACTIMEL,1,Rotselaar(BE),0082,0024 FR VALLET (DC),2502,2287,2287,2116,171,171,0,0,-215,8.593125499600319,126,164,164,164,0,0,0,0,38,-30.158730158730158,100.0,100.0,0.0,100.0,92.5229558373415,7.477044162658501,A Creuser
3006,0,2019-02-04,121320,ACTIMEL NATU 4x(12x100g) FR,0,0,0,ACTIMEL,1,Rotselaar(BE),0077,0024 FR LILPARK (DC),2502,2287,2287,2116,171,171,0,0,-215,8.593125499600319,119,73,73,73,0,0,0,0,-46,38.65546218487395,100.0,100.0,0.0,100.0,92.5229558373415,7.477044162658501,A Creuser
3007,0,2019-02-04,121320,ACTIMEL NATU 4x(12x100g) FR,0,0,0,ACTIMEL,1,Rotselaar(BE),0085,0024 FR TOULOUSE (DC),2502,2287,2287,2116,171,171,0,0,-215,8.593125499600319,366,383,383,383,0,0,0,0,17,-4.644808743169399,100.0,100.0,0.0,100.0,92.5229558373415,7.477044162658501,A Creuser
3008,0,2019-02-04,121320,ACTIMEL NATU 4x(12x100g) FR,0,0,0,ACTIMEL,1,Rotselaar(BE),0083,0024 FR CHAPONNAY (DC),2502,2287,2287,2116,171,171,0,0,-215,8.593125499600319,363,390,390,390,0,0,0,0,27,-7.43801652892562,100.0,100.0,0.0,100.0,92.5229558373415,7.477044162658501,A Creuser
3009,0,2019-02-04,121320,ACTIMEL NATU 4x(12x100g) FR,0,0,0,ACTIMEL,1,Rotselaar(BE),0079,0024 FR PARIS SUD (DC),2502,2287,2287,2116,171,171,0,0,-215,8.593125499600319,558,302,302,157,145,145,0,0,-256,45.878136200716845,100.0,51.98675496688742,48.01324503311258,100.0,92.5229558373415,7.477044162658501,A Creuser
3010,0,2019-02-04,121320,ACTIMEL NATU 4x(12x100g) FR,0,0,0,ACTIMEL,1,Rotselaar(BE),0078,0024 FR PARIS NORD (DC),2502,2287,2287,2116,171,171,0,0,-215,8.593125499600319,328,268,268,242,26,26,0,0,-60,18.29268292682927,100.0,90.29850746268657,9.701492537313428,100.0,92.5229558373415,7.477044162658501,A Creuser
3011,1,2019-02-04,135120,ACTIVIA SAV CIT 125X12 PLUS 4,0,0,0,ACTIVIA,0,Bailleul(FR),0078,0024 FR PARIS NORD (DC),48,407,407,391,16,16,0,0,359,-747.9166666666666,48,72,72,56,16,16,0,0,24,-50.0,100.0,77.77777777777779,22.222222222222214,100.0,96.06879606879608,3.9312039312039246,Client
3012,0,2019-02-05,32787,TAILLEF CHEESE PEACH 120GX4,0,0,0,TAILLEFINE,0,Ferrières(FR),0084,0024 FR AIX (DC),355,303,221,217,4,86,82,0,-52,14.647887323943662,27,44,44,44,0,0,0,0,17,-62.96296296296296,100.0,100.0,0.0,72.93729372937293,71.61716171617162,1.3201320132013024,Qualité
3013,0,2019-02-05,32787,TAILLEF CHEESE PEACH 120GX4,0,0,0,TAILLEFINE,0,Ferrières(FR),0081,0024 FR TOURS (DC),355,303,221,217,4,86,82,0,-52,14.647887323943662,77,63,5,1,4,62,58,0,-14,18.181818181818183,7.936507936507936,1.5873015873015872,6.349206349206349,72.93729372937293,71.61716171617162,1.3201320132013024,Qualité
3014,0,2019-02-05,32787,TAILLEF CHEESE PEACH 120GX4,0,0,0,TAILLEFINE,0,Ferrières(FR),0082,0024 FR VALLET (DC),355,303,221,217,4,86,82,0,-52,14.647887323943662,46,51,51,51,0,0,0,0,5,-10.869565217391305,100.0,100.0,0.0,72.93729372937293,71.61716171617162,1.3201320132013024,Qualité
3015,0,2019-02-05,32787,TAILLEF CHEESE PEACH 120GX4,0,0,0,TAILLEFINE,0,Ferrières(FR),0077,0024 FR LILPARK (DC),355,303,221,217,4,86,82,0,-52,14.647887323943662,96,68,68,68,0,0,0,0,-28,29.166666666666668,100.0,100.0,0.0,72.93729372937293,71.61716171617162,1.3201320132013024,Qualité
3016,0,2019-02-05,32787,TAILLEF CHEESE PEACH 120GX4,0,0,0,TAILLEFINE,0,Ferrières(FR),0085,0024 FR TOULOUSE (DC),355,303,221,217,4,86,82,0,-52,14.647887323943662,51,39,15,15,0,24,24,0,-12,23.529411764705884,38.46153846153847,38.46153846153847,0.0,72.93729372937293,71.61716171617162,1.3201320132013024,Qualité
3017,0,2019-02-05,32787,TAILLEF CHEESE PEACH 120GX4,0,0,0,TAILLEFINE,0,Ferrières(FR),0078,0024 FR PARIS NORD (DC),355,303,221,217,4,86,82,0,-52,14.647887323943662,58,38,38,38,0,0,0,0,-20,34.48275862068966,100.0,100.0,0.0,72.93729372937293,71.61716171617162,1.3201320132013024,Qualité
3018,0,2019-02-05,83924,ACTIMEL STRA 3x(14x100g) FR,0,0,0,ACTIMEL,1,Rotselaar(BE),0084,0024 FR AIX (DC),1573,1020,815,512,303,508,205,0,-553,35.15575333757152,40,240,46,45,1,195,194,0,200,-500.0,19.166666666666668,18.75,0.41666666666666785,79.90196078431373,50.19607843137255,29.70588235294118,Client
3019,0,2019-02-05,83924,ACTIMEL STRA 3x(14x100g) FR,0,0,0,ACTIMEL,1,Rotselaar(BE),0082,0024 FR VALLET (DC),1573,1020,815,512,303,508,205,0,-553,35.15575333757152,177,164,158,28,130,136,6,0,-13,7.344632768361582,96.34146341463415,17.073170731707318,79.26829268292683,79.90196078431373,50.19607843137255,29.70588235294118,Client
3020,0,2019-02-05,83924,ACTIMEL STRA 3x(14x100g) FR,0,0,0,ACTIMEL,1,Rotselaar(BE),0077,0024 FR LILPARK (DC),1573,1020,815,512,303,508,205,0,-553,35.15575333757152,154,95,95,95,0,0,0,0,-59,38.311688311688314,100.0,100.0,0.0,79.90196078431373,50.19607843137255,29.70588235294118,Client
3021,0,2019-02-05,83924,ACTIMEL STRA 3x(14x100g) FR,0,0,0,ACTIMEL,1,Rotselaar(BE),0085,0024 FR TOULOUSE (DC),1573,1020,815,512,303,508,205,0,-553,35.15575333757152,89,55,55,55,0,0,0,0,-34,38.20224719101124,100.0,100.0,0.0,79.90196078431373,50.19607843137255,29.70588235294118,Client
3022,0,2019-02-05,83924,ACTIMEL STRA 3x(14x100g) FR,0,0,0,ACTIMEL,1,Rotselaar(BE),0083,0024 FR CHAPONNAY (DC),1573,1020,815,512,303,508,205,0,-553,35.15575333757152,296,171,171,0,171,171,0,0,-125,42.229729729729726,100.0,0.0,100.0,79.90196078431373,50.19607843137255,29.70588235294118,Client
3023,1,2019-02-05,83924,ACTIMEL STRA 3x(14x100g) FR,0,0,0,ACTIMEL,1,Rotselaar(BE),0083,0024 FR CHAPONNAY (DC),1573,1020,815,512,303,508,205,0,-553,35.15575333757152,296,171,171,0,171,171,0,0,-125,42.229729729729726,100.0,0.0,100.0,79.90196078431373,50.19607843137255,29.70588235294118,Transport
3024,0,2019-02-05,83924,ACTIMEL STRA 3x(14x100g) FR,0,0,0,ACTIMEL,1,Rotselaar(BE),0079,0024 FR PARIS SUD (DC),1573,1020,815,512,303,508,205,0,-553,35.15575333757152,241,134,129,128,1,6,5,0,-107,44.398340248962654,96.26865671641791,95.52238805970148,0.7462686567164241,79.90196078431373,50.19607843137255,29.70588235294118,Client
3025,0,2019-02-05,83924,ACTIMEL STRA 3x(14x100g) FR,0,0,0,ACTIMEL,1,Rotselaar(BE),0078,0024 FR PARIS NORD (DC),1573,1020,815,512,303,508,205,0,-553,35.15575333757152,280,161,161,161,0,0,0,0,-119,42.5,100.0,100.0,0.0,79.90196078431373,50.19607843137255,29.70588235294118,Client
3026,0,2019-02-05,83925,ACTIMEL 0% NATU 3x(14x100g) FR,0,0,0,ACTIMEL,1,Rotselaar(BE),0084,0024 FR AIX (DC),451,374,215,128,87,246,159,0,-77,17.073170731707318,115,69,22,1,21,68,47,0,-46,40.0,31.88405797101449,1.4492753623188406,30.43478260869565,57.48663101604278,34.22459893048128,23.2620320855615,Client
3027,0,2019-02-05,83925,ACTIMEL 0% NATU 3x(14x100g) FR,0,0,0,ACTIMEL,1,Rotselaar(BE),0081,0024 FR TOURS (DC),451,374,215,128,87,246,159,0,-77,17.073170731707318,0,15,15,15,0,0,0,1,15,10000.0,100.0,100.0,0.0,57.48663101604278,34.22459893048128,23.2620320855615,Client
3028,0,2019-02-05,83925,ACTIMEL 0% NATU 3x(14x100g) FR,0,0,0,ACTIMEL,1,Rotselaar(BE),0082,0024 FR VALLET (DC),451,374,215,128,87,246,159,0,-77,17.073170731707318,50,43,43,43,0,0,0,0,-7,14.0,100.0,100.0,0.0,57.48663101604278,34.22459893048128,23.2620320855615,Client
3029,0,2019-02-05,83925,ACTIMEL 0% NATU 3x(14x100g) FR,0,0,0,ACTIMEL,1,Rotselaar(BE),0077,0024 FR LILPARK (DC),451,374,215,128,87,246,159,0,-77,17.073170731707318,18,11,11,11,0,0,0,0,-7,38.888888888888886,100.0,100.0,0.0,57.48663101604278,34.22459893048128,23.2620320855615,Client
3030,0,2019-02-05,83925,ACTIMEL 0% NATU 3x(14x100g) FR,0,0,0,ACTIMEL,1,Rotselaar(BE),0085,0024 FR TOULOUSE (DC),451,374,215,128,87,246,159,0,-77,17.073170731707318,81,50,3,2,1,48,47,0,-31,38.27160493827161,6.0,4.0,2.0,57.48663101604278,34.22459893048128,23.2620320855615,Client
3031,0,2019-02-05,83925,ACTIMEL 0% NATU 3x(14x100g) FR,0,0,0,ACTIMEL,1,Rotselaar(BE),0083,0024 FR CHAPONNAY (DC),451,374,215,128,87,246,159,0,-77,17.073170731707318,93,53,26,24,2,29,27,0,-40,43.01075268817204,49.056603773584904,45.28301886792453,3.773584905660371,57.48663101604278,34.22459893048128,23.2620320855615,Client
3032,0,2019-02-05,83925,ACTIMEL 0% NATU 3x(14x100g) FR,0,0,0,ACTIMEL,1,Rotselaar(BE),0079,0024 FR PARIS SUD (DC),451,374,215,128,87,246,159,0,-77,17.073170731707318,79,44,25,23,2,21,19,0,-35,44.30379746835443,56.81818181818182,52.27272727272727,4.545454545454547,57.48663101604278,34.22459893048128,23.2620320855615,Client
3033,0,2019-02-05,83925,ACTIMEL 0% NATU 3x(14x100g) FR,0,0,0,ACTIMEL,1,Rotselaar(BE),0078,0024 FR PARIS NORD (DC),451,374,215,128,87,246,159,0,-77,17.073170731707318,15,89,70,9,61,80,19,0,74,-493.3333333333333,78.65168539325843,10.112359550561797,68.53932584269664,57.48663101604278,34.22459893048128,23.2620320855615,Client
3034,0,2019-02-05,113943,ACTIVIA NATURE 125X16 OD,1,0,0,ACTIVIA,0,Bailleul(FR),0084,0024 FR AIX (DC),1608,2779,2449,2338,111,441,330,0,1171,-72.82338308457712,227,333,333,333,0,0,0,0,106,-46.69603524229075,100.0,100.0,0.0,88.12522490104354,84.1309823677582,3.9942425332853446,Client
3035,0,2019-02-05,113943,ACTIVIA NATURE 125X16 OD,1,0,0,ACTIVIA,0,Bailleul(FR),0080,0024 FR METZ (DC),1608,2779,2449,2338,111,441,330,0,1171,-72.82338308457712,18,28,28,28,0,0,0,0,10,-55.55555555555556,100.0,100.0,0.0,88.12522490104354,84.1309823677582,3.9942425332853446,Client
3036,0,2019-02-05,113943,ACTIVIA NATURE 125X16 OD,1,0,0,ACTIVIA,0,Bailleul(FR),0081,0024 FR TOURS (DC),1608,2779,2449,2338,111,441,330,0,1171,-72.82338308457712,19,101,101,101,0,0,0,0,82,-431.57894736842104,100.0,100.0,0.0,88.12522490104354,84.1309823677582,3.9942425332853446,Client
3037,0,2019-02-05,113943,ACTIVIA NATURE 125X16 OD,1,0,0,ACTIVIA,0,Bailleul(FR),0082,0024 FR VALLET (DC),1608,2779,2449,2338,111,441,330,0,1171,-72.82338308457712,117,328,126,15,111,313,202,0,211,-180.34188034188034,38.41463414634146,4.573170731707317,33.84146341463415,88.12522490104354,84.1309823677582,3.9942425332853446,Client
3038,0,2019-02-05,113943,ACTIVIA NATURE 125X16 OD,1,0,0,ACTIVIA,0,Bailleul(FR),0077,0024 FR LILPARK (DC),1608,2779,2449,2338,111,441,330,0,1171,-72.82338308457712,19,301,301,301,0,0,0,0,282,-1484.2105263157894,100.0,100.0,0.0,88.12522490104354,84.1309823677582,3.9942425332853446,Client
3039,0,2019-02-05,113943,ACTIVIA NATURE 125X16 OD,1,0,0,ACTIVIA,0,Bailleul(FR),0085,0024 FR TOULOUSE (DC),1608,2779,2449,2338,111,441,330,0,1171,-72.82338308457712,106,184,184,184,0,0,0,0,78,-73.58490566037736,100.0,100.0,0.0,88.12522490104354,84.1309823677582,3.9942425332853446,Client
3040,0,2019-02-05,113943,ACTIVIA NATURE 125X16 OD,1,0,0,ACTIVIA,0,Bailleul(FR),0083,0024 FR CHAPONNAY (DC),1608,2779,2449,2338,111,441,330,0,1171,-72.82338308457712,586,783,655,655,0,128,128,0,197,-33.617747440273035,83.65261813537676,83.65261813537676,0.0,88.12522490104354,84.1309823677582,3.9942425332853446,Client
3041,0,2019-02-05,113943,ACTIVIA NATURE 125X16 OD,1,0,0,ACTIVIA,0,Bailleul(FR),0079,0024 FR PARIS SUD (DC),1608,2779,2449,2338,111,441,330,0,1171,-72.82338308457712,286,409,409,409,0,0,0,0,123,-43.00699300699301,100.0,100.0,0.0,88.12522490104354,84.1309823677582,3.9942425332853446,Client
3042,0,2019-02-05,113943,ACTIVIA NATURE 125X16 OD,1,0,0,ACTIVIA,0,Bailleul(FR),0078,0024 FR PARIS NORD (DC),1608,2779,2449,2338,111,441,330,0,1171,-72.82338308457712,230,312,312,312,0,0,0,0,82,-35.65217391304348,100.0,100.0,0.0,88.12522490104354,84.1309823677582,3.9942425332853446,Client
3043,0,2019-02-05,120836,DANONE ARO PANACHE 125X4 AFH,0,0,1,DANONE,0,Bailleul(FR),0084,0024 FR AIX (DC),4205,5422,6008,5017,991,405,-586,0,1217,-28.941736028537456,543,462,462,462,0,0,0,0,-81,14.917127071823204,100.0,100.0,0.0,110.80781999262265,92.53043157506455,18.2773884175581,A Creuser
3044,0,2019-02-05,120836,DANONE ARO PANACHE 125X4 AFH,0,0,1,DANONE,0,Bailleul(FR),0080,0024 FR METZ (DC),4205,5422,6008,5017,991,405,-586,0,1217,-28.941736028537456,1064,777,777,777,0,0,0,0,-287,26.973684210526315,100.0,100.0,0.0,110.80781999262265,92.53043157506455,18.2773884175581,A Creuser
3045,0,2019-02-05,120836,DANONE ARO PANACHE 125X4 AFH,0,0,1,DANONE,0,Bailleul(FR),0081,0024 FR TOURS (DC),4205,5422,6008,5017,991,405,-586,0,1217,-28.941736028537456,913,1584,2170,1179,991,405,-586,0,671,-73.49397590361446,136.9949494949495,74.43181818181817,62.563131313131336,110.80781999262265,92.53043157506455,18.2773884175581,A Creuser
3046,0,2019-02-05,120836,DANONE ARO PANACHE 125X4 AFH,0,0,1,DANONE,0,Bailleul(FR),0082,0024 FR VALLET (DC),4205,5422,6008,5017,991,405,-586,0,1217,-28.941736028537456,162,187,187,187,0,0,0,0,25,-15.432098765432098,100.0,100.0,0.0,110.80781999262265,92.53043157506455,18.2773884175581,A Creuser
3047,0,2019-02-05,120836,DANONE ARO PANACHE 125X4 AFH,0,0,1,DANONE,0,Bailleul(FR),0077,0024 FR LILPARK (DC),4205,5422,6008,5017,991,405,-586,0,1217,-28.941736028537456,112,171,171,171,0,0,0,0,59,-52.67857142857143,100.0,100.0,0.0,110.80781999262265,92.53043157506455,18.2773884175581,A Creuser
3048,0,2019-02-05,120836,DANONE ARO PANACHE 125X4 AFH,0,0,1,DANONE,0,Bailleul(FR),0085,0024 FR TOULOUSE (DC),4205,5422,6008,5017,991,405,-586,0,1217,-28.941736028537456,654,612,612,612,0,0,0,0,-42,6.422018348623853,100.0,100.0,0.0,110.80781999262265,92.53043157506455,18.2773884175581,A Creuser
3049,0,2019-02-05,120836,DANONE ARO PANACHE 125X4 AFH,0,0,1,DANONE,0,Bailleul(FR),0083,0024 FR CHAPONNAY (DC),4205,5422,6008,5017,991,405,-586,0,1217,-28.941736028537456,299,27,27,27,0,0,0,0,-272,90.96989966555184,100.0,100.0,0.0,110.80781999262265,92.53043157506455,18.2773884175581,A Creuser
3050,0,2019-02-05,120836,DANONE ARO PANACHE 125X4 AFH,0,0,1,DANONE,0,Bailleul(FR),0079,0024 FR PARIS SUD (DC),4205,5422,6008,5017,991,405,-586,0,1217,-28.941736028537456,320,360,360,360,0,0,0,0,40,-12.5,100.0,100.0,0.0,110.80781999262265,92.53043157506455,18.2773884175581,A Creuser
3051,0,2019-02-05,120836,DANONE ARO PANACHE 125X4 AFH,0,0,1,DANONE,0,Bailleul(FR),0078,0024 FR PARIS NORD (DC),4205,5422,6008,5017,991,405,-586,0,1217,-28.941736028537456,138,1242,1242,1242,0,0,0,0,1104,-800.0,100.0,100.0,0.0,110.80781999262265,92.53043157506455,18.2773884175581,A Creuser
3052,1,2019-02-05,131396,ACTIVIA ABRICOT 125X4 OD,1,0,0,ACTIVIA,0,Villecomtal(FR),0083,0024 FR CHAPONNAY (DC),1,169,169,158,11,11,0,0,168,-16800.0,1,12,12,1,11,11,0,0,11,-1100.0,100.0,8.333333333333332,91.66666666666667,100.0,93.49112426035504,6.508875739644964,Expe usine
3053,0,2019-02-05,135358,TAILLEFINE YELLOW FRUIT 125X8 D,0,0,0,TAILLEFINE,0,Villecomtal(FR),0080,0024 FR METZ (DC),542,945,762,653,109,292,183,0,403,-74.35424354243543,191,180,153,153,0,27,27,0,-11,5.7591623036649215,85.0,85.0,0.0,80.63492063492063,69.1005291005291,11.534391534391531,Previsions
3054,0,2019-02-05,135358,TAILLEFINE YELLOW FRUIT 125X8 D,0,0,0,TAILLEFINE,0,Villecomtal(FR),0081,0024 FR TOURS (DC),542,945,762,653,109,292,183,0,403,-74.35424354243543,29,45,45,45,0,0,0,0,16,-55.172413793103445,100.0,100.0,0.0,80.63492063492063,69.1005291005291,11.534391534391531,Previsions
3055,0,2019-02-05,135358,TAILLEFINE YELLOW FRUIT 125X8 D,0,0,0,TAILLEFINE,0,Villecomtal(FR),0082,0024 FR VALLET (DC),542,945,762,653,109,292,183,0,403,-74.35424354243543,42,45,45,45,0,0,0,0,3,-7.142857142857143,100.0,100.0,0.0,80.63492063492063,69.1005291005291,11.534391534391531,Previsions
3056,0,2019-02-05,135358,TAILLEFINE YELLOW FRUIT 125X8 D,0,0,0,TAILLEFINE,0,Villecomtal(FR),0077,0024 FR LILPARK (DC),542,945,762,653,109,292,183,0,403,-74.35424354243543,168,405,303,302,1,103,102,0,237,-141.07142857142858,74.81481481481481,74.5679012345679,0.24691358024691112,80.63492063492063,69.1005291005291,11.534391534391531,Previsions
3057,0,2019-02-05,135358,TAILLEFINE YELLOW FRUIT 125X8 D,0,0,0,TAILLEFINE,0,Villecomtal(FR),0083,0024 FR CHAPONNAY (DC),542,945,762,653,109,292,183,0,403,-74.35424354243543,112,270,216,108,108,162,54,0,158,-141.07142857142858,80.0,40.0,40.0,80.63492063492063,69.1005291005291,11.534391534391531,Previsions
3058,0,2019-02-07,32787,TAILLEF CHEESE PEACH 120GX4,0,0,0,TAILLEFINE,0,Ferrières(FR),0084,0024 FR AIX (DC),320,337,250,249,1,88,87,0,17,-5.3125,44,48,48,48,0,0,0,0,4,-9.090909090909092,100.0,100.0,0.0,74.1839762611276,73.88724035608308,0.29673590504451397,Qualité
3059,0,2019-02-07,32787,TAILLEF CHEESE PEACH 120GX4,0,0,0,TAILLEFINE,0,Ferrières(FR),0082,0024 FR VALLET (DC),320,337,250,249,1,88,87,0,17,-5.3125,39,30,30,30,0,0,0,0,-9,23.076923076923077,100.0,100.0,0.0,74.1839762611276,73.88724035608308,0.29673590504451397,Qualité
3060,0,2019-02-07,32787,TAILLEF CHEESE PEACH 120GX4,0,0,0,TAILLEFINE,0,Ferrières(FR),0077,0024 FR LILPARK (DC),320,337,250,249,1,88,87,0,17,-5.3125,98,111,111,111,0,0,0,0,13,-13.26530612244898,100.0,100.0,0.0,74.1839762611276,73.88724035608308,0.29673590504451397,Qualité
3061,0,2019-02-07,32787,TAILLEF CHEESE PEACH 120GX4,0,0,0,TAILLEFINE,0,Ferrières(FR),0085,0024 FR TOULOUSE (DC),320,337,250,249,1,88,87,0,17,-5.3125,87,89,2,1,1,88,87,0,2,-2.2988505747126435,2.247191011235955,1.1235955056179776,1.1235955056179776,74.1839762611276,73.88724035608308,0.29673590504451397,Qualité
3062,0,2019-02-07,32787,TAILLEF CHEESE PEACH 120GX4,0,0,0,TAILLEFINE,0,Ferrières(FR),0078,0024 FR PARIS NORD (DC),320,337,250,249,1,88,87,0,17,-5.3125,52,59,59,59,0,0,0,0,7,-13.461538461538462,100.0,100.0,0.0,74.1839762611276,73.88724035608308,0.29673590504451397,Qualité
3063,0,2019-02-07,69190,FJORD NATURE 125GX8,0,0,0,FJORD,0,LeMolay(FR),0084,0024 FR AIX (DC),4199,5423,5419,5249,170,174,4,0,1224,-29.149797570850204,639,563,563,561,2,2,0,0,-76,11.89358372456964,100.0,99.64476021314387,0.35523978685613145,99.9262400885119,96.79144385026738,3.134796238244519,Transport
3064,0,2019-02-07,69190,FJORD NATURE 125GX8,0,0,0,FJORD,0,LeMolay(FR),0080,0024 FR METZ (DC),4199,5423,5419,5249,170,174,4,0,1224,-29.149797570850204,241,217,217,217,0,0,0,0,-24,9.95850622406639,100.0,100.0,0.0,99.9262400885119,96.79144385026738,3.134796238244519,Transport
3065,0,2019-02-07,69190,FJORD NATURE 125GX8,0,0,0,FJORD,0,LeMolay(FR),0081,0024 FR TOURS (DC),4199,5423,5419,5249,170,174,4,0,1224,-29.149797570850204,532,520,516,516,0,4,4,0,-12,2.255639097744361,99.23076923076923,99.23076923076923,0.0,99.9262400885119,96.79144385026738,3.134796238244519,Transport
3066,0,2019-02-07,69190,FJORD NATURE 125GX8,0,0,0,FJORD,0,LeMolay(FR),0082,0024 FR VALLET (DC),4199,5423,5419,5249,170,174,4,0,1224,-29.149797570850204,36,311,311,153,158,158,0,0,275,-763.8888888888889,100.0,49.19614147909968,50.80385852090032,99.9262400885119,96.79144385026738,3.134796238244519,Transport
3067,0,2019-02-07,69190,FJORD NATURE 125GX8,0,0,0,FJORD,0,LeMolay(FR),0077,0024 FR LILPARK (DC),4199,5423,5419,5249,170,174,4,0,1224,-29.149797570850204,351,378,378,368,10,10,0,0,27,-7.6923076923076925,100.0,97.35449735449735,2.6455026455026456,99.9262400885119,96.79144385026738,3.134796238244519,Transport
3068,0,2019-02-07,69190,FJORD NATURE 125GX8,0,0,0,FJORD,0,LeMolay(FR),0085,0024 FR TOULOUSE (DC),4199,5423,5419,5249,170,174,4,0,1224,-29.149797570850204,729,780,780,780,0,0,0,0,51,-6.995884773662551,100.0,100.0,0.0,99.9262400885119,96.79144385026738,3.134796238244519,Transport
3069,0,2019-02-07,69190,FJORD NATURE 125GX8,0,0,0,FJORD,0,LeMolay(FR),0083,0024 FR CHAPONNAY (DC),4199,5423,5419,5249,170,174,4,0,1224,-29.149797570850204,1088,1034,1034,1034,0,0,0,0,-54,4.963235294117647,100.0,100.0,0.0,99.9262400885119,96.79144385026738,3.134796238244519,Transport
3070,0,2019-02-07,69190,FJORD NATURE 125GX8,0,0,0,FJORD,0,LeMolay(FR),0079,0024 FR PARIS SUD (DC),4199,5423,5419,5249,170,174,4,0,1224,-29.149797570850204,122,1187,1187,1187,0,0,0,0,1065,-872.9508196721312,100.0,100.0,0.0,99.9262400885119,96.79144385026738,3.134796238244519,Transport
3071,0,2019-02-07,69190,FJORD NATURE 125GX8,0,0,0,FJORD,0,LeMolay(FR),0078,0024 FR PARIS NORD (DC),4199,5423,5419,5249,170,174,4,0,1224,-29.149797570850204,461,433,433,433,0,0,0,0,-28,6.073752711496746,100.0,100.0,0.0,99.9262400885119,96.79144385026738,3.134796238244519,Transport
3072,0,2019-02-07,122050,VELOUTE FRUIX ROUGES 125X8 OD,1,0,0,VELOUTE,0,Villecomtal(FR),0084,0024 FR AIX (DC),1043,1103,1103,960,143,143,0,0,60,-5.752636625119846,44,72,72,72,0,0,0,0,28,-63.63636363636363,100.0,100.0,0.0,100.0,87.0353581142339,12.964641885766099,Previsions
3073,0,2019-02-07,122050,VELOUTE FRUIX ROUGES 125X8 OD,1,0,0,VELOUTE,0,Villecomtal(FR),0080,0024 FR METZ (DC),1043,1103,1103,960,143,143,0,0,60,-5.752636625119846,187,125,125,1,124,124,0,0,-62,33.155080213903744,100.0,0.8,99.2,100.0,87.0353581142339,12.964641885766099,Previsions
3074,1,2019-02-07,122050,VELOUTE FRUIX ROUGES 125X8 OD,1,0,0,VELOUTE,0,Villecomtal(FR),0080,0024 FR METZ (DC),1043,1103,1103,960,143,143,0,0,60,-5.752636625119846,187,125,125,1,124,124,0,0,-62,33.155080213903744,100.0,0.8,99.2,100.0,87.0353581142339,12.964641885766099,Previsions
3075,0,2019-02-07,122050,VELOUTE FRUIX ROUGES 125X8 OD,1,0,0,VELOUTE,0,Villecomtal(FR),0081,0024 FR TOURS (DC),1043,1103,1103,960,143,143,0,0,60,-5.752636625119846,45,122,122,122,0,0,0,0,77,-171.11111111111111,100.0,100.0,0.0,100.0,87.0353581142339,12.964641885766099,Previsions
3076,0,2019-02-07,122050,VELOUTE FRUIX ROUGES 125X8 OD,1,0,0,VELOUTE,0,Villecomtal(FR),0082,0024 FR VALLET (DC),1043,1103,1103,960,143,143,0,0,60,-5.752636625119846,18,32,32,32,0,0,0,0,14,-77.77777777777777,100.0,100.0,0.0,100.0,87.0353581142339,12.964641885766099,Previsions
3077,0,2019-02-07,122050,VELOUTE FRUIX ROUGES 125X8 OD,1,0,0,VELOUTE,0,Villecomtal(FR),0077,0024 FR LILPARK (DC),1043,1103,1103,960,143,143,0,0,60,-5.752636625119846,205,161,161,142,19,19,0,0,-44,21.463414634146343,100.0,88.19875776397515,11.801242236024848,100.0,87.0353581142339,12.964641885766099,Previsions
3078,0,2019-02-07,122050,VELOUTE FRUIX ROUGES 125X8 OD,1,0,0,VELOUTE,0,Villecomtal(FR),0085,0024 FR TOULOUSE (DC),1043,1103,1103,960,143,143,0,0,60,-5.752636625119846,45,75,75,75,0,0,0,0,30,-66.66666666666667,100.0,100.0,0.0,100.0,87.0353581142339,12.964641885766099,Previsions
3079,0,2019-02-07,122050,VELOUTE FRUIX ROUGES 125X8 OD,1,0,0,VELOUTE,0,Villecomtal(FR),0083,0024 FR CHAPONNAY (DC),1043,1103,1103,960,143,143,0,0,60,-5.752636625119846,32,237,237,237,0,0,0,0,205,-640.625,100.0,100.0,0.0,100.0,87.0353581142339,12.964641885766099,Previsions
3080,0,2019-02-07,122050,VELOUTE FRUIX ROUGES 125X8 OD,1,0,0,VELOUTE,0,Villecomtal(FR),0079,0024 FR PARIS SUD (DC),1043,1103,1103,960,143,143,0,0,60,-5.752636625119846,215,223,223,223,0,0,0,0,8,-3.7209302325581395,100.0,100.0,0.0,100.0,87.0353581142339,12.964641885766099,Previsions
3081,0,2019-02-07,122050,VELOUTE FRUIX ROUGES 125X8 OD,1,0,0,VELOUTE,0,Villecomtal(FR),0078,0024 FR PARIS NORD (DC),1043,1103,1103,960,143,143,0,0,60,-5.752636625119846,65,56,56,56,0,0,0,0,-9,13.846153846153847,100.0,100.0,0.0,100.0,87.0353581142339,12.964641885766099,Previsions
3082,1,2019-02-07,133124,LIGHT & FREE PECH PASS 120X4 OD,1,0,0,LIGHT & FREE,0,Ferrières(FR),0083,0024 FR CHAPONNAY (DC),46,222,197,197,0,25,25,0,176,-382.60869565217394,46,34,9,9,0,25,25,0,-12,26.08695652173913,26.47058823529412,26.47058823529412,0.0,88.73873873873875,88.73873873873875,0.0,Expe usine
3083,1,2019-02-07,133133,LIGHT&FREE FRAIS BOIS 120X4 OD,1,0,0,LIGHT & FREE,0,Ferrières(FR),0078,0024 FR PARIS NORD (DC),61,286,286,276,10,10,0,0,225,-368.8524590163934,61,49,49,39,10,10,0,0,-12,19.672131147540984,100.0,79.59183673469387,20.40816326530613,100.0,96.5034965034965,3.496503496503493,Probleme Copacking
3084,0,2019-02-08,2631,GERVITA STRAW 100gx4,0,0,0,GERVITA,0,Ferrières(FR),0084,0024 FR AIX (DC),1879,3060,2919,2904,15,156,141,0,1181,-62.85258116019159,473,437,437,437,0,0,0,0,-36,7.6109936575052854,100.0,100.0,0.0,95.3921568627451,94.90196078431372,0.49019607843138147,Previsions
3085,0,2019-02-08,2631,GERVITA STRAW 100gx4,0,0,0,GERVITA,0,Ferrières(FR),0080,0024 FR METZ (DC),1879,3060,2919,2904,15,156,141,0,1181,-62.85258116019159,19,199,199,199,0,0,0,0,180,-947.3684210526316,100.0,100.0,0.0,95.3921568627451,94.90196078431372,0.49019607843138147,Previsions
3086,0,2019-02-08,2631,GERVITA STRAW 100gx4,0,0,0,GERVITA,0,Ferrières(FR),0081,0024 FR TOURS (DC),1879,3060,2919,2904,15,156,141,0,1181,-62.85258116019159,278,273,273,273,0,0,0,0,-5,1.7985611510791366,100.0,100.0,0.0,95.3921568627451,94.90196078431372,0.49019607843138147,Previsions
3087,0,2019-02-08,2631,GERVITA STRAW 100gx4,0,0,0,GERVITA,0,Ferrières(FR),0082,0024 FR VALLET (DC),1879,3060,2919,2904,15,156,141,0,1181,-62.85258116019159,232,250,250,250,0,0,0,0,18,-7.758620689655173,100.0,100.0,0.0,95.3921568627451,94.90196078431372,0.49019607843138147,Previsions
3088,0,2019-02-08,2631,GERVITA STRAW 100gx4,0,0,0,GERVITA,0,Ferrières(FR),0077,0024 FR LILPARK (DC),1879,3060,2919,2904,15,156,141,0,1181,-62.85258116019159,22,203,62,47,15,156,141,0,181,-822.7272727272727,30.541871921182267,23.15270935960591,7.389162561576356,95.3921568627451,94.90196078431372,0.49019607843138147,Previsions
3089,0,2019-02-08,2631,GERVITA STRAW 100gx4,0,0,0,GERVITA,0,Ferrières(FR),0085,0024 FR TOULOUSE (DC),1879,3060,2919,2904,15,156,141,0,1181,-62.85258116019159,31,277,277,277,0,0,0,0,246,-793.5483870967741,100.0,100.0,0.0,95.3921568627451,94.90196078431372,0.49019607843138147,Previsions
3090,0,2019-02-08,2631,GERVITA STRAW 100gx4,0,0,0,GERVITA,0,Ferrières(FR),0083,0024 FR CHAPONNAY (DC),1879,3060,2919,2904,15,156,141,0,1181,-62.85258116019159,296,282,282,282,0,0,0,0,-14,4.72972972972973,100.0,100.0,0.0,95.3921568627451,94.90196078431372,0.49019607843138147,Previsions
3091,0,2019-02-08,2631,GERVITA STRAW 100gx4,0,0,0,GERVITA,0,Ferrières(FR),0079,0024 FR PARIS SUD (DC),1879,3060,2919,2904,15,156,141,0,1181,-62.85258116019159,454,441,441,441,0,0,0,0,-13,2.8634361233480177,100.0,100.0,0.0,95.3921568627451,94.90196078431372,0.49019607843138147,Previsions
3092,0,2019-02-08,2631,GERVITA STRAW 100gx4,0,0,0,GERVITA,0,Ferrières(FR),0078,0024 FR PARIS NORD (DC),1879,3060,2919,2904,15,156,141,0,1181,-62.85258116019159,74,698,698,698,0,0,0,0,624,-843.2432432432432,100.0,100.0,0.0,95.3921568627451,94.90196078431372,0.49019607843138147,Previsions
3093,0,2019-02-08,32787,TAILLEF CHEESE PEACH 120GX4,0,0,0,TAILLEFINE,0,Ferrières(FR),0084,0024 FR AIX (DC),602,893,841,567,274,326,52,0,291,-48.33887043189369,98,87,87,87,0,0,0,0,-11,11.224489795918368,100.0,100.0,0.0,94.17693169092945,63.49384098544233,30.683090705487118,Expe usine
3094,0,2019-02-08,32787,TAILLEF CHEESE PEACH 120GX4,0,0,0,TAILLEFINE,0,Ferrières(FR),0080,0024 FR METZ (DC),602,893,841,567,274,326,52,0,291,-48.33887043189369,6,115,63,1,62,114,52,0,109,-1816.6666666666667,54.78260869565217,0.8695652173913043,53.91304347826087,94.17693169092945,63.49384098544233,30.683090705487118,Expe usine
3095,0,2019-02-08,32787,TAILLEF CHEESE PEACH 120GX4,0,0,0,TAILLEFINE,0,Ferrières(FR),0081,0024 FR TOURS (DC),602,893,841,567,274,326,52,0,291,-48.33887043189369,56,132,132,0,132,132,0,0,76,-135.71428571428572,100.0,0.0,100.0,94.17693169092945,63.49384098544233,30.683090705487118,Expe usine
3096,0,2019-02-08,32787,TAILLEF CHEESE PEACH 120GX4,0,0,0,TAILLEFINE,0,Ferrières(FR),0082,0024 FR VALLET (DC),602,893,841,567,274,326,52,0,291,-48.33887043189369,86,68,68,68,0,0,0,0,-18,20.930232558139537,100.0,100.0,0.0,94.17693169092945,63.49384098544233,30.683090705487118,Expe usine
3097,0,2019-02-08,32787,TAILLEF CHEESE PEACH 120GX4,0,0,0,TAILLEFINE,0,Ferrières(FR),0077,0024 FR LILPARK (DC),602,893,841,567,274,326,52,0,291,-48.33887043189369,65,79,79,79,0,0,0,0,14,-21.53846153846154,100.0,100.0,0.0,94.17693169092945,63.49384098544233,30.683090705487118,Expe usine
3098,0,2019-02-08,32787,TAILLEF CHEESE PEACH 120GX4,0,0,0,TAILLEFINE,0,Ferrières(FR),0085,0024 FR TOULOUSE (DC),602,893,841,567,274,326,52,0,291,-48.33887043189369,53,109,109,29,80,80,0,0,56,-105.66037735849056,100.0,26.605504587155966,73.39449541284404,94.17693169092945,63.49384098544233,30.683090705487118,Expe usine
3099,0,2019-02-08,32787,TAILLEF CHEESE PEACH 120GX4,0,0,0,TAILLEFINE,0,Ferrières(FR),0083,0024 FR CHAPONNAY (DC),602,893,841,567,274,326,52,0,291,-48.33887043189369,54,87,87,87,0,0,0,0,33,-61.111111111111114,100.0,100.0,0.0,94.17693169092945,63.49384098544233,30.683090705487118,Expe usine
3100,0,2019-02-08,32787,TAILLEF CHEESE PEACH 120GX4,0,0,0,TAILLEFINE,0,Ferrières(FR),0079,0024 FR PARIS SUD (DC),602,893,841,567,274,326,52,0,291,-48.33887043189369,108,132,132,132,0,0,0,0,24,-22.22222222222222,100.0,100.0,0.0,94.17693169092945,63.49384098544233,30.683090705487118,Expe usine
3101,0,2019-02-08,32787,TAILLEF CHEESE PEACH 120GX4,0,0,0,TAILLEFINE,0,Ferrières(FR),0078,0024 FR PARIS NORD (DC),602,893,841,567,274,326,52,0,291,-48.33887043189369,76,84,84,84,0,0,0,0,8,-10.526315789473685,100.0,100.0,0.0,94.17693169092945,63.49384098544233,30.683090705487118,Expe usine
3102,0,2019-02-08,122523,DANONINO FRTS PANACHE 50X16,0,0,0,DANONINO,0,Ferrières(FR),0084,0024 FR AIX (DC),184,268,210,206,4,62,58,0,84,-45.65217391304348,27,31,24,21,3,10,7,0,4,-14.814814814814815,77.41935483870968,67.74193548387096,9.677419354838719,78.35820895522389,76.86567164179104,1.4925373134328481,Previsions
3103,0,2019-02-08,122523,DANONINO FRTS PANACHE 50X16,0,0,0,DANONINO,0,Ferrières(FR),0081,0024 FR TOURS (DC),184,268,210,206,4,62,58,0,84,-45.65217391304348,22,41,41,41,0,0,0,0,19,-86.36363636363636,100.0,100.0,0.0,78.35820895522389,76.86567164179104,1.4925373134328481,Previsions
3104,0,2019-02-08,122523,DANONINO FRTS PANACHE 50X16,0,0,0,DANONINO,0,Ferrières(FR),0077,0024 FR LILPARK (DC),184,268,210,206,4,62,58,0,84,-45.65217391304348,35,66,15,14,1,52,51,0,31,-88.57142857142857,22.727272727272727,21.21212121212121,1.5151515151515156,78.35820895522389,76.86567164179104,1.4925373134328481,Previsions
3105,0,2019-02-08,122523,DANONINO FRTS PANACHE 50X16,0,0,0,DANONINO,0,Ferrières(FR),0085,0024 FR TOULOUSE (DC),184,268,210,206,4,62,58,0,84,-45.65217391304348,22,36,36,36,0,0,0,0,14,-63.63636363636363,100.0,100.0,0.0,78.35820895522389,76.86567164179104,1.4925373134328481,Previsions
3106,0,2019-02-08,122523,DANONINO FRTS PANACHE 50X16,0,0,0,DANONINO,0,Ferrières(FR),0083,0024 FR CHAPONNAY (DC),184,268,210,206,4,62,58,0,84,-45.65217391304348,51,55,55,55,0,0,0,0,4,-7.8431372549019605,100.0,100.0,0.0,78.35820895522389,76.86567164179104,1.4925373134328481,Previsions
3107,0,2019-02-08,122523,DANONINO FRTS PANACHE 50X16,0,0,0,DANONINO,0,Ferrières(FR),0078,0024 FR PARIS NORD (DC),184,268,210,206,4,62,58,0,84,-45.65217391304348,27,39,39,39,0,0,0,0,12,-44.44444444444444,100.0,100.0,0.0,78.35820895522389,76.86567164179104,1.4925373134328481,Previsions
3108,0,2019-02-08,135066,ACTIVIA SAV VANILLE 125X12 OD,1,0,0,ACTIVIA,0,Bailleul(FR),0084,0024 FR AIX (DC),2009,1119,1119,897,222,222,0,0,-890,44.30064708810353,27,175,175,175,0,0,0,0,148,-548.1481481481482,100.0,100.0,0.0,100.0,80.16085790884718,19.839142091152823,Client
3109,0,2019-02-08,135066,ACTIVIA SAV VANILLE 125X12 OD,1,0,0,ACTIVIA,0,Bailleul(FR),0081,0024 FR TOURS (DC),2009,1119,1119,897,222,222,0,0,-890,44.30064708810353,199,109,109,104,5,5,0,0,-90,45.22613065326633,100.0,95.41284403669725,4.587155963302749,100.0,80.16085790884718,19.839142091152823,Client
3110,0,2019-02-08,135066,ACTIVIA SAV VANILLE 125X12 OD,1,0,0,ACTIVIA,0,Bailleul(FR),0082,0024 FR VALLET (DC),2009,1119,1119,897,222,222,0,0,-890,44.30064708810353,175,124,124,124,0,0,0,0,-51,29.142857142857142,100.0,100.0,0.0,100.0,80.16085790884718,19.839142091152823,Client
3111,0,2019-02-08,135066,ACTIVIA SAV VANILLE 125X12 OD,1,0,0,ACTIVIA,0,Bailleul(FR),0077,0024 FR LILPARK (DC),2009,1119,1119,897,222,222,0,0,-890,44.30064708810353,1,12,12,12,0,0,0,0,11,-1100.0,100.0,100.0,0.0,100.0,80.16085790884718,19.839142091152823,Client
3112,0,2019-02-08,135066,ACTIVIA SAV VANILLE 125X12 OD,1,0,0,ACTIVIA,0,Bailleul(FR),0085,0024 FR TOULOUSE (DC),2009,1119,1119,897,222,222,0,0,-890,44.30064708810353,238,154,154,154,0,0,0,0,-84,35.294117647058826,100.0,100.0,0.0,100.0,80.16085790884718,19.839142091152823,Client
3113,0,2019-02-08,135066,ACTIVIA SAV VANILLE 125X12 OD,1,0,0,ACTIVIA,0,Bailleul(FR),0083,0024 FR CHAPONNAY (DC),2009,1119,1119,897,222,222,0,0,-890,44.30064708810353,582,364,364,147,217,217,0,0,-218,37.45704467353952,100.0,40.38461538461539,59.61538461538461,100.0,80.16085790884718,19.839142091152823,Client
3114,1,2019-02-08,135066,ACTIVIA SAV VANILLE 125X12 OD,1,0,0,ACTIVIA,0,Bailleul(FR),0083,0024 FR CHAPONNAY (DC),2009,1119,1119,897,222,222,0,0,-890,44.30064708810353,582,364,364,147,217,217,0,0,-218,37.45704467353952,100.0,40.38461538461539,59.61538461538461,100.0,80.16085790884718,19.839142091152823,Transport
3115,0,2019-02-08,135066,ACTIVIA SAV VANILLE 125X12 OD,1,0,0,ACTIVIA,0,Bailleul(FR),0079,0024 FR PARIS SUD (DC),2009,1119,1119,897,222,222,0,0,-890,44.30064708810353,121,88,88,88,0,0,0,0,-33,27.272727272727273,100.0,100.0,0.0,100.0,80.16085790884718,19.839142091152823,Client
3116,0,2019-02-08,135066,ACTIVIA SAV VANILLE 125X12 OD,1,0,0,ACTIVIA,0,Bailleul(FR),0078,0024 FR PARIS NORD (DC),2009,1119,1119,897,222,222,0,0,-890,44.30064708810353,84,93,93,93,0,0,0,0,9,-10.714285714285714,100.0,100.0,0.0,100.0,80.16085790884718,19.839142091152823,Client
3117,0,2019-02-08,138394,DANONINO FRTS PANACHE 50X24 D,0,0,0,DANONINO,0,Ferrières(FR),0079,0024 FR PARIS SUD (DC),141,335,271,271,0,64,64,0,194,-137.5886524822695,141,320,256,256,0,64,64,0,179,-126.95035460992908,80.0,80.0,0.0,80.8955223880597,80.8955223880597,0.0,Déploiement/Quarantaine
3118,0,2019-02-08,138394,DANONINO FRTS PANACHE 50X24 D,0,0,0,DANONINO,0,Ferrières(FR),0078,0024 FR PARIS NORD (DC),141,335,271,271,0,64,64,0,194,-137.5886524822695,0,15,15,15,0,0,0,1,15,10000.0,100.0,100.0,0.0,80.8955223880597,80.8955223880597,0.0,Déploiement/Quarantaine
3119,0,2019-02-09,122177,LES 2 VACHES MYRTILLES 115X4,0,0,0,LES 2 VACHES,0,LeMolay(FR),0084,0024 FR AIX (DC),1614,1606,1436,1436,0,170,170,0,-8,0.49566294919454773,146,188,170,170,0,18,18,0,42,-28.767123287671232,90.42553191489363,90.42553191489363,0.0,89.41469489414695,89.41469489414695,0.0,Previsions
3120,0,2019-02-09,122177,LES 2 VACHES MYRTILLES 115X4,0,0,0,LES 2 VACHES,0,LeMolay(FR),0080,0024 FR METZ (DC),1614,1606,1436,1436,0,170,170,0,-8,0.49566294919454773,58,64,64,64,0,0,0,0,6,-10.344827586206897,100.0,100.0,0.0,89.41469489414695,89.41469489414695,0.0,Previsions
3121,0,2019-02-09,122177,LES 2 VACHES MYRTILLES 115X4,0,0,0,LES 2 VACHES,0,LeMolay(FR),0081,0024 FR TOURS (DC),1614,1606,1436,1436,0,170,170,0,-8,0.49566294919454773,228,210,210,210,0,0,0,0,-18,7.894736842105263,100.0,100.0,0.0,89.41469489414695,89.41469489414695,0.0,Previsions
3122,0,2019-02-09,122177,LES 2 VACHES MYRTILLES 115X4,0,0,0,LES 2 VACHES,0,LeMolay(FR),0082,0024 FR VALLET (DC),1614,1606,1436,1436,0,170,170,0,-8,0.49566294919454773,196,129,129,129,0,0,0,0,-67,34.183673469387756,100.0,100.0,0.0,89.41469489414695,89.41469489414695,0.0,Previsions
3123,0,2019-02-09,122177,LES 2 VACHES MYRTILLES 115X4,0,0,0,LES 2 VACHES,0,LeMolay(FR),0077,0024 FR LILPARK (DC),1614,1606,1436,1436,0,170,170,0,-8,0.49566294919454773,84,55,55,55,0,0,0,0,-29,34.523809523809526,100.0,100.0,0.0,89.41469489414695,89.41469489414695,0.0,Previsions
3124,0,2019-02-09,122177,LES 2 VACHES MYRTILLES 115X4,0,0,0,LES 2 VACHES,0,LeMolay(FR),0085,0024 FR TOULOUSE (DC),1614,1606,1436,1436,0,170,170,0,-8,0.49566294919454773,131,137,137,137,0,0,0,0,6,-4.580152671755725,100.0,100.0,0.0,89.41469489414695,89.41469489414695,0.0,Previsions
3125,0,2019-02-09,122177,LES 2 VACHES MYRTILLES 115X4,0,0,0,LES 2 VACHES,0,LeMolay(FR),0083,0024 FR CHAPONNAY (DC),1614,1606,1436,1436,0,170,170,0,-8,0.49566294919454773,224,217,217,217,0,0,0,0,-7,3.125,100.0,100.0,0.0,89.41469489414695,89.41469489414695,0.0,Previsions
3126,0,2019-02-09,122177,LES 2 VACHES MYRTILLES 115X4,0,0,0,LES 2 VACHES,0,LeMolay(FR),0079,0024 FR PARIS SUD (DC),1614,1606,1436,1436,0,170,170,0,-8,0.49566294919454773,226,254,102,102,0,152,152,0,28,-12.389380530973451,40.15748031496063,40.15748031496063,0.0,89.41469489414695,89.41469489414695,0.0,Previsions
3127,0,2019-02-09,122177,LES 2 VACHES MYRTILLES 115X4,0,0,0,LES 2 VACHES,0,LeMolay(FR),0078,0024 FR PARIS NORD (DC),1614,1606,1436,1436,0,170,170,0,-8,0.49566294919454773,321,352,352,352,0,0,0,0,31,-9.657320872274143,100.0,100.0,0.0,89.41469489414695,89.41469489414695,0.0,Previsions
3128,0,2019-02-09,122523,DANONINO FRTS PANACHE 50X16,0,0,0,DANONINO,0,Ferrières(FR),0084,0024 FR AIX (DC),112,112,65,61,4,51,47,0,0,0.0,15,22,2,1,1,21,20,0,7,-46.666666666666664,9.090909090909092,4.545454545454546,4.545454545454546,58.03571428571429,54.46428571428571,3.5714285714285836,Previsions
3129,0,2019-02-09,122523,DANONINO FRTS PANACHE 50X16,0,0,0,DANONINO,0,Ferrières(FR),0081,0024 FR TOURS (DC),112,112,65,61,4,51,47,0,0,0.0,20,33,15,12,3,21,18,0,13,-65.0,45.45454545454545,36.36363636363637,9.090909090909086,58.03571428571429,54.46428571428571,3.5714285714285836,Previsions
3130,0,2019-02-09,122523,DANONINO FRTS PANACHE 50X16,0,0,0,DANONINO,0,Ferrières(FR),0085,0024 FR TOULOUSE (DC),112,112,65,61,4,51,47,0,0,0.0,23,16,16,16,0,0,0,0,-7,30.434782608695652,100.0,100.0,0.0,58.03571428571429,54.46428571428571,3.5714285714285836,Previsions
3131,0,2019-02-09,122523,DANONINO FRTS PANACHE 50X16,0,0,0,DANONINO,0,Ferrières(FR),0083,0024 FR CHAPONNAY (DC),112,112,65,61,4,51,47,0,0,0.0,24,15,6,6,0,9,9,0,-9,37.5,40.0,40.0,0.0,58.03571428571429,54.46428571428571,3.5714285714285836,Previsions
3132,0,2019-02-09,122523,DANONINO FRTS PANACHE 50X16,0,0,0,DANONINO,0,Ferrières(FR),0078,0024 FR PARIS NORD (DC),112,112,65,61,4,51,47,0,0,0.0,30,26,26,26,0,0,0,0,-4,13.333333333333334,100.0,100.0,0.0,58.03571428571429,54.46428571428571,3.5714285714285836,Previsions
3133,0,2019-02-09,128868,LES 2 VACHES CARAMEL 95X4,0,0,0,LES 2 VACHES,0,LeMolay(FR),0080,0024 FR METZ (DC),257,240,240,235,5,5,0,0,-17,6.614785992217898,36,28,28,28,0,0,0,0,-8,22.22222222222222,100.0,100.0,0.0,100.0,97.91666666666666,2.083333333333343,Previsions
3134,0,2019-02-09,128868,LES 2 VACHES CARAMEL 95X4,0,0,0,LES 2 VACHES,0,LeMolay(FR),0081,0024 FR TOURS (DC),257,240,240,235,5,5,0,0,-17,6.614785992217898,70,71,71,71,0,0,0,0,1,-1.4285714285714286,100.0,100.0,0.0,100.0,97.91666666666666,2.083333333333343,Previsions
3135,0,2019-02-09,128868,LES 2 VACHES CARAMEL 95X4,0,0,0,LES 2 VACHES,0,LeMolay(FR),0077,0024 FR LILPARK (DC),257,240,240,235,5,5,0,0,-17,6.614785992217898,15,56,56,56,0,0,0,0,41,-273.3333333333333,100.0,100.0,0.0,100.0,97.91666666666666,2.083333333333343,Previsions
3136,0,2019-02-09,128868,LES 2 VACHES CARAMEL 95X4,0,0,0,LES 2 VACHES,0,LeMolay(FR),0085,0024 FR TOULOUSE (DC),257,240,240,235,5,5,0,0,-17,6.614785992217898,43,37,37,37,0,0,0,0,-6,13.953488372093023,100.0,100.0,0.0,100.0,97.91666666666666,2.083333333333343,Previsions
3137,0,2019-02-09,128868,LES 2 VACHES CARAMEL 95X4,0,0,0,LES 2 VACHES,0,LeMolay(FR),0079,0024 FR PARIS SUD (DC),257,240,240,235,5,5,0,0,-17,6.614785992217898,78,32,32,27,5,5,0,0,-46,58.97435897435897,100.0,84.375,15.625,100.0,97.91666666666666,2.083333333333343,Previsions
3138,0,2019-02-09,128868,LES 2 VACHES CARAMEL 95X4,0,0,0,LES 2 VACHES,0,LeMolay(FR),0078,0024 FR PARIS NORD (DC),257,240,240,235,5,5,0,0,-17,6.614785992217898,15,16,16,16,0,0,0,0,1,-6.666666666666667,100.0,100.0,0.0,100.0,97.91666666666666,2.083333333333343,Previsions
3139,0,2019-02-09,131489,ACTIVIA AB FR MA KI 125X8 OD,1,0,0,ACTIVIA,0,Villecomtal(FR),0080,0024 FR METZ (DC),143,157,157,157,0,0,0,0,14,-9.79020979020979,98,100,100,100,0,0,0,0,2,-2.0408163265306123,100.0,100.0,0.0,100.0,100.0,0.0,Previsions
3140,0,2019-02-09,131489,ACTIVIA AB FR MA KI 125X8 OD,1,0,0,ACTIVIA,0,Villecomtal(FR),0077,0024 FR LILPARK (DC),143,157,157,157,0,0,0,0,14,-9.79020979020979,21,33,33,33,0,0,0,0,12,-57.142857142857146,100.0,100.0,0.0,100.0,100.0,0.0,Previsions
3141,0,2019-02-09,131489,ACTIVIA AB FR MA KI 125X8 OD,1,0,0,ACTIVIA,0,Villecomtal(FR),0083,0024 FR CHAPONNAY (DC),143,157,157,157,0,0,0,0,14,-9.79020979020979,24,24,24,24,0,0,0,0,0,0.0,100.0,100.0,0.0,100.0,100.0,0.0,Previsions
3142,0,2019-03-11,121321,ACTIMEL MULTI 3x(8x100g) FR,0,0,0,ACTIMEL,1,Aldaya(ES),0084,0024 FR AIX (DC),2427,2135,1785,1774,11,361,350,0,-292,12.031314379892871,204,167,40,30,10,137,127,0,-37,18.137254901960784,23.952095808383234,17.964071856287426,5.9880239520958085,83.60655737704919,83.09133489461358,0.515222482435604,Schéma
3143,0,2019-03-11,121321,ACTIMEL MULTI 3x(8x100g) FR,0,0,0,ACTIMEL,1,Aldaya(ES),0080,0024 FR METZ (DC),2427,2135,1785,1774,11,361,350,0,-292,12.031314379892871,310,263,199,199,0,64,64,0,-47,15.161290322580646,75.66539923954373,75.66539923954373,0.0,83.60655737704919,83.09133489461358,0.515222482435604,Schéma
3144,0,2019-03-11,121321,ACTIMEL MULTI 3x(8x100g) FR,0,0,0,ACTIMEL,1,Aldaya(ES),0081,0024 FR TOURS (DC),2427,2135,1785,1774,11,361,350,0,-292,12.031314379892871,213,227,106,105,1,122,121,0,14,-6.572769953051643,46.69603524229075,46.25550660792951,0.440528634361236,83.60655737704919,83.09133489461358,0.515222482435604,Schéma
3145,0,2019-03-11,121321,ACTIMEL MULTI 3x(8x100g) FR,0,0,0,ACTIMEL,1,Aldaya(ES),0082,0024 FR VALLET (DC),2427,2135,1785,1774,11,361,350,0,-292,12.031314379892871,176,151,151,151,0,0,0,0,-25,14.204545454545455,100.0,100.0,0.0,83.60655737704919,83.09133489461358,0.515222482435604,Schéma
3146,0,2019-03-11,121321,ACTIMEL MULTI 3x(8x100g) FR,0,0,0,ACTIMEL,1,Aldaya(ES),0077,0024 FR LILPARK (DC),2427,2135,1785,1774,11,361,350,0,-292,12.031314379892871,92,95,57,57,0,38,38,0,3,-3.260869565217391,60.0,60.0,0.0,83.60655737704919,83.09133489461358,0.515222482435604,Schéma
3147,0,2019-03-11,121321,ACTIMEL MULTI 3x(8x100g) FR,0,0,0,ACTIMEL,1,Aldaya(ES),0085,0024 FR TOULOUSE (DC),2427,2135,1785,1774,11,361,350,0,-292,12.031314379892871,298,178,178,178,0,0,0,0,-120,40.26845637583892,100.0,100.0,0.0,83.60655737704919,83.09133489461358,0.515222482435604,Schéma
3148,0,2019-03-11,121321,ACTIMEL MULTI 3x(8x100g) FR,0,0,0,ACTIMEL,1,Aldaya(ES),0083,0024 FR CHAPONNAY (DC),2427,2135,1785,1774,11,361,350,0,-292,12.031314379892871,382,284,284,284,0,0,0,0,-98,25.654450261780106,100.0,100.0,0.0,83.60655737704919,83.09133489461358,0.515222482435604,Schéma
3149,0,2019-03-11,121321,ACTIMEL MULTI 3x(8x100g) FR,0,0,0,ACTIMEL,1,Aldaya(ES),0079,0024 FR PARIS SUD (DC),2427,2135,1785,1774,11,361,350,0,-292,12.031314379892871,378,383,383,383,0,0,0,0,5,-1.3227513227513228,100.0,100.0,0.0,83.60655737704919,83.09133489461358,0.515222482435604,Schéma
3150,0,2019-03-11,121321,ACTIMEL MULTI 3x(8x100g) FR,0,0,0,ACTIMEL,1,Aldaya(ES),0078,0024 FR PARIS NORD (DC),2427,2135,1785,1774,11,361,350,0,-292,12.031314379892871,374,387,387,387,0,0,0,0,13,-3.4759358288770055,100.0,100.0,0.0,83.60655737704919,83.09133489461358,0.515222482435604,Schéma
3151,0,2019-03-11,121446,ACTIMEL NATU 6x(4x100g) BE/FR,0,0,0,ACTIMEL,1,Rotselaar(BE),0084,0024 FR AIX (DC),326,526,520,474,46,52,6,0,200,-61.34969325153374,51,56,56,56,0,0,0,0,5,-9.803921568627452,100.0,100.0,0.0,98.85931558935361,90.11406844106465,8.745247148288968,Transport
3152,0,2019-03-11,121446,ACTIMEL NATU 6x(4x100g) BE/FR,0,0,0,ACTIMEL,1,Rotselaar(BE),0080,0024 FR METZ (DC),326,526,520,474,46,52,6,0,200,-61.34969325153374,57,69,63,18,45,51,6,0,12,-21.05263157894737,91.30434782608695,26.08695652173913,65.21739130434783,98.85931558935361,90.11406844106465,8.745247148288968,Transport
3153,0,2019-03-11,121446,ACTIMEL NATU 6x(4x100g) BE/FR,0,0,0,ACTIMEL,1,Rotselaar(BE),0081,0024 FR TOURS (DC),326,526,520,474,46,52,6,0,200,-61.34969325153374,43,32,32,31,1,1,0,0,-11,25.58139534883721,100.0,96.875,3.125,98.85931558935361,90.11406844106465,8.745247148288968,Transport
3154,0,2019-03-11,121446,ACTIMEL NATU 6x(4x100g) BE/FR,0,0,0,ACTIMEL,1,Rotselaar(BE),0082,0024 FR VALLET (DC),326,526,520,474,46,52,6,0,200,-61.34969325153374,36,28,28,28,0,0,0,0,-8,22.22222222222222,100.0,100.0,0.0,98.85931558935361,90.11406844106465,8.745247148288968,Transport
3155,0,2019-03-11,121446,ACTIMEL NATU 6x(4x100g) BE/FR,0,0,0,ACTIMEL,1,Rotselaar(BE),0077,0024 FR LILPARK (DC),326,526,520,474,46,52,6,0,200,-61.34969325153374,21,41,41,41,0,0,0,0,20,-95.23809523809524,100.0,100.0,0.0,98.85931558935361,90.11406844106465,8.745247148288968,Transport
3156,0,2019-03-11,121446,ACTIMEL NATU 6x(4x100g) BE/FR,0,0,0,ACTIMEL,1,Rotselaar(BE),0085,0024 FR TOULOUSE (DC),326,526,520,474,46,52,6,0,200,-61.34969325153374,42,66,66,66,0,0,0,0,24,-57.142857142857146,100.0,100.0,0.0,98.85931558935361,90.11406844106465,8.745247148288968,Transport
3157,0,2019-03-11,121446,ACTIMEL NATU 6x(4x100g) BE/FR,0,0,0,ACTIMEL,1,Rotselaar(BE),0083,0024 FR CHAPONNAY (DC),326,526,520,474,46,52,6,0,200,-61.34969325153374,62,67,67,67,0,0,0,0,5,-8.064516129032258,100.0,100.0,0.0,98.85931558935361,90.11406844106465,8.745247148288968,Transport
3158,0,2019-03-11,121446,ACTIMEL NATU 6x(4x100g) BE/FR,0,0,0,ACTIMEL,1,Rotselaar(BE),0078,0024 FR PARIS NORD (DC),326,526,520,474,46,52,6,0,200,-61.34969325153374,14,167,167,167,0,0,0,0,153,-1092.857142857143,100.0,100.0,0.0,98.85931558935361,90.11406844106465,8.745247148288968,Transport
3159,0,2019-03-11,138806,DANONE LAIT ENT AMANDE 125X4 ED,0,0,0,DANONE,0,Bailleul(FR),0084,0024 FR AIX (DC),555,763,652,652,0,111,111,0,208,-37.47747747747748,41,103,72,72,0,31,31,0,62,-151.21951219512195,69.90291262135922,69.90291262135922,0.0,85.4521625163827,85.4521625163827,0.0,Previsions
3160,0,2019-03-11,138806,DANONE LAIT ENT AMANDE 125X4 ED,0,0,0,DANONE,0,Bailleul(FR),0080,0024 FR METZ (DC),555,763,652,652,0,111,111,0,208,-37.47747747747748,71,108,108,108,0,0,0,0,37,-52.11267605633803,100.0,100.0,0.0,85.4521625163827,85.4521625163827,0.0,Previsions
3161,0,2019-03-11,138806,DANONE LAIT ENT AMANDE 125X4 ED,0,0,0,DANONE,0,Bailleul(FR),0081,0024 FR TOURS (DC),555,763,652,652,0,111,111,0,208,-37.47747747747748,125,158,133,133,0,25,25,0,33,-26.4,84.17721518987342,84.17721518987342,0.0,85.4521625163827,85.4521625163827,0.0,Previsions
3162,0,2019-03-11,138806,DANONE LAIT ENT AMANDE 125X4 ED,0,0,0,DANONE,0,Bailleul(FR),0082,0024 FR VALLET (DC),555,763,652,652,0,111,111,0,208,-37.47747747747748,57,92,80,80,0,12,12,0,35,-61.40350877192982,86.95652173913044,86.95652173913044,0.0,85.4521625163827,85.4521625163827,0.0,Previsions
3163,0,2019-03-11,138806,DANONE LAIT ENT AMANDE 125X4 ED,0,0,0,DANONE,0,Bailleul(FR),0077,0024 FR LILPARK (DC),555,763,652,652,0,111,111,0,208,-37.47747747747748,5,3,3,3,0,0,0,0,-2,40.0,100.0,100.0,0.0,85.4521625163827,85.4521625163827,0.0,Previsions
3164,0,2019-03-11,138806,DANONE LAIT ENT AMANDE 125X4 ED,0,0,0,DANONE,0,Bailleul(FR),0085,0024 FR TOULOUSE (DC),555,763,652,652,0,111,111,0,208,-37.47747747747748,81,107,79,79,0,28,28,0,26,-32.098765432098766,73.83177570093457,73.83177570093457,0.0,85.4521625163827,85.4521625163827,0.0,Previsions
3165,0,2019-03-11,138806,DANONE LAIT ENT AMANDE 125X4 ED,0,0,0,DANONE,0,Bailleul(FR),0083,0024 FR CHAPONNAY (DC),555,763,652,652,0,111,111,0,208,-37.47747747747748,86,100,85,85,0,15,15,0,14,-16.27906976744186,85.0,85.0,0.0,85.4521625163827,85.4521625163827,0.0,Previsions
3166,0,2019-03-11,138806,DANONE LAIT ENT AMANDE 125X4 ED,0,0,0,DANONE,0,Bailleul(FR),0078,0024 FR PARIS NORD (DC),555,763,652,652,0,111,111,0,208,-37.47747747747748,89,92,92,92,0,0,0,0,3,-3.3707865168539324,100.0,100.0,0.0,85.4521625163827,85.4521625163827,0.0,Previsions
3167,1,2019-03-11,142281,ACTIVIA NAT 125X12+4,1,0,0,ACTIVIA,0,Bailleul(FR),0080,0024 FR METZ (DC),26,656,656,602,54,54,0,0,630,-2423.076923076923,26,49,49,0,49,49,0,0,23,-88.46153846153847,100.0,0.0,100.0,100.0,91.76829268292683,8.231707317073173,A Creuser
3168,0,2019-03-12,25528,DANACOL DR PLAIN 0% 100GX4 FR,0,0,0,DANACOL,1,Aldaya(ES),0084,0024 FR AIX (DC),287,390,220,211,9,179,170,0,103,-35.88850174216028,48,54,28,26,2,28,26,0,6,-12.5,51.85185185185185,48.148148148148145,3.7037037037037024,56.41025641025641,54.1025641025641,2.3076923076923066,A Creuser
3169,0,2019-03-12,25528,DANACOL DR PLAIN 0% 100GX4 FR,0,0,0,DANACOL,1,Aldaya(ES),0080,0024 FR METZ (DC),287,390,220,211,9,179,170,0,103,-35.88850174216028,23,27,27,27,0,0,0,0,4,-17.391304347826086,100.0,100.0,0.0,56.41025641025641,54.1025641025641,2.3076923076923066,A Creuser
3170,0,2019-03-12,25528,DANACOL DR PLAIN 0% 100GX4 FR,0,0,0,DANACOL,1,Aldaya(ES),0082,0024 FR VALLET (DC),287,390,220,211,9,179,170,0,103,-35.88850174216028,27,41,6,0,6,41,35,0,14,-51.851851851851855,14.634146341463413,0.0,14.634146341463413,56.41025641025641,54.1025641025641,2.3076923076923066,A Creuser
3171,0,2019-03-12,25528,DANACOL DR PLAIN 0% 100GX4 FR,0,0,0,DANACOL,1,Aldaya(ES),0077,0024 FR LILPARK (DC),287,390,220,211,9,179,170,0,103,-35.88850174216028,27,34,34,34,0,0,0,0,7,-25.925925925925927,100.0,100.0,0.0,56.41025641025641,54.1025641025641,2.3076923076923066,A Creuser
3172,0,2019-03-12,25528,DANACOL DR PLAIN 0% 100GX4 FR,0,0,0,DANACOL,1,Aldaya(ES),0085,0024 FR TOULOUSE (DC),287,390,220,211,9,179,170,0,103,-35.88850174216028,31,61,61,61,0,0,0,0,30,-96.7741935483871,100.0,100.0,0.0,56.41025641025641,54.1025641025641,2.3076923076923066,A Creuser
3173,0,2019-03-12,25528,DANACOL DR PLAIN 0% 100GX4 FR,0,0,0,DANACOL,1,Aldaya(ES),0083,0024 FR CHAPONNAY (DC),287,390,220,211,9,179,170,0,103,-35.88850174216028,36,48,45,45,0,3,3,0,12,-33.333333333333336,93.75,93.75,0.0,56.41025641025641,54.1025641025641,2.3076923076923066,A Creuser
3174,0,2019-03-12,25528,DANACOL DR PLAIN 0% 100GX4 FR,0,0,0,DANACOL,1,Aldaya(ES),0079,0024 FR PARIS SUD (DC),287,390,220,211,9,179,170,0,103,-35.88850174216028,95,125,19,18,1,107,106,0,30,-31.57894736842105,15.2,14.399999999999999,0.8000000000000007,56.41025641025641,54.1025641025641,2.3076923076923066,A Creuser
3175,0,2019-03-12,121320,ACTIMEL NATU 4x(12x100g) FR,0,0,0,ACTIMEL,1,Rotselaar(BE),0084,0024 FR AIX (DC),2014,2905,2191,2189,2,716,714,0,891,-44.240317775571,184,287,167,167,0,120,120,0,103,-55.97826086956522,58.18815331010453,58.18815331010453,0.0,75.42168674698794,75.35283993115318,0.06884681583476038,Previsions
3176,0,2019-03-12,121320,ACTIMEL NATU 4x(12x100g) FR,0,0,0,ACTIMEL,1,Rotselaar(BE),0080,0024 FR METZ (DC),2014,2905,2191,2189,2,716,714,0,891,-44.240317775571,174,272,272,272,0,0,0,0,98,-56.32183908045977,100.0,100.0,0.0,75.42168674698794,75.35283993115318,0.06884681583476038,Previsions
3177,0,2019-03-12,121320,ACTIMEL NATU 4x(12x100g) FR,0,0,0,ACTIMEL,1,Rotselaar(BE),0081,0024 FR TOURS (DC),2014,2905,2191,2189,2,716,714,0,891,-44.240317775571,267,387,205,205,0,182,182,0,120,-44.943820224719104,52.97157622739018,52.97157622739018,0.0,75.42168674698794,75.35283993115318,0.06884681583476038,Previsions
3178,0,2019-03-12,121320,ACTIMEL NATU 4x(12x100g) FR,0,0,0,ACTIMEL,1,Rotselaar(BE),0082,0024 FR VALLET (DC),2014,2905,2191,2189,2,716,714,0,891,-44.240317775571,176,162,162,162,0,0,0,0,-14,7.954545454545454,100.0,100.0,0.0,75.42168674698794,75.35283993115318,0.06884681583476038,Previsions
3179,0,2019-03-12,121320,ACTIMEL NATU 4x(12x100g) FR,0,0,0,ACTIMEL,1,Rotselaar(BE),0077,0024 FR LILPARK (DC),2014,2905,2191,2189,2,716,714,0,891,-44.240317775571,246,338,215,215,0,123,123,0,92,-37.39837398373984,63.609467455621306,63.609467455621306,0.0,75.42168674698794,75.35283993115318,0.06884681583476038,Previsions
3180,0,2019-03-12,121320,ACTIMEL NATU 4x(12x100g) FR,0,0,0,ACTIMEL,1,Rotselaar(BE),0085,0024 FR TOULOUSE (DC),2014,2905,2191,2189,2,716,714,0,891,-44.240317775571,192,273,136,136,0,137,137,0,81,-42.1875,49.81684981684982,49.81684981684982,0.0,75.42168674698794,75.35283993115318,0.06884681583476038,Previsions
3181,0,2019-03-12,121320,ACTIMEL NATU 4x(12x100g) FR,0,0,0,ACTIMEL,1,Rotselaar(BE),0083,0024 FR CHAPONNAY (DC),2014,2905,2191,2189,2,716,714,0,891,-44.240317775571,231,340,241,241,0,99,99,0,109,-47.18614718614719,70.88235294117648,70.88235294117648,0.0,75.42168674698794,75.35283993115318,0.06884681583476038,Previsions
3182,0,2019-03-12,121320,ACTIMEL NATU 4x(12x100g) FR,0,0,0,ACTIMEL,1,Rotselaar(BE),0079,0024 FR PARIS SUD (DC),2014,2905,2191,2189,2,716,714,0,891,-44.240317775571,336,538,485,483,2,55,53,0,202,-60.11904761904762,90.14869888475836,89.77695167286245,0.371747211895908,75.42168674698794,75.35283993115318,0.06884681583476038,Previsions
3183,0,2019-03-12,121320,ACTIMEL NATU 4x(12x100g) FR,0,0,0,ACTIMEL,1,Rotselaar(BE),0078,0024 FR PARIS NORD (DC),2014,2905,2191,2189,2,716,714,0,891,-44.240317775571,208,308,308,308,0,0,0,0,100,-48.07692307692308,100.0,100.0,0.0,75.42168674698794,75.35283993115318,0.06884681583476038,Previsions
3184,1,2019-03-12,135064,ACTIVIA SAV VANILLE 125X16 OD,1,0,0,ACTIVIA,0,Bailleul(FR),0084,0024 FR AIX (DC),370,1851,1684,1598,86,253,167,0,1481,-400.27027027027026,370,370,370,360,10,10,0,0,0,0.0,100.0,97.2972972972973,2.7027027027026946,90.97784981091303,86.33171258779039,4.646137223122636,A Creuser
3185,0,2019-03-12,138806,DANONE LAIT ENT AMANDE 125X4 ED,0,0,0,DANONE,0,Bailleul(FR),0084,0024 FR AIX (DC),303,502,281,274,7,228,221,0,199,-65.67656765676567,72,81,65,65,0,16,16,0,9,-12.5,80.24691358024691,80.24691358024691,0.0,55.97609561752988,54.581673306772906,1.3944223107569726,Previsions
3186,0,2019-03-12,138806,DANONE LAIT ENT AMANDE 125X4 ED,0,0,0,DANONE,0,Bailleul(FR),0080,0024 FR METZ (DC),303,502,281,274,7,228,221,0,199,-65.67656765676567,43,50,38,38,0,12,12,0,7,-16.27906976744186,76.0,76.0,0.0,55.97609561752988,54.581673306772906,1.3944223107569726,Previsions
3187,0,2019-03-12,138806,DANONE LAIT ENT AMANDE 125X4 ED,0,0,0,DANONE,0,Bailleul(FR),0081,0024 FR TOURS (DC),303,502,281,274,7,228,221,0,199,-65.67656765676567,63,118,40,40,0,78,78,0,55,-87.3015873015873,33.89830508474576,33.89830508474576,0.0,55.97609561752988,54.581673306772906,1.3944223107569726,Previsions
3188,0,2019-03-12,138806,DANONE LAIT ENT AMANDE 125X4 ED,0,0,0,DANONE,0,Bailleul(FR),0077,0024 FR LILPARK (DC),303,502,281,274,7,228,221,0,199,-65.67656765676567,25,62,25,25,0,37,37,0,37,-148.0,40.32258064516129,40.32258064516129,0.0,55.97609561752988,54.581673306772906,1.3944223107569726,Previsions
3189,0,2019-03-12,138806,DANONE LAIT ENT AMANDE 125X4 ED,0,0,0,DANONE,0,Bailleul(FR),0085,0024 FR TOULOUSE (DC),303,502,281,274,7,228,221,0,199,-65.67656765676567,58,103,78,77,1,26,25,0,45,-77.58620689655173,75.72815533980582,74.75728155339806,0.9708737864077648,55.97609561752988,54.581673306772906,1.3944223107569726,Previsions
3190,0,2019-03-12,138806,DANONE LAIT ENT AMANDE 125X4 ED,0,0,0,DANONE,0,Bailleul(FR),0083,0024 FR CHAPONNAY (DC),303,502,281,274,7,228,221,0,199,-65.67656765676567,26,65,20,18,2,47,45,0,39,-150.0,30.76923076923077,27.692307692307693,3.0769230769230766,55.97609561752988,54.581673306772906,1.3944223107569726,Previsions
3191,0,2019-03-12,138806,DANONE LAIT ENT AMANDE 125X4 ED,0,0,0,DANONE,0,Bailleul(FR),0078,0024 FR PARIS NORD (DC),303,502,281,274,7,228,221,0,199,-65.67656765676567,16,23,15,11,4,12,8,0,7,-43.75,65.21739130434783,47.82608695652174,17.391304347826086,55.97609561752988,54.581673306772906,1.3944223107569726,Previsions
3192,1,2019-03-13,113943,ACTIVIA NATURE 125X16 OD,1,0,0,ACTIVIA,0,Bailleul(FR),0083,0024 FR CHAPONNAY (DC),340,1274,1272,1187,85,87,2,0,934,-274.70588235294116,340,411,409,324,85,87,2,0,71,-20.88235294117647,99.51338199513383,78.83211678832117,20.681265206812654,99.84301412872841,93.17111459968604,6.671899529042378,Probleme Copacking
3193,0,2019-03-13,121320,ACTIMEL NATU 4x(12x100g) FR,0,0,0,ACTIMEL,1,Rotselaar(BE),0084,0024 FR AIX (DC),2052,2226,1145,927,218,1299,1081,0,174,-8.47953216374269,266,275,128,128,0,147,147,0,9,-3.3834586466165413,46.54545454545455,46.54545454545455,0.0,51.43755615453729,41.64420485175202,9.793351302785268,Previsions
3194,0,2019-03-13,121320,ACTIMEL NATU 4x(12x100g) FR,0,0,0,ACTIMEL,1,Rotselaar(BE),0080,0024 FR METZ (DC),2052,2226,1145,927,218,1299,1081,0,174,-8.47953216374269,263,337,198,197,1,140,139,0,74,-28.136882129277566,58.753709198813056,58.45697329376854,0.29673590504451397,51.43755615453729,41.64420485175202,9.793351302785268,Previsions
3195,0,2019-03-13,121320,ACTIMEL NATU 4x(12x100g) FR,0,0,0,ACTIMEL,1,Rotselaar(BE),0081,0024 FR TOURS (DC),2052,2226,1145,927,218,1299,1081,0,174,-8.47953216374269,245,258,129,129,0,129,129,0,13,-5.3061224489795915,50.0,50.0,0.0,51.43755615453729,41.64420485175202,9.793351302785268,Previsions
3196,0,2019-03-13,121320,ACTIMEL NATU 4x(12x100g) FR,0,0,0,ACTIMEL,1,Rotselaar(BE),0082,0024 FR VALLET (DC),2052,2226,1145,927,218,1299,1081,0,174,-8.47953216374269,190,170,42,42,0,128,128,0,-20,10.526315789473685,24.705882352941178,24.705882352941178,0.0,51.43755615453729,41.64420485175202,9.793351302785268,Previsions
3197,0,2019-03-13,121320,ACTIMEL NATU 4x(12x100g) FR,0,0,0,ACTIMEL,1,Rotselaar(BE),0077,0024 FR LILPARK (DC),2052,2226,1145,927,218,1299,1081,0,174,-8.47953216374269,87,117,115,115,0,2,2,0,30,-34.48275862068966,98.29059829059828,98.29059829059828,0.0,51.43755615453729,41.64420485175202,9.793351302785268,Previsions
3198,0,2019-03-13,121320,ACTIMEL NATU 4x(12x100g) FR,0,0,0,ACTIMEL,1,Rotselaar(BE),0085,0024 FR TOULOUSE (DC),2052,2226,1145,927,218,1299,1081,0,174,-8.47953216374269,329,290,115,115,0,175,175,0,-39,11.854103343465045,39.6551724137931,39.6551724137931,0.0,51.43755615453729,41.64420485175202,9.793351302785268,Previsions
3199,0,2019-03-13,121320,ACTIMEL NATU 4x(12x100g) FR,0,0,0,ACTIMEL,1,Rotselaar(BE),0083,0024 FR CHAPONNAY (DC),2052,2226,1145,927,218,1299,1081,0,174,-8.47953216374269,406,489,128,128,0,361,361,0,83,-20.44334975369458,26.1758691206544,26.1758691206544,0.0,51.43755615453729,41.64420485175202,9.793351302785268,Previsions
3200,0,2019-03-13,121320,ACTIMEL NATU 4x(12x100g) FR,0,0,0,ACTIMEL,1,Rotselaar(BE),0078,0024 FR PARIS NORD (DC),2052,2226,1145,927,218,1299,1081,0,174,-8.47953216374269,266,290,290,73,217,217,0,0,24,-9.022556390977444,100.0,25.17241379310345,74.82758620689656,51.43755615453729,41.64420485175202,9.793351302785268,Previsions
3201,0,2019-03-13,121321,ACTIMEL MULTI 3x(8x100g) FR,0,0,0,ACTIMEL,1,Rotselaar(BE),0084,0024 FR AIX (DC),2279,2708,2313,2078,235,630,395,0,429,-18.824045634050023,253,290,175,175,0,115,115,0,37,-14.624505928853756,60.3448275862069,60.3448275862069,0.0,85.4135893648449,76.73559822747416,8.67799113737074,Schéma
3202,0,2019-03-13,121321,ACTIMEL MULTI 3x(8x100g) FR,0,0,0,ACTIMEL,1,Rotselaar(BE),0080,0024 FR METZ (DC),2279,2708,2313,2078,235,630,395,0,429,-18.824045634050023,272,255,245,240,5,15,10,0,-17,6.25,96.07843137254902,94.11764705882352,1.9607843137254974,85.4135893648449,76.73559822747416,8.67799113737074,Schéma
3203,0,2019-03-13,121321,ACTIMEL MULTI 3x(8x100g) FR,0,0,0,ACTIMEL,1,Rotselaar(BE),0081,0024 FR TOURS (DC),2279,2708,2313,2078,235,630,395,0,429,-18.824045634050023,223,325,256,256,0,69,69,0,102,-45.73991031390135,78.76923076923077,78.76923076923077,0.0,85.4135893648449,76.73559822747416,8.67799113737074,Schéma
3204,0,2019-03-13,121321,ACTIMEL MULTI 3x(8x100g) FR,0,0,0,ACTIMEL,1,Rotselaar(BE),0082,0024 FR VALLET (DC),2279,2708,2313,2078,235,630,395,0,429,-18.824045634050023,232,260,260,122,138,138,0,0,28,-12.068965517241379,100.0,46.92307692307692,53.07692307692308,85.4135893648449,76.73559822747416,8.67799113737074,Schéma
3205,0,2019-03-13,121321,ACTIMEL MULTI 3x(8x100g) FR,0,0,0,ACTIMEL,1,Rotselaar(BE),0077,0024 FR LILPARK (DC),2279,2708,2313,2078,235,630,395,0,429,-18.824045634050023,99,136,98,98,0,38,38,0,37,-37.37373737373738,72.05882352941177,72.05882352941177,0.0,85.4135893648449,76.73559822747416,8.67799113737074,Schéma
3206,0,2019-03-13,121321,ACTIMEL MULTI 3x(8x100g) FR,0,0,0,ACTIMEL,1,Rotselaar(BE),0085,0024 FR TOULOUSE (DC),2279,2708,2313,2078,235,630,395,0,429,-18.824045634050023,243,219,203,111,92,108,16,0,-24,9.876543209876543,92.69406392694064,50.68493150684932,42.009132420091326,85.4135893648449,76.73559822747416,8.67799113737074,Schéma
3207,0,2019-03-13,121321,ACTIMEL MULTI 3x(8x100g) FR,0,0,0,ACTIMEL,1,Rotselaar(BE),0083,0024 FR CHAPONNAY (DC),2279,2708,2313,2078,235,630,395,0,429,-18.824045634050023,382,416,269,269,0,147,147,0,34,-8.900523560209423,64.66346153846155,64.66346153846155,0.0,85.4135893648449,76.73559822747416,8.67799113737074,Schéma
3208,0,2019-03-13,121321,ACTIMEL MULTI 3x(8x100g) FR,0,0,0,ACTIMEL,1,Rotselaar(BE),0079,0024 FR PARIS SUD (DC),2279,2708,2313,2078,235,630,395,0,429,-18.824045634050023,322,378,378,378,0,0,0,0,56,-17.391304347826086,100.0,100.0,0.0,85.4135893648449,76.73559822747416,8.67799113737074,Schéma
3209,0,2019-03-13,121321,ACTIMEL MULTI 3x(8x100g) FR,0,0,0,ACTIMEL,1,Rotselaar(BE),0078,0024 FR PARIS NORD (DC),2279,2708,2313,2078,235,630,395,0,429,-18.824045634050023,253,429,429,429,0,0,0,0,176,-69.56521739130434,100.0,100.0,0.0,85.4135893648449,76.73559822747416,8.67799113737074,Schéma
3210,1,2019-03-13,135064,ACTIVIA SAV VANILLE 125X16 OD,1,0,0,ACTIVIA,0,Bailleul(FR),0082,0024 FR VALLET (DC),41,1098,1094,1001,93,97,4,0,1057,-2578.048780487805,41,41,41,0,41,41,0,0,0,0.0,100.0,0.0,100.0,99.63570127504553,91.16575591985429,8.469945355191243,Probleme Copacking
3211,0,2019-03-13,135347,ACTIVIA NATURE 125X12 D,1,0,0,ACTIVIA,0,Bailleul(FR),0084,0024 FR AIX (DC),3844,3192,2669,2442,227,750,523,0,-652,16.96149843912591,548,528,521,521,0,7,7,0,-20,3.6496350364963503,98.67424242424242,98.67424242424242,0.0,83.61528822055138,76.50375939849624,7.111528822055135,Client
3212,0,2019-03-13,135347,ACTIVIA NATURE 125X12 D,1,0,0,ACTIVIA,0,Bailleul(FR),0080,0024 FR METZ (DC),3844,3192,2669,2442,227,750,523,0,-652,16.96149843912591,626,528,445,445,0,83,83,0,-98,15.654952076677317,84.28030303030303,84.28030303030303,0.0,83.61528822055138,76.50375939849624,7.111528822055135,Client
3213,0,2019-03-13,135347,ACTIVIA NATURE 125X12 D,1,0,0,ACTIVIA,0,Bailleul(FR),0081,0024 FR TOURS (DC),3844,3192,2669,2442,227,750,523,0,-652,16.96149843912591,559,264,162,162,0,102,102,0,-295,52.772808586762075,61.36363636363637,61.36363636363637,0.0,83.61528822055138,76.50375939849624,7.111528822055135,Client
3214,0,2019-03-13,135347,ACTIVIA NATURE 125X12 D,1,0,0,ACTIVIA,0,Bailleul(FR),0082,0024 FR VALLET (DC),3844,3192,2669,2442,227,750,523,0,-652,16.96149843912591,318,240,72,72,0,168,168,0,-78,24.528301886792452,30.0,30.0,0.0,83.61528822055138,76.50375939849624,7.111528822055135,Client
3215,0,2019-03-13,135347,ACTIVIA NATURE 125X12 D,1,0,0,ACTIVIA,0,Bailleul(FR),0077,0024 FR LILPARK (DC),3844,3192,2669,2442,227,750,523,0,-652,16.96149843912591,398,480,480,480,0,0,0,0,82,-20.603015075376884,100.0,100.0,0.0,83.61528822055138,76.50375939849624,7.111528822055135,Client
3216,0,2019-03-13,135347,ACTIVIA NATURE 125X12 D,1,0,0,ACTIVIA,0,Bailleul(FR),0085,0024 FR TOULOUSE (DC),3844,3192,2669,2442,227,750,523,0,-652,16.96149843912591,292,96,35,96,-61,0,61,0,-196,67.12328767123287,36.45833333333333,100.0,-63.54166666666667,83.61528822055138,76.50375939849624,7.111528822055135,Client
3217,0,2019-03-13,135347,ACTIVIA NATURE 125X12 D,1,0,0,ACTIVIA,0,Bailleul(FR),0083,0024 FR CHAPONNAY (DC),3844,3192,2669,2442,227,750,523,0,-652,16.96149843912591,453,432,432,144,288,288,0,0,-21,4.635761589403973,100.0,33.33333333333333,66.66666666666667,83.61528822055138,76.50375939849624,7.111528822055135,Client
3218,0,2019-03-13,135347,ACTIVIA NATURE 125X12 D,1,0,0,ACTIVIA,0,Bailleul(FR),0079,0024 FR PARIS SUD (DC),3844,3192,2669,2442,227,750,523,0,-652,16.96149843912591,40,144,144,144,0,0,0,0,104,-260.0,100.0,100.0,0.0,83.61528822055138,76.50375939849624,7.111528822055135,Client
3219,0,2019-03-13,135347,ACTIVIA NATURE 125X12 D,1,0,0,ACTIVIA,0,Bailleul(FR),0078,0024 FR PARIS NORD (DC),3844,3192,2669,2442,227,750,523,0,-652,16.96149843912591,610,480,378,378,0,102,102,0,-130,21.311475409836067,78.75,78.75,0.0,83.61528822055138,76.50375939849624,7.111528822055135,Client
3220,0,2019-03-13,135358,TAILLEFINE YELLOW FRUIT 125X8 D,0,0,0,TAILLEFINE,0,Villecomtal(FR),0080,0024 FR METZ (DC),3450,1800,680,617,63,1183,1120,0,-1650,47.82608695652174,647,540,181,181,0,359,359,0,-107,16.537867078825347,33.51851851851852,33.51851851851852,0.0,37.77777777777778,34.27777777777778,3.5,Client
3221,0,2019-03-13,135358,TAILLEFINE YELLOW FRUIT 125X8 D,0,0,0,TAILLEFINE,0,Villecomtal(FR),0081,0024 FR TOURS (DC),3450,1800,680,617,63,1183,1120,0,-1650,47.82608695652174,1302,135,7,7,0,128,128,0,-1167,89.63133640552995,5.185185185185185,5.185185185185185,0.0,37.77777777777778,34.27777777777778,3.5,Client
3222,0,2019-03-13,135358,TAILLEFINE YELLOW FRUIT 125X8 D,0,0,0,TAILLEFINE,0,Villecomtal(FR),0082,0024 FR VALLET (DC),3450,1800,680,617,63,1183,1120,0,-1650,47.82608695652174,313,225,25,0,25,225,200,0,-88,28.115015974440894,11.11111111111111,0.0,11.11111111111111,37.77777777777778,34.27777777777778,3.5,Client
3223,0,2019-03-13,135358,TAILLEFINE YELLOW FRUIT 125X8 D,0,0,0,TAILLEFINE,0,Villecomtal(FR),0077,0024 FR LILPARK (DC),3450,1800,680,617,63,1183,1120,0,-1650,47.82608695652174,568,540,429,429,0,111,111,0,-28,4.929577464788732,79.44444444444444,79.44444444444444,0.0,37.77777777777778,34.27777777777778,3.5,Client
3224,0,2019-03-13,135358,TAILLEFINE YELLOW FRUIT 125X8 D,0,0,0,TAILLEFINE,0,Villecomtal(FR),0083,0024 FR CHAPONNAY (DC),3450,1800,680,617,63,1183,1120,0,-1650,47.82608695652174,620,360,38,0,38,360,322,0,-260,41.935483870967744,10.555555555555555,0.0,10.555555555555555,37.77777777777778,34.27777777777778,3.5,Client
3225,1,2019-03-13,140278,Activia almond/muesli/chia 170g FR-copac,0,0,0,ACTIVIA,1,Roumanie(RO),0084,0024 FR AIX (DC),242,638,395,238,157,400,243,0,396,-163.63636363636363,96,63,19,2,17,61,44,0,-33,34.375,30.158730158730158,3.1746031746031744,26.984126984126984,61.91222570532915,37.30407523510972,24.608150470219428,Transport
3226,1,2019-03-13,140278,Activia almond/muesli/chia 170g FR-copac,0,0,0,ACTIVIA,1,Roumanie(RO),0081,0024 FR TOURS (DC),242,638,395,238,157,400,243,0,396,-163.63636363636363,67,53,53,15,38,38,0,0,-14,20.895522388059703,100.0,28.30188679245283,71.69811320754717,61.91222570532915,37.30407523510972,24.608150470219428,Transport
3227,1,2019-03-13,140278,Activia almond/muesli/chia 170g FR-copac,0,0,0,ACTIVIA,1,Roumanie(RO),0082,0024 FR VALLET (DC),242,638,395,238,157,400,243,0,396,-163.63636363636363,79,73,73,0,73,73,0,0,-6,7.594936708860759,100.0,0.0,100.0,61.91222570532915,37.30407523510972,24.608150470219428,Transport
3228,1,2019-03-13,140280,Activia chia/raspb/muesli 170g FR-copack,0,0,0,ACTIVIA,1,Roumanie(RO),0081,0024 FR TOURS (DC),180,723,586,363,223,360,137,0,543,-301.6666666666667,69,74,74,29,45,45,0,0,5,-7.246376811594203,100.0,39.189189189189186,60.810810810810814,81.05117565698478,50.20746887966805,30.843706777316733,Transport
3229,1,2019-03-13,140280,Activia chia/raspb/muesli 170g FR-copack,0,0,0,ACTIVIA,1,Roumanie(RO),0082,0024 FR VALLET (DC),180,723,586,363,223,360,137,0,543,-301.6666666666667,111,100,100,0,100,100,0,0,-11,9.90990990990991,100.0,0.0,100.0,81.05117565698478,50.20746887966805,30.843706777316733,Transport
3230,0,2019-03-13,145090,DANET CARAMEL 125X6 D,0,1,0,DANETTE,0,StJust(FR),0084,0024 FR AIX (DC),5184,4368,3065,3065,0,1303,1303,0,-816,15.74074074074074,738,637,429,429,0,208,208,0,-101,13.685636856368564,67.3469387755102,67.3469387755102,0.0,70.16941391941391,70.16941391941391,0.0,Client
3231,0,2019-03-13,145090,DANET CARAMEL 125X6 D,0,1,0,DANETTE,0,StJust(FR),0080,0024 FR METZ (DC),5184,4368,3065,3065,0,1303,1303,0,-816,15.74074074074074,821,546,372,372,0,174,174,0,-275,33.49573690621194,68.13186813186813,68.13186813186813,0.0,70.16941391941391,70.16941391941391,0.0,Client
3232,0,2019-03-13,145090,DANET CARAMEL 125X6 D,0,1,0,DANETTE,0,StJust(FR),0081,0024 FR TOURS (DC),5184,4368,3065,3065,0,1303,1303,0,-816,15.74074074074074,812,455,123,123,0,332,332,0,-357,43.96551724137931,27.032967032967033,27.032967032967033,0.0,70.16941391941391,70.16941391941391,0.0,Client
3233,0,2019-03-13,145090,DANET CARAMEL 125X6 D,0,1,0,DANETTE,0,StJust(FR),0082,0024 FR VALLET (DC),5184,4368,3065,3065,0,1303,1303,0,-816,15.74074074074074,298,182,16,16,0,166,166,0,-116,38.92617449664429,8.791208791208792,8.791208791208792,0.0,70.16941391941391,70.16941391941391,0.0,Client
3234,0,2019-03-13,145090,DANET CARAMEL 125X6 D,0,1,0,DANETTE,0,StJust(FR),0077,0024 FR LILPARK (DC),5184,4368,3065,3065,0,1303,1303,0,-816,15.74074074074074,518,637,526,526,0,111,111,0,119,-22.972972972972972,82.574568288854,82.574568288854,0.0,70.16941391941391,70.16941391941391,0.0,Client
3235,0,2019-03-13,145090,DANET CARAMEL 125X6 D,0,1,0,DANETTE,0,StJust(FR),0085,0024 FR TOULOUSE (DC),5184,4368,3065,3065,0,1303,1303,0,-816,15.74074074074074,485,182,182,182,0,0,0,0,-303,62.47422680412371,100.0,100.0,0.0,70.16941391941391,70.16941391941391,0.0,Client
3236,0,2019-03-13,145090,DANET CARAMEL 125X6 D,0,1,0,DANETTE,0,StJust(FR),0083,0024 FR CHAPONNAY (DC),5184,4368,3065,3065,0,1303,1303,0,-816,15.74074074074074,574,728,728,728,0,0,0,0,154,-26.829268292682926,100.0,100.0,0.0,70.16941391941391,70.16941391941391,0.0,Client
3237,0,2019-03-13,145090,DANET CARAMEL 125X6 D,0,1,0,DANETTE,0,StJust(FR),0079,0024 FR PARIS SUD (DC),5184,4368,3065,3065,0,1303,1303,0,-816,15.74074074074074,178,364,52,52,0,312,312,0,186,-104.49438202247191,14.285714285714285,14.285714285714285,0.0,70.16941391941391,70.16941391941391,0.0,Client
3238,0,2019-03-13,145090,DANET CARAMEL 125X6 D,0,1,0,DANETTE,0,StJust(FR),0078,0024 FR PARIS NORD (DC),5184,4368,3065,3065,0,1303,1303,0,-816,15.74074074074074,760,637,637,637,0,0,0,0,-123,16.18421052631579,100.0,100.0,0.0,70.16941391941391,70.16941391941391,0.0,Client
3239,0,2019-03-14,433,DANET MOUS CHOC LIEG 80gx4,1,0,0,DANETTE,1,Ochsenfurt(ALL),0084,0024 FR AIX (DC),1122,1138,1080,980,100,158,58,0,16,-1.4260249554367201,164,158,158,156,2,2,0,0,-6,3.658536585365854,100.0,98.73417721518987,1.2658227848101262,94.90333919156416,86.11599297012302,8.78734622144114,Client
3240,0,2019-03-14,433,DANET MOUS CHOC LIEG 80gx4,1,0,0,DANETTE,1,Ochsenfurt(ALL),0080,0024 FR METZ (DC),1122,1138,1080,980,100,158,58,0,16,-1.4260249554367201,165,167,167,140,27,27,0,0,2,-1.2121212121212122,100.0,83.8323353293413,16.167664670658695,94.90333919156416,86.11599297012302,8.78734622144114,Client
3241,0,2019-03-14,433,DANET MOUS CHOC LIEG 80gx4,1,0,0,DANETTE,1,Ochsenfurt(ALL),0081,0024 FR TOURS (DC),1122,1138,1080,980,100,158,58,0,16,-1.4260249554367201,232,231,231,231,0,0,0,0,-1,0.43103448275862066,100.0,100.0,0.0,94.90333919156416,86.11599297012302,8.78734622144114,Client
3242,0,2019-03-14,433,DANET MOUS CHOC LIEG 80gx4,1,0,0,DANETTE,1,Ochsenfurt(ALL),0082,0024 FR VALLET (DC),1122,1138,1080,980,100,158,58,0,16,-1.4260249554367201,29,25,25,25,0,0,0,0,-4,13.793103448275861,100.0,100.0,0.0,94.90333919156416,86.11599297012302,8.78734622144114,Client
3243,0,2019-03-14,433,DANET MOUS CHOC LIEG 80gx4,1,0,0,DANETTE,1,Ochsenfurt(ALL),0077,0024 FR LILPARK (DC),1122,1138,1080,980,100,158,58,0,16,-1.4260249554367201,119,118,60,0,60,118,58,0,-1,0.8403361344537815,50.847457627118644,0.0,50.847457627118644,94.90333919156416,86.11599297012302,8.78734622144114,Client
3244,0,2019-03-14,433,DANET MOUS CHOC LIEG 80gx4,1,0,0,DANETTE,1,Ochsenfurt(ALL),0085,0024 FR TOULOUSE (DC),1122,1138,1080,980,100,158,58,0,16,-1.4260249554367201,137,133,133,133,0,0,0,0,-4,2.9197080291970803,100.0,100.0,0.0,94.90333919156416,86.11599297012302,8.78734622144114,Client
3245,0,2019-03-14,433,DANET MOUS CHOC LIEG 80gx4,1,0,0,DANETTE,1,Ochsenfurt(ALL),0083,0024 FR CHAPONNAY (DC),1122,1138,1080,980,100,158,58,0,16,-1.4260249554367201,159,174,174,174,0,0,0,0,15,-9.433962264150944,100.0,100.0,0.0,94.90333919156416,86.11599297012302,8.78734622144114,Client
3246,0,2019-03-14,433,DANET MOUS CHOC LIEG 80gx4,1,0,0,DANETTE,1,Ochsenfurt(ALL),0079,0024 FR PARIS SUD (DC),1122,1138,1080,980,100,158,58,0,16,-1.4260249554367201,63,84,84,84,0,0,0,0,21,-33.333333333333336,100.0,100.0,0.0,94.90333919156416,86.11599297012302,8.78734622144114,Client
3247,0,2019-03-14,433,DANET MOUS CHOC LIEG 80gx4,1,0,0,DANETTE,1,Ochsenfurt(ALL),0078,0024 FR PARIS NORD (DC),1122,1138,1080,980,100,158,58,0,16,-1.4260249554367201,54,48,48,37,11,11,0,0,-6,11.11111111111111,100.0,77.08333333333334,22.916666666666657,94.90333919156416,86.11599297012302,8.78734622144114,Client
3248,0,2019-03-14,105287,DANET MOUS CHOC LIEG 80gx4 Lidl,0,0,0,DANETTE,1,Ochsenfurt(ALL),0084,0024 FR AIX (DC),2861,2464,2204,1729,475,735,260,0,-397,13.87626703949668,388,120,120,120,0,0,0,0,-268,69.0721649484536,100.0,100.0,0.0,89.44805194805194,70.17045454545455,19.277597402597394,Client
3249,0,2019-03-14,105287,DANET MOUS CHOC LIEG 80gx4 Lidl,0,0,0,DANETTE,1,Ochsenfurt(ALL),0080,0024 FR METZ (DC),2861,2464,2204,1729,475,735,260,0,-397,13.87626703949668,438,360,360,360,0,0,0,0,-78,17.80821917808219,100.0,100.0,0.0,89.44805194805194,70.17045454545455,19.277597402597394,Client
3250,0,2019-03-14,105287,DANET MOUS CHOC LIEG 80gx4 Lidl,0,0,0,DANETTE,1,Ochsenfurt(ALL),0082,0024 FR VALLET (DC),2861,2464,2204,1729,475,735,260,0,-397,13.87626703949668,197,240,240,240,0,0,0,0,43,-21.82741116751269,100.0,100.0,0.0,89.44805194805194,70.17045454545455,19.277597402597394,Client
3251,0,2019-03-14,105287,DANET MOUS CHOC LIEG 80gx4 Lidl,0,0,0,DANETTE,1,Ochsenfurt(ALL),0077,0024 FR LILPARK (DC),2861,2464,2204,1729,475,735,260,0,-397,13.87626703949668,435,240,140,140,0,100,100,0,-195,44.827586206896555,58.333333333333336,58.333333333333336,0.0,89.44805194805194,70.17045454545455,19.277597402597394,Client
3252,0,2019-03-14,105287,DANET MOUS CHOC LIEG 80gx4 Lidl,0,0,0,DANETTE,1,Ochsenfurt(ALL),0085,0024 FR TOULOUSE (DC),2861,2464,2204,1729,475,735,260,0,-397,13.87626703949668,365,480,480,480,0,0,0,0,115,-31.506849315068493,100.0,100.0,0.0,89.44805194805194,70.17045454545455,19.277597402597394,Client
3253,0,2019-03-14,105287,DANET MOUS CHOC LIEG 80gx4 Lidl,0,0,0,DANETTE,1,Ochsenfurt(ALL),0083,0024 FR CHAPONNAY (DC),2861,2464,2204,1729,475,735,260,0,-397,13.87626703949668,411,240,240,240,0,0,0,0,-171,41.605839416058394,100.0,100.0,0.0,89.44805194805194,70.17045454545455,19.277597402597394,Client
3254,0,2019-03-14,105287,DANET MOUS CHOC LIEG 80gx4 Lidl,0,0,0,DANETTE,1,Ochsenfurt(ALL),0079,0024 FR PARIS SUD (DC),2861,2464,2204,1729,475,735,260,0,-397,13.87626703949668,242,544,475,0,475,544,69,0,302,-124.79338842975207,87.31617647058823,0.0,87.31617647058823,89.44805194805194,70.17045454545455,19.277597402597394,Client
3255,0,2019-03-14,105287,DANET MOUS CHOC LIEG 80gx4 Lidl,0,0,0,DANETTE,1,Ochsenfurt(ALL),0078,0024 FR PARIS NORD (DC),2861,2464,2204,1729,475,735,260,0,-397,13.87626703949668,385,240,149,149,0,91,91,0,-145,37.66233766233766,62.083333333333336,62.083333333333336,0.0,89.44805194805194,70.17045454545455,19.277597402597394,Client
3256,0,2019-03-14,120836,DANONE ARO PANACHE 125X4 AFH,0,0,1,DANONE,0,Bailleul(FR),0084,0024 FR AIX (DC),3437,5170,4607,4605,2,565,563,0,1733,-50.4218795461158,660,431,431,431,0,0,0,0,-229,34.696969696969695,100.0,100.0,0.0,89.11025145067698,89.07156673114119,0.03868471953579444,Client
3257,0,2019-03-14,120836,DANONE ARO PANACHE 125X4 AFH,0,0,1,DANONE,0,Bailleul(FR),0080,0024 FR METZ (DC),3437,5170,4607,4605,2,565,563,0,1733,-50.4218795461158,242,229,229,229,0,0,0,0,-13,5.371900826446281,100.0,100.0,0.0,89.11025145067698,89.07156673114119,0.03868471953579444,Client
3258,0,2019-03-14,120836,DANONE ARO PANACHE 125X4 AFH,0,0,1,DANONE,0,Bailleul(FR),0081,0024 FR TOURS (DC),3437,5170,4607,4605,2,565,563,0,1733,-50.4218795461158,280,469,469,469,0,0,0,0,189,-67.5,100.0,100.0,0.0,89.11025145067698,89.07156673114119,0.03868471953579444,Client
3259,0,2019-03-14,120836,DANONE ARO PANACHE 125X4 AFH,0,0,1,DANONE,0,Bailleul(FR),0082,0024 FR VALLET (DC),3437,5170,4607,4605,2,565,563,0,1733,-50.4218795461158,331,387,387,387,0,0,0,0,56,-16.91842900302115,100.0,100.0,0.0,89.11025145067698,89.07156673114119,0.03868471953579444,Client
3260,0,2019-03-14,120836,DANONE ARO PANACHE 125X4 AFH,0,0,1,DANONE,0,Bailleul(FR),0077,0024 FR LILPARK (DC),3437,5170,4607,4605,2,565,563,0,1733,-50.4218795461158,407,468,468,468,0,0,0,0,61,-14.987714987714988,100.0,100.0,0.0,89.11025145067698,89.07156673114119,0.03868471953579444,Client
3261,0,2019-03-14,120836,DANONE ARO PANACHE 125X4 AFH,0,0,1,DANONE,0,Bailleul(FR),0085,0024 FR TOULOUSE (DC),3437,5170,4607,4605,2,565,563,0,1733,-50.4218795461158,555,864,864,864,0,0,0,0,309,-55.67567567567568,100.0,100.0,0.0,89.11025145067698,89.07156673114119,0.03868471953579444,Client
3262,0,2019-03-14,120836,DANONE ARO PANACHE 125X4 AFH,0,0,1,DANONE,0,Bailleul(FR),0083,0024 FR CHAPONNAY (DC),3437,5170,4607,4605,2,565,563,0,1733,-50.4218795461158,479,1431,868,866,2,565,563,0,952,-198.7473903966597,60.65688329839273,60.51712089447938,0.1397624039133447,89.11025145067698,89.07156673114119,0.03868471953579444,Client
3263,0,2019-03-14,120836,DANONE ARO PANACHE 125X4 AFH,0,0,1,DANONE,0,Bailleul(FR),0079,0024 FR PARIS SUD (DC),3437,5170,4607,4605,2,565,563,0,1733,-50.4218795461158,136,549,549,549,0,0,0,0,413,-303.6764705882353,100.0,100.0,0.0,89.11025145067698,89.07156673114119,0.03868471953579444,Client
3264,0,2019-03-14,120836,DANONE ARO PANACHE 125X4 AFH,0,0,1,DANONE,0,Bailleul(FR),0078,0024 FR PARIS NORD (DC),3437,5170,4607,4605,2,565,563,0,1733,-50.4218795461158,347,342,342,342,0,0,0,0,-5,1.440922190201729,100.0,100.0,0.0,89.11025145067698,89.07156673114119,0.03868471953579444,Client
3265,0,2019-03-14,121320,ACTIMEL NATU 4x(12x100g) FR,0,0,0,ACTIMEL,1,Rotselaar(BE),0084,0024 FR AIX (DC),2655,3356,2965,2083,882,1273,391,0,701,-26.4030131826742,260,375,375,128,247,247,0,0,115,-44.23076923076923,100.0,34.13333333333333,65.86666666666667,88.3492252681764,62.06793802145412,26.28128724672228,Previsions
3266,0,2019-03-14,121320,ACTIMEL NATU 4x(12x100g) FR,0,0,0,ACTIMEL,1,Rotselaar(BE),0080,0024 FR METZ (DC),2655,3356,2965,2083,882,1273,391,0,701,-26.4030131826742,224,251,164,84,80,167,87,0,27,-12.053571428571429,65.33864541832669,33.46613545816733,31.872509960159363,88.3492252681764,62.06793802145412,26.28128724672228,Previsions
3267,0,2019-03-14,121320,ACTIMEL NATU 4x(12x100g) FR,0,0,0,ACTIMEL,1,Rotselaar(BE),0081,0024 FR TOURS (DC),2655,3356,2965,2083,882,1273,391,0,701,-26.4030131826742,299,356,356,255,101,101,0,0,57,-19.06354515050167,100.0,71.62921348314607,28.370786516853926,88.3492252681764,62.06793802145412,26.28128724672228,Previsions
3268,0,2019-03-14,121320,ACTIMEL NATU 4x(12x100g) FR,0,0,0,ACTIMEL,1,Rotselaar(BE),0082,0024 FR VALLET (DC),2655,3356,2965,2083,882,1273,391,0,701,-26.4030131826742,180,153,115,115,0,38,38,0,-27,15.0,75.16339869281046,75.16339869281046,0.0,88.3492252681764,62.06793802145412,26.28128724672228,Previsions
3269,0,2019-03-14,121320,ACTIMEL NATU 4x(12x100g) FR,0,0,0,ACTIMEL,1,Rotselaar(BE),0077,0024 FR LILPARK (DC),2655,3356,2965,2083,882,1273,391,0,701,-26.4030131826742,287,368,303,266,37,102,65,0,81,-28.222996515679444,82.33695652173914,72.28260869565217,10.054347826086968,88.3492252681764,62.06793802145412,26.28128724672228,Previsions
3270,0,2019-03-14,121320,ACTIMEL NATU 4x(12x100g) FR,0,0,0,ACTIMEL,1,Rotselaar(BE),0085,0024 FR TOULOUSE (DC),2655,3356,2965,2083,882,1273,391,0,701,-26.4030131826742,321,458,458,67,391,391,0,0,137,-42.679127725856695,100.0,14.628820960698691,85.37117903930131,88.3492252681764,62.06793802145412,26.28128724672228,Previsions
3271,0,2019-03-14,121320,ACTIMEL NATU 4x(12x100g) FR,0,0,0,ACTIMEL,1,Rotselaar(BE),0083,0024 FR CHAPONNAY (DC),2655,3356,2965,2083,882,1273,391,0,701,-26.4030131826742,378,457,256,256,0,201,201,0,79,-20.8994708994709,56.01750547045952,56.01750547045952,0.0,88.3492252681764,62.06793802145412,26.28128724672228,Previsions
3272,0,2019-03-14,121320,ACTIMEL NATU 4x(12x100g) FR,0,0,0,ACTIMEL,1,Rotselaar(BE),0079,0024 FR PARIS SUD (DC),2655,3356,2965,2083,882,1273,391,0,701,-26.4030131826742,459,628,628,628,0,0,0,0,169,-36.81917211328976,100.0,100.0,0.0,88.3492252681764,62.06793802145412,26.28128724672228,Previsions
3273,0,2019-03-14,121320,ACTIMEL NATU 4x(12x100g) FR,0,0,0,ACTIMEL,1,Rotselaar(BE),0078,0024 FR PARIS NORD (DC),2655,3356,2965,2083,882,1273,391,0,701,-26.4030131826742,247,310,310,284,26,26,0,0,63,-25.506072874493928,100.0,91.61290322580645,8.387096774193552,88.3492252681764,62.06793802145412,26.28128724672228,Previsions
3274,1,2019-03-14,121321,ACTIMEL MULTI 3x(8x100g) FR,0,0,0,ACTIMEL,1,Aldaya(ES),0084,0024 FR AIX (DC),2990,3055,1965,936,1029,2119,1090,0,65,-2.1739130434782608,227,355,355,18,337,337,0,0,128,-56.38766519823788,100.0,5.070422535211268,94.92957746478874,64.32078559738135,30.638297872340424,33.68248772504092,Schéma
3275,0,2019-03-14,121321,ACTIMEL MULTI 3x(8x100g) FR,0,0,0,ACTIMEL,1,Rotselaar(BE),0084,0024 FR AIX (DC),2990,3055,1965,936,1029,2119,1090,0,65,-2.1739130434782608,227,355,355,18,337,337,0,0,128,-56.38766519823788,100.0,5.070422535211268,94.92957746478874,64.32078559738135,30.638297872340424,33.68248772504092,Schéma
3276,0,2019-03-14,121321,ACTIMEL MULTI 3x(8x100g) FR,0,0,0,ACTIMEL,1,Rotselaar(BE),0080,0024 FR METZ (DC),2990,3055,1965,936,1029,2119,1090,0,65,-2.1739130434782608,215,244,16,16,0,228,228,0,29,-13.488372093023257,6.557377049180328,6.557377049180328,0.0,64.32078559738135,30.638297872340424,33.68248772504092,Schéma
3277,0,2019-03-14,121321,ACTIMEL MULTI 3x(8x100g) FR,0,0,0,ACTIMEL,1,Rotselaar(BE),0081,0024 FR TOURS (DC),2990,3055,1965,936,1029,2119,1090,0,65,-2.1739130434782608,317,428,428,2,426,426,0,0,111,-35.01577287066246,100.0,0.46728971962616817,99.53271028037383,64.32078559738135,30.638297872340424,33.68248772504092,Schéma
3278,0,2019-03-14,121321,ACTIMEL MULTI 3x(8x100g) FR,0,0,0,ACTIMEL,1,Rotselaar(BE),0082,0024 FR VALLET (DC),2990,3055,1965,936,1029,2119,1090,0,65,-2.1739130434782608,176,133,57,0,57,133,76,0,-43,24.431818181818183,42.857142857142854,0.0,42.857142857142854,64.32078559738135,30.638297872340424,33.68248772504092,Schéma
3279,0,2019-03-14,121321,ACTIMEL MULTI 3x(8x100g) FR,0,0,0,ACTIMEL,1,Rotselaar(BE),0077,0024 FR LILPARK (DC),2990,3055,1965,936,1029,2119,1090,0,65,-2.1739130434782608,310,382,1,1,0,381,381,0,72,-23.225806451612904,0.2617801047120419,0.2617801047120419,0.0,64.32078559738135,30.638297872340424,33.68248772504092,Schéma
3280,0,2019-03-14,121321,ACTIMEL MULTI 3x(8x100g) FR,0,0,0,ACTIMEL,1,Rotselaar(BE),0085,0024 FR TOULOUSE (DC),2990,3055,1965,936,1029,2119,1090,0,65,-2.1739130434782608,274,247,247,38,209,209,0,0,-27,9.854014598540147,100.0,15.384615384615385,84.61538461538461,64.32078559738135,30.638297872340424,33.68248772504092,Schéma
3281,0,2019-03-14,121321,ACTIMEL MULTI 3x(8x100g) FR,0,0,0,ACTIMEL,1,Rotselaar(BE),0083,0024 FR CHAPONNAY (DC),2990,3055,1965,936,1029,2119,1090,0,65,-2.1739130434782608,392,412,7,7,0,405,405,0,20,-5.1020408163265305,1.6990291262135921,1.6990291262135921,0.0,64.32078559738135,30.638297872340424,33.68248772504092,Schéma
3282,0,2019-03-14,121321,ACTIMEL MULTI 3x(8x100g) FR,0,0,0,ACTIMEL,1,Rotselaar(BE),0079,0024 FR PARIS SUD (DC),2990,3055,1965,936,1029,2119,1090,0,65,-2.1739130434782608,536,590,590,590,0,0,0,0,54,-10.074626865671641,100.0,100.0,0.0,64.32078559738135,30.638297872340424,33.68248772504092,Schéma
3283,0,2019-03-14,121321,ACTIMEL MULTI 3x(8x100g) FR,0,0,0,ACTIMEL,1,Rotselaar(BE),0078,0024 FR PARIS NORD (DC),2990,3055,1965,936,1029,2119,1090,0,65,-2.1739130434782608,316,264,264,264,0,0,0,0,-52,16.455696202531644,100.0,100.0,0.0,64.32078559738135,30.638297872340424,33.68248772504092,Schéma
3284,0,2019-03-14,135119,ACTIVIA SAV CITRON 125X16 OD,0,0,0,ACTIVIA,0,Bailleul(FR),0084,0024 FR AIX (DC),515,427,339,339,0,88,88,0,-88,17.0873786407767,96,112,86,86,0,26,26,0,16,-16.666666666666668,76.78571428571429,76.78571428571429,0.0,79.39110070257611,79.39110070257611,0.0,A Creuser
3285,0,2019-03-14,135119,ACTIVIA SAV CITRON 125X16 OD,0,0,0,ACTIVIA,0,Bailleul(FR),0081,0024 FR TOURS (DC),515,427,339,339,0,88,88,0,-88,17.0873786407767,155,29,29,29,0,0,0,0,-126,81.29032258064517,100.0,100.0,0.0,79.39110070257611,79.39110070257611,0.0,A Creuser
3286,0,2019-03-14,135119,ACTIVIA SAV CITRON 125X16 OD,0,0,0,ACTIVIA,0,Bailleul(FR),0082,0024 FR VALLET (DC),515,427,339,339,0,88,88,0,-88,17.0873786407767,42,67,67,67,0,0,0,0,25,-59.523809523809526,100.0,100.0,0.0,79.39110070257611,79.39110070257611,0.0,A Creuser
3287,0,2019-03-14,135119,ACTIVIA SAV CITRON 125X16 OD,0,0,0,ACTIVIA,0,Bailleul(FR),0077,0024 FR LILPARK (DC),515,427,339,339,0,88,88,0,-88,17.0873786407767,37,27,27,27,0,0,0,0,-10,27.027027027027028,100.0,100.0,0.0,79.39110070257611,79.39110070257611,0.0,A Creuser
3288,0,2019-03-14,135119,ACTIVIA SAV CITRON 125X16 OD,0,0,0,ACTIVIA,0,Bailleul(FR),0085,0024 FR TOULOUSE (DC),515,427,339,339,0,88,88,0,-88,17.0873786407767,85,44,37,37,0,7,7,0,-41,48.23529411764706,84.0909090909091,84.0909090909091,0.0,79.39110070257611,79.39110070257611,0.0,A Creuser
3289,0,2019-03-14,135119,ACTIVIA SAV CITRON 125X16 OD,0,0,0,ACTIVIA,0,Bailleul(FR),0083,0024 FR CHAPONNAY (DC),515,427,339,339,0,88,88,0,-88,17.0873786407767,45,82,39,39,0,43,43,0,37,-82.22222222222223,47.5609756097561,47.5609756097561,0.0,79.39110070257611,79.39110070257611,0.0,A Creuser
3290,0,2019-03-14,135119,ACTIVIA SAV CITRON 125X16 OD,0,0,0,ACTIVIA,0,Bailleul(FR),0078,0024 FR PARIS NORD (DC),515,427,339,339,0,88,88,0,-88,17.0873786407767,55,66,54,54,0,12,12,0,11,-20.0,81.81818181818183,81.81818181818183,0.0,79.39110070257611,79.39110070257611,0.0,A Creuser
3291,0,2019-03-14,145080,DANET CHOCOLAT 125GX6 D,0,1,0,DANETTE,0,StJust(FR),0084,0024 FR AIX (DC),5009,5096,4902,4408,494,688,194,0,87,-1.736873627470553,622,182,182,182,0,0,0,0,-440,70.73954983922829,100.0,100.0,0.0,96.19309262166405,86.49921507064364,9.693877551020407,Client
3292,0,2019-03-14,145080,DANET CHOCOLAT 125GX6 D,0,1,0,DANETTE,0,StJust(FR),0080,0024 FR METZ (DC),5009,5096,4902,4408,494,688,194,0,87,-1.736873627470553,575,728,549,549,0,179,179,0,153,-26.608695652173914,75.41208791208791,75.41208791208791,0.0,96.19309262166405,86.49921507064364,9.693877551020407,Client
3293,0,2019-03-14,145080,DANET CHOCOLAT 125GX6 D,0,1,0,DANETTE,0,StJust(FR),0081,0024 FR TOURS (DC),5009,5096,4902,4408,494,688,194,0,87,-1.736873627470553,332,182,182,182,0,0,0,0,-150,45.18072289156626,100.0,100.0,0.0,96.19309262166405,86.49921507064364,9.693877551020407,Client
3294,0,2019-03-14,145080,DANET CHOCOLAT 125GX6 D,0,1,0,DANETTE,0,StJust(FR),0082,0024 FR VALLET (DC),5009,5096,4902,4408,494,688,194,0,87,-1.736873627470553,356,364,364,364,0,0,0,0,8,-2.247191011235955,100.0,100.0,0.0,96.19309262166405,86.49921507064364,9.693877551020407,Client
3295,0,2019-03-14,145080,DANET CHOCOLAT 125GX6 D,0,1,0,DANETTE,0,StJust(FR),0077,0024 FR LILPARK (DC),5009,5096,4902,4408,494,688,194,0,87,-1.736873627470553,637,364,364,364,0,0,0,0,-273,42.857142857142854,100.0,100.0,0.0,96.19309262166405,86.49921507064364,9.693877551020407,Client
3296,0,2019-03-14,145080,DANET CHOCOLAT 125GX6 D,0,1,0,DANETTE,0,StJust(FR),0085,0024 FR TOULOUSE (DC),5009,5096,4902,4408,494,688,194,0,87,-1.736873627470553,676,910,910,910,0,0,0,0,234,-34.61538461538461,100.0,100.0,0.0,96.19309262166405,86.49921507064364,9.693877551020407,Client
3297,0,2019-03-14,145080,DANET CHOCOLAT 125GX6 D,0,1,0,DANETTE,0,StJust(FR),0083,0024 FR CHAPONNAY (DC),5009,5096,4902,4408,494,688,194,0,87,-1.736873627470553,746,546,546,546,0,0,0,0,-200,26.80965147453083,100.0,100.0,0.0,96.19309262166405,86.49921507064364,9.693877551020407,Client
3298,0,2019-03-14,145080,DANET CHOCOLAT 125GX6 D,0,1,0,DANETTE,0,StJust(FR),0079,0024 FR PARIS SUD (DC),5009,5096,4902,4408,494,688,194,0,87,-1.736873627470553,252,910,910,416,494,494,0,0,658,-261.1111111111111,100.0,45.714285714285715,54.285714285714285,96.19309262166405,86.49921507064364,9.693877551020407,Client
3299,0,2019-03-14,145080,DANET CHOCOLAT 125GX6 D,0,1,0,DANETTE,0,StJust(FR),0078,0024 FR PARIS NORD (DC),5009,5096,4902,4408,494,688,194,0,87,-1.736873627470553,813,910,895,895,0,15,15,0,97,-11.931119311193111,98.35164835164835,98.35164835164835,0.0,96.19309262166405,86.49921507064364,9.693877551020407,Client
3300,0,2019-03-14,145090,DANET CARAMEL 125X6 D,0,1,0,DANETTE,0,StJust(FR),0084,0024 FR AIX (DC),2308,2548,2093,1729,364,819,455,0,240,-10.398613518197573,404,182,77,77,0,105,105,0,-222,54.95049504950495,42.30769230769231,42.30769230769231,0.0,82.14285714285714,67.85714285714286,14.285714285714278,Client
3301,0,2019-03-14,145090,DANET CARAMEL 125X6 D,0,1,0,DANETTE,0,StJust(FR),0080,0024 FR METZ (DC),2308,2548,2093,1729,364,819,455,0,240,-10.398613518197573,274,455,304,304,0,151,151,0,181,-66.05839416058394,66.8131868131868,66.8131868131868,0.0,82.14285714285714,67.85714285714286,14.285714285714278,Client
3302,0,2019-03-14,145090,DANET CARAMEL 125X6 D,0,1,0,DANETTE,0,StJust(FR),0081,0024 FR TOURS (DC),2308,2548,2093,1729,364,819,455,0,240,-10.398613518197573,180,91,87,87,0,4,4,0,-89,49.44444444444444,95.6043956043956,95.6043956043956,0.0,82.14285714285714,67.85714285714286,14.285714285714278,Client
3303,0,2019-03-14,145090,DANET CARAMEL 125X6 D,0,1,0,DANETTE,0,StJust(FR),0082,0024 FR VALLET (DC),2308,2548,2093,1729,364,819,455,0,240,-10.398613518197573,106,273,257,231,26,42,16,0,167,-157.54716981132074,94.13919413919413,84.61538461538461,9.523809523809518,82.14285714285714,67.85714285714286,14.285714285714278,Client
3304,0,2019-03-14,145090,DANET CARAMEL 125X6 D,0,1,0,DANETTE,0,StJust(FR),0077,0024 FR LILPARK (DC),2308,2548,2093,1729,364,819,455,0,240,-10.398613518197573,318,182,74,74,0,108,108,0,-136,42.76729559748428,40.65934065934066,40.65934065934066,0.0,82.14285714285714,67.85714285714286,14.285714285714278,Client
3305,0,2019-03-14,145090,DANET CARAMEL 125X6 D,0,1,0,DANETTE,0,StJust(FR),0085,0024 FR TOULOUSE (DC),2308,2548,2093,1729,364,819,455,0,240,-10.398613518197573,444,546,475,475,0,71,71,0,102,-22.972972972972972,86.99633699633699,86.99633699633699,0.0,82.14285714285714,67.85714285714286,14.285714285714278,Client
3306,0,2019-03-14,145090,DANET CARAMEL 125X6 D,0,1,0,DANETTE,0,StJust(FR),0079,0024 FR PARIS SUD (DC),2308,2548,2093,1729,364,819,455,0,240,-10.398613518197573,125,364,364,26,338,338,0,0,239,-191.2,100.0,7.142857142857142,92.85714285714286,82.14285714285714,67.85714285714286,14.285714285714278,Client
3307,0,2019-03-14,145090,DANET CARAMEL 125X6 D,0,1,0,DANETTE,0,StJust(FR),0078,0024 FR PARIS NORD (DC),2308,2548,2093,1729,364,819,455,0,240,-10.398613518197573,457,455,455,455,0,0,0,0,-2,0.437636761487965,100.0,100.0,0.0,82.14285714285714,67.85714285714286,14.285714285714278,Client
3308,0,2019-03-15,83923,ACTIMEL NATU 3x(14x100g) FR,0,0,0,ACTIMEL,1,Rotselaar(BE),0084,0024 FR AIX (DC),2593,2864,2454,2454,0,410,410,0,271,-10.451214809101426,137,136,136,136,0,0,0,0,-1,0.7299270072992701,100.0,100.0,0.0,85.68435754189943,85.68435754189943,0.0,Client
3309,0,2019-03-15,83923,ACTIMEL NATU 3x(14x100g) FR,0,0,0,ACTIMEL,1,Rotselaar(BE),0081,0024 FR TOURS (DC),2593,2864,2454,2454,0,410,410,0,271,-10.451214809101426,55,52,28,28,0,24,24,0,-3,5.454545454545454,53.84615384615385,53.84615384615385,0.0,85.68435754189943,85.68435754189943,0.0,Client
3310,0,2019-03-15,83923,ACTIMEL NATU 3x(14x100g) FR,0,0,0,ACTIMEL,1,Rotselaar(BE),0082,0024 FR VALLET (DC),2593,2864,2454,2454,0,410,410,0,271,-10.451214809101426,152,121,121,121,0,0,0,0,-31,20.394736842105264,100.0,100.0,0.0,85.68435754189943,85.68435754189943,0.0,Client
3311,0,2019-03-15,83923,ACTIMEL NATU 3x(14x100g) FR,0,0,0,ACTIMEL,1,Rotselaar(BE),0077,0024 FR LILPARK (DC),2593,2864,2454,2454,0,410,410,0,271,-10.451214809101426,203,226,226,226,0,0,0,0,23,-11.330049261083744,100.0,100.0,0.0,85.68435754189943,85.68435754189943,0.0,Client
3312,0,2019-03-15,83923,ACTIMEL NATU 3x(14x100g) FR,0,0,0,ACTIMEL,1,Rotselaar(BE),0085,0024 FR TOULOUSE (DC),2593,2864,2454,2454,0,410,410,0,271,-10.451214809101426,235,237,237,237,0,0,0,0,2,-0.851063829787234,100.0,100.0,0.0,85.68435754189943,85.68435754189943,0.0,Client
3313,0,2019-03-15,83923,ACTIMEL NATU 3x(14x100g) FR,0,0,0,ACTIMEL,1,Rotselaar(BE),0083,0024 FR CHAPONNAY (DC),2593,2864,2454,2454,0,410,410,0,271,-10.451214809101426,502,613,557,557,0,56,56,0,111,-22.111553784860558,90.86460032626428,90.86460032626428,0.0,85.68435754189943,85.68435754189943,0.0,Client
3314,0,2019-03-15,83923,ACTIMEL NATU 3x(14x100g) FR,0,0,0,ACTIMEL,1,Rotselaar(BE),0079,0024 FR PARIS SUD (DC),2593,2864,2454,2454,0,410,410,0,271,-10.451214809101426,437,571,241,241,0,330,330,0,134,-30.663615560640732,42.20665499124343,42.20665499124343,0.0,85.68435754189943,85.68435754189943,0.0,Client
3315,0,2019-03-15,83923,ACTIMEL NATU 3x(14x100g) FR,0,0,0,ACTIMEL,1,Rotselaar(BE),0078,0024 FR PARIS NORD (DC),2593,2864,2454,2454,0,410,410,0,271,-10.451214809101426,872,908,908,908,0,0,0,0,36,-4.128440366972477,100.0,100.0,0.0,85.68435754189943,85.68435754189943,0.0,Client
3316,0,2019-03-15,83924,ACTIMEL STRA 3x(14x100g) FR,0,0,0,ACTIMEL,1,Rotselaar(BE),0084,0024 FR AIX (DC),4183,4544,4008,4008,0,536,536,0,361,-8.63016973464021,201,201,201,201,0,0,0,0,0,0.0,100.0,100.0,0.0,88.20422535211267,88.20422535211267,0.0,Client
3317,0,2019-03-15,83924,ACTIMEL STRA 3x(14x100g) FR,0,0,0,ACTIMEL,1,Rotselaar(BE),0081,0024 FR TOURS (DC),4183,4544,4008,4008,0,536,536,0,361,-8.63016973464021,81,80,80,80,0,0,0,0,-1,1.2345679012345678,100.0,100.0,0.0,88.20422535211267,88.20422535211267,0.0,Client
3318,0,2019-03-15,83924,ACTIMEL STRA 3x(14x100g) FR,0,0,0,ACTIMEL,1,Rotselaar(BE),0082,0024 FR VALLET (DC),4183,4544,4008,4008,0,536,536,0,361,-8.63016973464021,214,180,180,180,0,0,0,0,-34,15.88785046728972,100.0,100.0,0.0,88.20422535211267,88.20422535211267,0.0,Client
3319,0,2019-03-15,83924,ACTIMEL STRA 3x(14x100g) FR,0,0,0,ACTIMEL,1,Rotselaar(BE),0077,0024 FR LILPARK (DC),4183,4544,4008,4008,0,536,536,0,361,-8.63016973464021,322,323,323,323,0,0,0,0,1,-0.3105590062111801,100.0,100.0,0.0,88.20422535211267,88.20422535211267,0.0,Client
3320,0,2019-03-15,83924,ACTIMEL STRA 3x(14x100g) FR,0,0,0,ACTIMEL,1,Rotselaar(BE),0085,0024 FR TOULOUSE (DC),4183,4544,4008,4008,0,536,536,0,361,-8.63016973464021,377,382,382,382,0,0,0,0,5,-1.3262599469496021,100.0,100.0,0.0,88.20422535211267,88.20422535211267,0.0,Client
3321,0,2019-03-15,83924,ACTIMEL STRA 3x(14x100g) FR,0,0,0,ACTIMEL,1,Rotselaar(BE),0083,0024 FR CHAPONNAY (DC),4183,4544,4008,4008,0,536,536,0,361,-8.63016973464021,765,890,766,766,0,124,124,0,125,-16.33986928104575,86.06741573033709,86.06741573033709,0.0,88.20422535211267,88.20422535211267,0.0,Client
3322,0,2019-03-15,83924,ACTIMEL STRA 3x(14x100g) FR,0,0,0,ACTIMEL,1,Rotselaar(BE),0079,0024 FR PARIS SUD (DC),4183,4544,4008,4008,0,536,536,0,361,-8.63016973464021,653,839,427,427,0,412,412,0,186,-28.483920367534456,50.89392133492253,50.89392133492253,0.0,88.20422535211267,88.20422535211267,0.0,Client
3323,0,2019-03-15,83924,ACTIMEL STRA 3x(14x100g) FR,0,0,0,ACTIMEL,1,Rotselaar(BE),0078,0024 FR PARIS NORD (DC),4183,4544,4008,4008,0,536,536,0,361,-8.63016973464021,1570,1649,1649,1649,0,0,0,0,79,-5.031847133757962,100.0,100.0,0.0,88.20422535211267,88.20422535211267,0.0,Client
3324,1,2019-03-15,127088,DANONE LABAN 250X2,0,0,0,DANONE,0,Ferrières(FR),0078,0024 FR PARIS NORD (DC),6,37,29,16,13,21,8,0,31,-516.6666666666666,6,13,13,3,10,10,0,0,7,-116.66666666666667,100.0,23.076923076923077,76.92307692307692,78.37837837837837,43.24324324324324,35.13513513513513,Qualité
3325,1,2019-03-15,137713,DANET LIEG CARAMEL 100X4,0,1,0,DANETTE,0,StJust(FR),0081,0024 FR TOURS (DC),583,2909,2909,2790,119,119,0,0,2326,-398.97084048027443,583,503,503,385,118,118,0,0,-80,13.722126929674099,100.0,76.54075546719682,23.459244532803183,100.0,95.90924716397387,4.090752836026127,Transport
3326,0,2019-03-16,433,DANET MOUS CHOC LIEG 80gx4,1,0,0,DANETTE,1,Ochsenfurt(ALL),0084,0024 FR AIX (DC),2019,1732,1661,1297,364,435,71,0,-287,14.21495789995047,115,112,112,23,89,89,0,0,-3,2.608695652173913,100.0,20.535714285714285,79.46428571428572,95.90069284064666,74.88452655889145,21.016166281755204,Client
3327,1,2019-03-16,433,DANET MOUS CHOC LIEG 80gx4,1,0,0,DANETTE,1,Ochsenfurt(ALL),0084,0024 FR AIX (DC),2019,1732,1661,1297,364,435,71,0,-287,14.21495789995047,115,112,112,23,89,89,0,0,-3,2.608695652173913,100.0,20.535714285714285,79.46428571428572,95.90069284064666,74.88452655889145,21.016166281755204,Client
3328,0,2019-03-16,433,DANET MOUS CHOC LIEG 80gx4,1,0,0,DANETTE,1,Ochsenfurt(ALL),0080,0024 FR METZ (DC),2019,1732,1661,1297,364,435,71,0,-287,14.21495789995047,110,225,225,225,0,0,0,0,115,-104.54545454545455,100.0,100.0,0.0,95.90069284064666,74.88452655889145,21.016166281755204,Client
3329,0,2019-03-16,433,DANET MOUS CHOC LIEG 80gx4,1,0,0,DANETTE,1,Ochsenfurt(ALL),0081,0024 FR TOURS (DC),2019,1732,1661,1297,364,435,71,0,-287,14.21495789995047,508,570,499,499,0,71,71,0,62,-12.204724409448819,87.54385964912281,87.54385964912281,0.0,95.90069284064666,74.88452655889145,21.016166281755204,Client
3330,0,2019-03-16,433,DANET MOUS CHOC LIEG 80gx4,1,0,0,DANETTE,1,Ochsenfurt(ALL),0082,0024 FR VALLET (DC),2019,1732,1661,1297,364,435,71,0,-287,14.21495789995047,318,314,314,212,102,102,0,0,-4,1.2578616352201257,100.0,67.51592356687898,32.48407643312102,95.90069284064666,74.88452655889145,21.016166281755204,Client
3331,1,2019-03-16,433,DANET MOUS CHOC LIEG 80gx4,1,0,0,DANETTE,1,Ochsenfurt(ALL),0082,0024 FR VALLET (DC),2019,1732,1661,1297,364,435,71,0,-287,14.21495789995047,318,314,314,212,102,102,0,0,-4,1.2578616352201257,100.0,67.51592356687898,32.48407643312102,95.90069284064666,74.88452655889145,21.016166281755204,Client
3332,0,2019-03-16,433,DANET MOUS CHOC LIEG 80gx4,1,0,0,DANETTE,1,Ochsenfurt(ALL),0077,0024 FR LILPARK (DC),2019,1732,1661,1297,364,435,71,0,-287,14.21495789995047,56,113,113,0,113,113,0,0,57,-101.78571428571429,100.0,0.0,100.0,95.90069284064666,74.88452655889145,21.016166281755204,Client
3333,0,2019-03-16,433,DANET MOUS CHOC LIEG 80gx4,1,0,0,DANETTE,1,Ochsenfurt(ALL),0085,0024 FR TOULOUSE (DC),2019,1732,1661,1297,364,435,71,0,-287,14.21495789995047,102,102,102,102,0,0,0,0,0,0.0,100.0,100.0,0.0,95.90069284064666,74.88452655889145,21.016166281755204,Client
3334,0,2019-03-16,433,DANET MOUS CHOC LIEG 80gx4,1,0,0,DANETTE,1,Ochsenfurt(ALL),0083,0024 FR CHAPONNAY (DC),2019,1732,1661,1297,364,435,71,0,-287,14.21495789995047,148,146,146,146,0,0,0,0,-2,1.3513513513513513,100.0,100.0,0.0,95.90069284064666,74.88452655889145,21.016166281755204,Client
3335,0,2019-03-16,433,DANET MOUS CHOC LIEG 80gx4,1,0,0,DANETTE,1,Ochsenfurt(ALL),0079,0024 FR PARIS SUD (DC),2019,1732,1661,1297,364,435,71,0,-287,14.21495789995047,57,75,75,75,0,0,0,0,18,-31.57894736842105,100.0,100.0,0.0,95.90069284064666,74.88452655889145,21.016166281755204,Client
3336,0,2019-03-16,433,DANET MOUS CHOC LIEG 80gx4,1,0,0,DANETTE,1,Ochsenfurt(ALL),0078,0024 FR PARIS NORD (DC),2019,1732,1661,1297,364,435,71,0,-287,14.21495789995047,86,75,75,15,60,60,0,0,-11,12.790697674418604,100.0,20.0,80.0,95.90069284064666,74.88452655889145,21.016166281755204,Client
3337,1,2019-03-16,433,DANET MOUS CHOC LIEG 80gx4,1,0,0,DANETTE,1,Ochsenfurt(ALL),0078,0024 FR PARIS NORD (DC),2019,1732,1661,1297,364,435,71,0,-287,14.21495789995047,86,75,75,15,60,60,0,0,-11,12.790697674418604,100.0,20.0,80.0,95.90069284064666,74.88452655889145,21.016166281755204,Client
3338,0,2019-03-16,83923,ACTIMEL NATU 3x(14x100g) FR,0,0,0,ACTIMEL,1,Rotselaar(BE),0084,0024 FR AIX (DC),1551,1653,1497,1476,21,177,156,0,102,-6.576402321083172,298,385,320,320,0,65,65,0,87,-29.19463087248322,83.11688311688312,83.11688311688312,0.0,90.56261343012704,89.29219600725953,1.27041742286751,Client
3339,0,2019-03-16,83923,ACTIMEL NATU 3x(14x100g) FR,0,0,0,ACTIMEL,1,Rotselaar(BE),0081,0024 FR TOURS (DC),1551,1653,1497,1476,21,177,156,0,102,-6.576402321083172,22,22,22,1,21,21,0,0,0,0.0,100.0,4.545454545454546,95.45454545454545,90.56261343012704,89.29219600725953,1.27041742286751,Client
3340,1,2019-03-16,83923,ACTIMEL NATU 3x(14x100g) FR,0,0,0,ACTIMEL,1,Rotselaar(BE),0081,0024 FR TOURS (DC),1551,1653,1497,1476,21,177,156,0,102,-6.576402321083172,22,22,22,1,21,21,0,0,0,0.0,100.0,4.545454545454546,95.45454545454545,90.56261343012704,89.29219600725953,1.27041742286751,Client
3341,0,2019-03-16,83923,ACTIMEL NATU 3x(14x100g) FR,0,0,0,ACTIMEL,1,Rotselaar(BE),0082,0024 FR VALLET (DC),1551,1653,1497,1476,21,177,156,0,102,-6.576402321083172,193,179,179,179,0,0,0,0,-14,7.253886010362694,100.0,100.0,0.0,90.56261343012704,89.29219600725953,1.27041742286751,Client
3342,0,2019-03-16,83923,ACTIMEL NATU 3x(14x100g) FR,0,0,0,ACTIMEL,1,Rotselaar(BE),0077,0024 FR LILPARK (DC),1551,1653,1497,1476,21,177,156,0,102,-6.576402321083172,149,185,185,185,0,0,0,0,36,-24.161073825503355,100.0,100.0,0.0,90.56261343012704,89.29219600725953,1.27041742286751,Client
3343,0,2019-03-16,83923,ACTIMEL NATU 3x(14x100g) FR,0,0,0,ACTIMEL,1,Rotselaar(BE),0085,0024 FR TOULOUSE (DC),1551,1653,1497,1476,21,177,156,0,102,-6.576402321083172,125,124,124,124,0,0,0,0,-1,0.8,100.0,100.0,0.0,90.56261343012704,89.29219600725953,1.27041742286751,Client
3344,0,2019-03-16,83923,ACTIMEL NATU 3x(14x100g) FR,0,0,0,ACTIMEL,1,Rotselaar(BE),0083,0024 FR CHAPONNAY (DC),1551,1653,1497,1476,21,177,156,0,102,-6.576402321083172,185,183,183,183,0,0,0,0,-2,1.0810810810810811,100.0,100.0,0.0,90.56261343012704,89.29219600725953,1.27041742286751,Client
3345,0,2019-03-16,83923,ACTIMEL NATU 3x(14x100g) FR,0,0,0,ACTIMEL,1,Rotselaar(BE),0079,0024 FR PARIS SUD (DC),1551,1653,1497,1476,21,177,156,0,102,-6.576402321083172,194,211,211,211,0,0,0,0,17,-8.762886597938145,100.0,100.0,0.0,90.56261343012704,89.29219600725953,1.27041742286751,Client
3346,0,2019-03-16,83923,ACTIMEL NATU 3x(14x100g) FR,0,0,0,ACTIMEL,1,Rotselaar(BE),0078,0024 FR PARIS NORD (DC),1551,1653,1497,1476,21,177,156,0,102,-6.576402321083172,363,364,273,273,0,91,91,0,1,-0.27548209366391185,75.0,75.0,0.0,90.56261343012704,89.29219600725953,1.27041742286751,Client
3347,0,2019-03-16,105287,DANET MOUS CHOC LIEG 80gx4 Lidl,0,0,0,DANETTE,1,Ochsenfurt(ALL),0081,0024 FR TOURS (DC),629,720,595,282,313,438,125,0,91,-14.467408585055644,223,240,120,120,0,120,120,0,17,-7.623318385650224,50.0,50.0,0.0,82.63888888888889,39.166666666666664,43.47222222222222,Client
3348,0,2019-03-16,105287,DANET MOUS CHOC LIEG 80gx4 Lidl,0,0,0,DANETTE,1,Ochsenfurt(ALL),0082,0024 FR VALLET (DC),629,720,595,282,313,438,125,0,91,-14.467408585055644,0,120,115,0,115,120,5,1,120,10000.0,95.83333333333334,0.0,95.83333333333334,82.63888888888889,39.166666666666664,43.47222222222222,Client
3349,0,2019-03-16,105287,DANET MOUS CHOC LIEG 80gx4 Lidl,0,0,0,DANETTE,1,Ochsenfurt(ALL),0077,0024 FR LILPARK (DC),629,720,595,282,313,438,125,0,91,-14.467408585055644,406,360,360,162,198,198,0,0,-46,11.330049261083744,100.0,45.0,55.0,82.63888888888889,39.166666666666664,43.47222222222222,Client
3350,0,2019-03-16,145090,DANET CARAMEL 125X6 D,0,1,0,DANETTE,0,StJust(FR),0082,0024 FR VALLET (DC),584,455,59,0,59,455,396,0,-129,22.089041095890412,89,182,26,0,26,182,156,0,93,-104.49438202247191,14.285714285714285,0.0,14.285714285714285,12.967032967032969,0.0,12.967032967032969,Client
3351,0,2019-03-16,145090,DANET CARAMEL 125X6 D,0,1,0,DANETTE,0,StJust(FR),0077,0024 FR LILPARK (DC),584,455,59,0,59,455,396,0,-129,22.089041095890412,495,273,33,0,33,273,240,0,-222,44.84848484848485,12.087912087912088,0.0,12.087912087912088,12.967032967032969,0.0,12.967032967032969,Client
3352,0,2019-03-18,105287,DANET MOUS CHOC LIEG 80gx4 Lidl,0,0,0,DANETTE,1,Ochsenfurt(ALL),0084,0024 FR AIX (DC),1569,3064,2568,2328,240,736,496,0,1495,-95.2836201402167,143,480,480,480,0,0,0,0,337,-235.66433566433565,100.0,100.0,0.0,83.81201044386422,75.97911227154047,7.832898172323752,Client
3353,0,2019-03-18,105287,DANET MOUS CHOC LIEG 80gx4 Lidl,0,0,0,DANETTE,1,Ochsenfurt(ALL),0080,0024 FR METZ (DC),1569,3064,2568,2328,240,736,496,0,1495,-95.2836201402167,192,360,272,272,0,88,88,0,168,-87.5,75.55555555555556,75.55555555555556,0.0,83.81201044386422,75.97911227154047,7.832898172323752,Client
3354,0,2019-03-18,105287,DANET MOUS CHOC LIEG 80gx4 Lidl,0,0,0,DANETTE,1,Ochsenfurt(ALL),0081,0024 FR TOURS (DC),1569,3064,2568,2328,240,736,496,0,1495,-95.2836201402167,213,240,240,240,0,0,0,0,27,-12.67605633802817,100.0,100.0,0.0,83.81201044386422,75.97911227154047,7.832898172323752,Client
3355,0,2019-03-18,105287,DANET MOUS CHOC LIEG 80gx4 Lidl,0,0,0,DANETTE,1,Ochsenfurt(ALL),0082,0024 FR VALLET (DC),1569,3064,2568,2328,240,736,496,0,1495,-95.2836201402167,59,240,240,136,104,104,0,0,181,-306.77966101694915,100.0,56.666666666666664,43.333333333333336,83.81201044386422,75.97911227154047,7.832898172323752,Client
3356,0,2019-03-18,105287,DANET MOUS CHOC LIEG 80gx4 Lidl,0,0,0,DANETTE,1,Ochsenfurt(ALL),0077,0024 FR LILPARK (DC),1569,3064,2568,2328,240,736,496,0,1495,-95.2836201402167,256,240,240,240,0,0,0,0,-16,6.25,100.0,100.0,0.0,83.81201044386422,75.97911227154047,7.832898172323752,Client
3357,0,2019-03-18,105287,DANET MOUS CHOC LIEG 80gx4 Lidl,0,0,0,DANETTE,1,Ochsenfurt(ALL),0085,0024 FR TOULOUSE (DC),1569,3064,2568,2328,240,736,496,0,1495,-95.2836201402167,166,480,480,480,0,0,0,0,314,-189.15662650602408,100.0,100.0,0.0,83.81201044386422,75.97911227154047,7.832898172323752,Client
3358,0,2019-03-18,105287,DANET MOUS CHOC LIEG 80gx4 Lidl,0,0,0,DANETTE,1,Ochsenfurt(ALL),0083,0024 FR CHAPONNAY (DC),1569,3064,2568,2328,240,736,496,0,1495,-95.2836201402167,206,360,360,360,0,0,0,0,154,-74.75728155339806,100.0,100.0,0.0,83.81201044386422,75.97911227154047,7.832898172323752,Client
3359,0,2019-03-18,105287,DANET MOUS CHOC LIEG 80gx4 Lidl,0,0,0,DANETTE,1,Ochsenfurt(ALL),0079,0024 FR PARIS SUD (DC),1569,3064,2568,2328,240,736,496,0,1495,-95.2836201402167,38,544,136,0,136,544,408,0,506,-1331.578947368421,25.0,0.0,25.0,83.81201044386422,75.97911227154047,7.832898172323752,Client
3360,0,2019-03-18,105287,DANET MOUS CHOC LIEG 80gx4 Lidl,0,0,0,DANETTE,1,Ochsenfurt(ALL),0078,0024 FR PARIS NORD (DC),1569,3064,2568,2328,240,736,496,0,1495,-95.2836201402167,296,120,120,120,0,0,0,0,-176,59.45945945945946,100.0,100.0,0.0,83.81201044386422,75.97911227154047,7.832898172323752,Client
3361,0,2019-03-18,132459,ACTIVIA SAV VANILLE 125X4 OD,0,0,0,ACTIVIA,0,Bailleul(FR),0082,0024 FR VALLET (DC),0,15,15,15,0,0,0,1,15,90000.0,0,15,15,15,0,0,0,1,15,10000.0,100.0,100.0,0.0,100.0,100.0,0.0,Previsions
3362,0,2019-03-18,145090,DANET CARAMEL 125X6 D,0,1,0,DANETTE,0,StJust(FR),0084,0024 FR AIX (DC),1138,1274,551,0,551,1274,723,0,136,-11.95079086115993,161,455,303,0,303,455,152,0,294,-182.6086956521739,66.59340659340658,0.0,66.59340659340658,43.24960753532182,0.0,43.24960753532182,Client
3363,0,2019-03-18,145090,DANET CARAMEL 125X6 D,0,1,0,DANETTE,0,StJust(FR),0082,0024 FR VALLET (DC),1138,1274,551,0,551,1274,723,0,136,-11.95079086115993,64,91,26,0,26,91,65,0,27,-42.1875,28.57142857142857,0.0,28.57142857142857,43.24960753532182,0.0,43.24960753532182,Client
3364,0,2019-03-18,145090,DANET CARAMEL 125X6 D,0,1,0,DANETTE,0,StJust(FR),0077,0024 FR LILPARK (DC),1138,1274,551,0,551,1274,723,0,136,-11.95079086115993,103,182,56,0,56,182,126,0,79,-76.69902912621359,30.76923076923077,0.0,30.76923076923077,43.24960753532182,0.0,43.24960753532182,Client
3365,0,2019-03-18,145090,DANET CARAMEL 125X6 D,0,1,0,DANETTE,0,StJust(FR),0085,0024 FR TOULOUSE (DC),1138,1274,551,0,551,1274,723,0,136,-11.95079086115993,276,455,156,0,156,455,299,0,179,-64.85507246376811,34.285714285714285,0.0,34.285714285714285,43.24960753532182,0.0,43.24960753532182,Client
3366,0,2019-03-18,145090,DANET CARAMEL 125X6 D,0,1,0,DANETTE,0,StJust(FR),0078,0024 FR PARIS NORD (DC),1138,1274,551,0,551,1274,723,0,136,-11.95079086115993,534,91,10,0,10,91,81,0,-443,82.95880149812734,10.989010989010989,0.0,10.989010989010989,43.24960753532182,0.0,43.24960753532182,Client
3367,0,2019-03-19,83924,ACTIMEL STRA 3x(14x100g) FR,0,0,0,ACTIMEL,1,Rotselaar(BE),0084,0024 FR AIX (DC),571,1330,948,836,112,494,382,0,759,-132.9246935201401,39,75,75,0,75,75,0,0,36,-92.3076923076923,100.0,0.0,100.0,71.2781954887218,62.857142857142854,8.421052631578952,Client
3368,0,2019-03-19,83924,ACTIMEL STRA 3x(14x100g) FR,0,0,0,ACTIMEL,1,Rotselaar(BE),0081,0024 FR TOURS (DC),571,1330,948,836,112,494,382,0,759,-132.9246935201401,0,16,4,3,1,13,12,1,16,10000.0,25.0,18.75,6.25,71.2781954887218,62.857142857142854,8.421052631578952,Client
3369,0,2019-03-19,83924,ACTIMEL STRA 3x(14x100g) FR,0,0,0,ACTIMEL,1,Rotselaar(BE),0082,0024 FR VALLET (DC),571,1330,948,836,112,494,382,0,759,-132.9246935201401,25,188,132,127,5,61,56,0,163,-652.0,70.2127659574468,67.5531914893617,2.659574468085111,71.2781954887218,62.857142857142854,8.421052631578952,Client
3370,0,2019-03-19,83924,ACTIMEL STRA 3x(14x100g) FR,0,0,0,ACTIMEL,1,Rotselaar(BE),0077,0024 FR LILPARK (DC),571,1330,948,836,112,494,382,0,759,-132.9246935201401,0,111,111,111,0,0,0,1,111,10000.0,100.0,100.0,0.0,71.2781954887218,62.857142857142854,8.421052631578952,Client
3371,0,2019-03-19,83924,ACTIMEL STRA 3x(14x100g) FR,0,0,0,ACTIMEL,1,Rotselaar(BE),0085,0024 FR TOULOUSE (DC),571,1330,948,836,112,494,382,0,759,-132.9246935201401,14,77,9,9,0,68,68,0,63,-450.0,11.688311688311687,11.688311688311687,0.0,71.2781954887218,62.857142857142854,8.421052631578952,Client
3372,0,2019-03-19,83924,ACTIMEL STRA 3x(14x100g) FR,0,0,0,ACTIMEL,1,Rotselaar(BE),0083,0024 FR CHAPONNAY (DC),571,1330,948,836,112,494,382,0,759,-132.9246935201401,98,164,28,0,28,164,136,0,66,-67.34693877551021,17.073170731707318,0.0,17.073170731707318,71.2781954887218,62.857142857142854,8.421052631578952,Client
3373,1,2019-03-19,83924,ACTIMEL STRA 3x(14x100g) FR,0,0,0,ACTIMEL,1,Rotselaar(BE),0083,0024 FR CHAPONNAY (DC),571,1330,948,836,112,494,382,0,759,-132.9246935201401,98,164,28,0,28,164,136,0,66,-67.34693877551021,17.073170731707318,0.0,17.073170731707318,71.2781954887218,62.857142857142854,8.421052631578952,Client
3374,0,2019-03-19,83924,ACTIMEL STRA 3x(14x100g) FR,0,0,0,ACTIMEL,1,Rotselaar(BE),0079,0024 FR PARIS SUD (DC),571,1330,948,836,112,494,382,0,759,-132.9246935201401,86,239,129,126,3,113,110,0,153,-177.90697674418604,53.97489539748954,52.719665271966534,1.2552301255230063,71.2781954887218,62.857142857142854,8.421052631578952,Client
3375,0,2019-03-19,83924,ACTIMEL STRA 3x(14x100g) FR,0,0,0,ACTIMEL,1,Rotselaar(BE),0078,0024 FR PARIS NORD (DC),571,1330,948,836,112,494,382,0,759,-132.9246935201401,211,460,460,460,0,0,0,0,249,-118.00947867298578,100.0,100.0,0.0,71.2781954887218,62.857142857142854,8.421052631578952,Client
3376,0,2019-03-19,102497,ACTIVIA CHEESE STRAWBERRY 120X4,0,0,0,ACTIVIA,0,Ferrières(FR),0084,0024 FR AIX (DC),1106,1073,1067,887,180,186,6,0,-33,2.9837251356238697,88,99,99,63,36,36,0,0,11,-12.5,100.0,63.63636363636363,36.36363636363637,99.4408201304753,82.6654240447344,16.77539608574091,Schéma
3377,0,2019-03-19,102497,ACTIVIA CHEESE STRAWBERRY 120X4,0,0,0,ACTIVIA,0,Ferrières(FR),0080,0024 FR METZ (DC),1106,1073,1067,887,180,186,6,0,-33,2.9837251356238697,51,49,49,49,0,0,0,0,-2,3.9215686274509802,100.0,100.0,0.0,99.4408201304753,82.6654240447344,16.77539608574091,Schéma
3378,0,2019-03-19,102497,ACTIVIA CHEESE STRAWBERRY 120X4,0,0,0,ACTIVIA,0,Ferrières(FR),0081,0024 FR TOURS (DC),1106,1073,1067,887,180,186,6,0,-33,2.9837251356238697,150,139,133,124,9,15,6,0,-11,7.333333333333333,95.68345323741008,89.20863309352518,6.474820143884898,99.4408201304753,82.6654240447344,16.77539608574091,Schéma
3379,0,2019-03-19,102497,ACTIVIA CHEESE STRAWBERRY 120X4,0,0,0,ACTIVIA,0,Ferrières(FR),0082,0024 FR VALLET (DC),1106,1073,1067,887,180,186,6,0,-33,2.9837251356238697,96,96,96,82,14,14,0,0,0,0.0,100.0,85.41666666666666,14.583333333333343,99.4408201304753,82.6654240447344,16.77539608574091,Schéma
3380,0,2019-03-19,102497,ACTIVIA CHEESE STRAWBERRY 120X4,0,0,0,ACTIVIA,0,Ferrières(FR),0077,0024 FR LILPARK (DC),1106,1073,1067,887,180,186,6,0,-33,2.9837251356238697,163,147,147,147,0,0,0,0,-16,9.815950920245399,100.0,100.0,0.0,99.4408201304753,82.6654240447344,16.77539608574091,Schéma
3381,0,2019-03-19,102497,ACTIVIA CHEESE STRAWBERRY 120X4,0,0,0,ACTIVIA,0,Ferrières(FR),0085,0024 FR TOULOUSE (DC),1106,1073,1067,887,180,186,6,0,-33,2.9837251356238697,128,120,120,97,23,23,0,0,-8,6.25,100.0,80.83333333333333,19.16666666666667,99.4408201304753,82.6654240447344,16.77539608574091,Schéma
3382,0,2019-03-19,102497,ACTIVIA CHEESE STRAWBERRY 120X4,0,0,0,ACTIVIA,0,Ferrières(FR),0083,0024 FR CHAPONNAY (DC),1106,1073,1067,887,180,186,6,0,-33,2.9837251356238697,113,119,119,82,37,37,0,0,6,-5.3097345132743365,100.0,68.90756302521008,31.09243697478992,99.4408201304753,82.6654240447344,16.77539608574091,Schéma
3383,0,2019-03-19,102497,ACTIVIA CHEESE STRAWBERRY 120X4,0,0,0,ACTIVIA,0,Ferrières(FR),0079,0024 FR PARIS SUD (DC),1106,1073,1067,887,180,186,6,0,-33,2.9837251356238697,214,218,218,157,61,61,0,0,4,-1.8691588785046729,100.0,72.01834862385321,27.981651376146786,99.4408201304753,82.6654240447344,16.77539608574091,Schéma
3384,0,2019-03-19,102497,ACTIVIA CHEESE STRAWBERRY 120X4,0,0,0,ACTIVIA,0,Ferrières(FR),0078,0024 FR PARIS NORD (DC),1106,1073,1067,887,180,186,6,0,-33,2.9837251356238697,103,86,86,86,0,0,0,0,-17,16.50485436893204,100.0,100.0,0.0,99.4408201304753,82.6654240447344,16.77539608574091,Schéma
3385,0,2019-03-19,105287,DANET MOUS CHOC LIEG 80gx4 Lidl,0,0,0,DANETTE,1,Ochsenfurt(ALL),0084,0024 FR AIX (DC),1824,1816,1724,1468,256,348,92,0,-8,0.43859649122807015,173,120,120,104,16,16,0,0,-53,30.63583815028902,100.0,86.66666666666667,13.333333333333329,94.93392070484582,80.83700440528634,14.096916299559481,Client
3386,0,2019-03-19,105287,DANET MOUS CHOC LIEG 80gx4 Lidl,0,0,0,DANETTE,1,Ochsenfurt(ALL),0080,0024 FR METZ (DC),1824,1816,1724,1468,256,348,92,0,-8,0.43859649122807015,290,360,360,360,0,0,0,0,70,-24.137931034482758,100.0,100.0,0.0,94.93392070484582,80.83700440528634,14.096916299559481,Client
3387,0,2019-03-19,105287,DANET MOUS CHOC LIEG 80gx4 Lidl,0,0,0,DANETTE,1,Ochsenfurt(ALL),0082,0024 FR VALLET (DC),1824,1816,1724,1468,256,348,92,0,-8,0.43859649122807015,91,240,240,0,240,240,0,0,149,-163.73626373626374,100.0,0.0,100.0,94.93392070484582,80.83700440528634,14.096916299559481,Client
3388,0,2019-03-19,105287,DANET MOUS CHOC LIEG 80gx4 Lidl,0,0,0,DANETTE,1,Ochsenfurt(ALL),0077,0024 FR LILPARK (DC),1824,1816,1724,1468,256,348,92,0,-8,0.43859649122807015,299,360,360,360,0,0,0,0,61,-20.401337792642142,100.0,100.0,0.0,94.93392070484582,80.83700440528634,14.096916299559481,Client
3389,0,2019-03-19,105287,DANET MOUS CHOC LIEG 80gx4 Lidl,0,0,0,DANETTE,1,Ochsenfurt(ALL),0085,0024 FR TOULOUSE (DC),1824,1816,1724,1468,256,348,92,0,-8,0.43859649122807015,277,240,173,173,0,67,67,0,-37,13.35740072202166,72.08333333333333,72.08333333333333,0.0,94.93392070484582,80.83700440528634,14.096916299559481,Client
3390,0,2019-03-19,105287,DANET MOUS CHOC LIEG 80gx4 Lidl,0,0,0,DANETTE,1,Ochsenfurt(ALL),0083,0024 FR CHAPONNAY (DC),1824,1816,1724,1468,256,348,92,0,-8,0.43859649122807015,231,120,95,95,0,25,25,0,-111,48.05194805194805,79.16666666666666,79.16666666666666,0.0,94.93392070484582,80.83700440528634,14.096916299559481,Client
3391,0,2019-03-19,105287,DANET MOUS CHOC LIEG 80gx4 Lidl,0,0,0,DANETTE,1,Ochsenfurt(ALL),0079,0024 FR PARIS SUD (DC),1824,1816,1724,1468,256,348,92,0,-8,0.43859649122807015,128,136,136,136,0,0,0,0,8,-6.25,100.0,100.0,0.0,94.93392070484582,80.83700440528634,14.096916299559481,Client
3392,0,2019-03-19,105287,DANET MOUS CHOC LIEG 80gx4 Lidl,0,0,0,DANETTE,1,Ochsenfurt(ALL),0078,0024 FR PARIS NORD (DC),1824,1816,1724,1468,256,348,92,0,-8,0.43859649122807015,335,240,240,240,0,0,0,0,-95,28.35820895522388,100.0,100.0,0.0,94.93392070484582,80.83700440528634,14.096916299559481,Client
3393,0,2019-03-19,120841,VELOUTE FRUIX PANACHES 125X8 AFH,0,0,1,VELOUTE,0,Villecomtal(FR),0084,0024 FR AIX (DC),6295,6220,6013,6012,1,208,207,0,-75,1.1914217633042097,803,620,620,620,0,0,0,0,-183,22.789539227895393,100.0,100.0,0.0,96.67202572347267,96.65594855305466,0.01607717041801493,A Creuser
3394,0,2019-03-19,120841,VELOUTE FRUIX PANACHES 125X8 AFH,0,0,1,VELOUTE,0,Villecomtal(FR),0080,0024 FR METZ (DC),6295,6220,6013,6012,1,208,207,0,-75,1.1914217633042097,435,526,526,526,0,0,0,0,91,-20.919540229885058,100.0,100.0,0.0,96.67202572347267,96.65594855305466,0.01607717041801493,A Creuser
3395,0,2019-03-19,120841,VELOUTE FRUIX PANACHES 125X8 AFH,0,0,1,VELOUTE,0,Villecomtal(FR),0081,0024 FR TOURS (DC),6295,6220,6013,6012,1,208,207,0,-75,1.1914217633042097,1880,1193,1193,1192,1,1,0,0,-687,36.54255319148936,100.0,99.91617770326907,0.08382229673092922,96.67202572347267,96.65594855305466,0.01607717041801493,A Creuser
3396,0,2019-03-19,120841,VELOUTE FRUIX PANACHES 125X8 AFH,0,0,1,VELOUTE,0,Villecomtal(FR),0082,0024 FR VALLET (DC),6295,6220,6013,6012,1,208,207,0,-75,1.1914217633042097,562,486,486,486,0,0,0,0,-76,13.523131672597865,100.0,100.0,0.0,96.67202572347267,96.65594855305466,0.01607717041801493,A Creuser
3397,0,2019-03-19,120841,VELOUTE FRUIX PANACHES 125X8 AFH,0,0,1,VELOUTE,0,Villecomtal(FR),0077,0024 FR LILPARK (DC),6295,6220,6013,6012,1,208,207,0,-75,1.1914217633042097,295,177,177,177,0,0,0,0,-118,40.0,100.0,100.0,0.0,96.67202572347267,96.65594855305466,0.01607717041801493,A Creuser
3398,0,2019-03-19,120841,VELOUTE FRUIX PANACHES 125X8 AFH,0,0,1,VELOUTE,0,Villecomtal(FR),0085,0024 FR TOULOUSE (DC),6295,6220,6013,6012,1,208,207,0,-75,1.1914217633042097,405,579,579,579,0,0,0,0,174,-42.96296296296296,100.0,100.0,0.0,96.67202572347267,96.65594855305466,0.01607717041801493,A Creuser
3399,0,2019-03-19,120841,VELOUTE FRUIX PANACHES 125X8 AFH,0,0,1,VELOUTE,0,Villecomtal(FR),0083,0024 FR CHAPONNAY (DC),6295,6220,6013,6012,1,208,207,0,-75,1.1914217633042097,317,498,498,498,0,0,0,0,181,-57.09779179810725,100.0,100.0,0.0,96.67202572347267,96.65594855305466,0.01607717041801493,A Creuser
3400,0,2019-03-19,120841,VELOUTE FRUIX PANACHES 125X8 AFH,0,0,1,VELOUTE,0,Villecomtal(FR),0079,0024 FR PARIS SUD (DC),6295,6220,6013,6012,1,208,207,0,-75,1.1914217633042097,117,965,758,758,0,207,207,0,848,-724.7863247863248,78.54922279792747,78.54922279792747,0.0,96.67202572347267,96.65594855305466,0.01607717041801493,A Creuser
3401,0,2019-03-19,120841,VELOUTE FRUIX PANACHES 125X8 AFH,0,0,1,VELOUTE,0,Villecomtal(FR),0078,0024 FR PARIS NORD (DC),6295,6220,6013,6012,1,208,207,0,-75,1.1914217633042097,1481,1176,1176,1176,0,0,0,0,-305,20.594193112761648,100.0,100.0,0.0,96.67202572347267,96.65594855305466,0.01607717041801493,A Creuser
3402,0,2019-03-19,140947,ACV 145gx2(x5) BIO PINE-MANGO FR,0,0,0,ACTIVIA,1,Ochsenfurt(ALL),0084,0024 FR AIX (DC),698,567,563,423,140,144,4,0,-131,18.76790830945559,30,25,25,25,0,0,0,0,-5,16.666666666666668,100.0,100.0,0.0,99.29453262786596,74.60317460317461,24.691358024691354,Expe usine
3403,0,2019-03-19,140947,ACV 145gx2(x5) BIO PINE-MANGO FR,0,0,0,ACTIVIA,1,Ochsenfurt(ALL),0080,0024 FR METZ (DC),698,567,563,423,140,144,4,0,-131,18.76790830945559,71,64,64,64,0,0,0,0,-7,9.859154929577464,100.0,100.0,0.0,99.29453262786596,74.60317460317461,24.691358024691354,Expe usine
3404,0,2019-03-19,140947,ACV 145gx2(x5) BIO PINE-MANGO FR,0,0,0,ACTIVIA,1,Ochsenfurt(ALL),0081,0024 FR TOURS (DC),698,567,563,423,140,144,4,0,-131,18.76790830945559,137,144,140,0,140,144,4,0,7,-5.109489051094891,97.22222222222221,0.0,97.22222222222221,99.29453262786596,74.60317460317461,24.691358024691354,Expe usine
3405,1,2019-03-19,140947,ACV 145gx2(x5) BIO PINE-MANGO FR,0,0,0,ACTIVIA,1,Ochsenfurt(ALL),0081,0024 FR TOURS (DC),698,567,563,423,140,144,4,0,-131,18.76790830945559,137,144,140,0,140,144,4,0,7,-5.109489051094891,97.22222222222221,0.0,97.22222222222221,99.29453262786596,74.60317460317461,24.691358024691354,Expe usine
3406,0,2019-03-19,140947,ACV 145gx2(x5) BIO PINE-MANGO FR,0,0,0,ACTIVIA,1,Ochsenfurt(ALL),0082,0024 FR VALLET (DC),698,567,563,423,140,144,4,0,-131,18.76790830945559,42,46,46,46,0,0,0,0,4,-9.523809523809524,100.0,100.0,0.0,99.29453262786596,74.60317460317461,24.691358024691354,Expe usine
3407,0,2019-03-19,140947,ACV 145gx2(x5) BIO PINE-MANGO FR,0,0,0,ACTIVIA,1,Ochsenfurt(ALL),0077,0024 FR LILPARK (DC),698,567,563,423,140,144,4,0,-131,18.76790830945559,41,39,39,39,0,0,0,0,-2,4.878048780487805,100.0,100.0,0.0,99.29453262786596,74.60317460317461,24.691358024691354,Expe usine
3408,0,2019-03-19,140947,ACV 145gx2(x5) BIO PINE-MANGO FR,0,0,0,ACTIVIA,1,Ochsenfurt(ALL),0085,0024 FR TOULOUSE (DC),698,567,563,423,140,144,4,0,-131,18.76790830945559,39,24,24,24,0,0,0,0,-15,38.46153846153846,100.0,100.0,0.0,99.29453262786596,74.60317460317461,24.691358024691354,Expe usine
3409,0,2019-03-19,140947,ACV 145gx2(x5) BIO PINE-MANGO FR,0,0,0,ACTIVIA,1,Ochsenfurt(ALL),0083,0024 FR CHAPONNAY (DC),698,567,563,423,140,144,4,0,-131,18.76790830945559,57,63,63,63,0,0,0,0,6,-10.526315789473685,100.0,100.0,0.0,99.29453262786596,74.60317460317461,24.691358024691354,Expe usine
3410,0,2019-03-19,140947,ACV 145gx2(x5) BIO PINE-MANGO FR,0,0,0,ACTIVIA,1,Ochsenfurt(ALL),0079,0024 FR PARIS SUD (DC),698,567,563,423,140,144,4,0,-131,18.76790830945559,66,50,50,50,0,0,0,0,-16,24.242424242424242,100.0,100.0,0.0,99.29453262786596,74.60317460317461,24.691358024691354,Expe usine
3411,0,2019-03-19,140947,ACV 145gx2(x5) BIO PINE-MANGO FR,0,0,0,ACTIVIA,1,Ochsenfurt(ALL),0078,0024 FR PARIS NORD (DC),698,567,563,423,140,144,4,0,-131,18.76790830945559,78,112,112,112,0,0,0,0,34,-43.58974358974359,100.0,100.0,0.0,99.29453262786596,74.60317460317461,24.691358024691354,Expe usine
3412,0,2019-03-20,102481,ACTIVIA CHEESE VANILLA 120X4,0,0,0,ACTIVIA,0,Ferrières(FR),0084,0024 FR AIX (DC),710,702,648,501,147,201,54,0,-8,1.1267605633802817,78,128,74,71,3,57,54,0,50,-64.1025641025641,57.8125,55.46875,2.34375,92.3076923076923,71.36752136752136,20.940170940170944,Schéma
3413,0,2019-03-20,102481,ACTIVIA CHEESE VANILLA 120X4,0,0,0,ACTIVIA,0,Ferrières(FR),0080,0024 FR METZ (DC),710,702,648,501,147,201,54,0,-8,1.1267605633802817,102,72,72,72,0,0,0,0,-30,29.41176470588235,100.0,100.0,0.0,92.3076923076923,71.36752136752136,20.940170940170944,Schéma
3414,0,2019-03-20,102481,ACTIVIA CHEESE VANILLA 120X4,0,0,0,ACTIVIA,0,Ferrières(FR),0081,0024 FR TOURS (DC),710,702,648,501,147,201,54,0,-8,1.1267605633802817,58,43,43,43,0,0,0,0,-15,25.862068965517242,100.0,100.0,0.0,92.3076923076923,71.36752136752136,20.940170940170944,Schéma
3415,0,2019-03-20,102481,ACTIVIA CHEESE VANILLA 120X4,0,0,0,ACTIVIA,0,Ferrières(FR),0082,0024 FR VALLET (DC),710,702,648,501,147,201,54,0,-8,1.1267605633802817,83,88,88,24,64,64,0,0,5,-6.024096385542169,100.0,27.27272727272727,72.72727272727273,92.3076923076923,71.36752136752136,20.940170940170944,Schéma
3416,0,2019-03-20,102481,ACTIVIA CHEESE VANILLA 120X4,0,0,0,ACTIVIA,0,Ferrières(FR),0077,0024 FR LILPARK (DC),710,702,648,501,147,201,54,0,-8,1.1267605633802817,36,42,42,42,0,0,0,0,6,-16.666666666666668,100.0,100.0,0.0,92.3076923076923,71.36752136752136,20.940170940170944,Schéma
3417,0,2019-03-20,102481,ACTIVIA CHEESE VANILLA 120X4,0,0,0,ACTIVIA,0,Ferrières(FR),0085,0024 FR TOULOUSE (DC),710,702,648,501,147,201,54,0,-8,1.1267605633802817,92,85,85,85,0,0,0,0,-7,7.608695652173913,100.0,100.0,0.0,92.3076923076923,71.36752136752136,20.940170940170944,Schéma
3418,0,2019-03-20,102481,ACTIVIA CHEESE VANILLA 120X4,0,0,0,ACTIVIA,0,Ferrières(FR),0083,0024 FR CHAPONNAY (DC),710,702,648,501,147,201,54,0,-8,1.1267605633802817,69,61,61,61,0,0,0,0,-8,11.594202898550725,100.0,100.0,0.0,92.3076923076923,71.36752136752136,20.940170940170944,Schéma
3419,0,2019-03-20,102481,ACTIVIA CHEESE VANILLA 120X4,0,0,0,ACTIVIA,0,Ferrières(FR),0079,0024 FR PARIS SUD (DC),710,702,648,501,147,201,54,0,-8,1.1267605633802817,125,145,145,65,80,80,0,0,20,-16.0,100.0,44.827586206896555,55.172413793103445,92.3076923076923,71.36752136752136,20.940170940170944,Schéma
3420,0,2019-03-20,102481,ACTIVIA CHEESE VANILLA 120X4,0,0,0,ACTIVIA,0,Ferrières(FR),0078,0024 FR PARIS NORD (DC),710,702,648,501,147,201,54,0,-8,1.1267605633802817,67,38,38,38,0,0,0,0,-29,43.28358208955224,100.0,100.0,0.0,92.3076923076923,71.36752136752136,20.940170940170944,Schéma
3421,0,2019-03-20,133397,LIGHT & FREE FRAIS BOIS 120X4,0,0,0,LIGHT & FREE,0,Ferrières(FR),0084,0024 FR AIX (DC),451,508,382,382,0,126,126,0,57,-12.638580931263858,63,95,10,10,0,85,85,0,32,-50.79365079365079,10.526315789473683,10.526315789473683,0.0,75.19685039370079,75.19685039370079,0.0,Production
3422,0,2019-03-20,133397,LIGHT & FREE FRAIS BOIS 120X4,0,0,0,LIGHT & FREE,0,Ferrières(FR),0081,0024 FR TOURS (DC),451,508,382,382,0,126,126,0,57,-12.638580931263858,65,119,119,119,0,0,0,0,54,-83.07692307692308,100.0,100.0,0.0,75.19685039370079,75.19685039370079,0.0,Production
3423,0,2019-03-20,133397,LIGHT & FREE FRAIS BOIS 120X4,0,0,0,LIGHT & FREE,0,Ferrières(FR),0077,0024 FR LILPARK (DC),451,508,382,382,0,126,126,0,57,-12.638580931263858,18,20,20,20,0,0,0,0,2,-11.11111111111111,100.0,100.0,0.0,75.19685039370079,75.19685039370079,0.0,Production
3424,0,2019-03-20,133397,LIGHT & FREE FRAIS BOIS 120X4,0,0,0,LIGHT & FREE,0,Ferrières(FR),0085,0024 FR TOULOUSE (DC),451,508,382,382,0,126,126,0,57,-12.638580931263858,67,81,40,40,0,41,41,0,14,-20.895522388059703,49.382716049382715,49.382716049382715,0.0,75.19685039370079,75.19685039370079,0.0,Production
3425,0,2019-03-20,133397,LIGHT & FREE FRAIS BOIS 120X4,0,0,0,LIGHT & FREE,0,Ferrières(FR),0083,0024 FR CHAPONNAY (DC),451,508,382,382,0,126,126,0,57,-12.638580931263858,88,76,76,76,0,0,0,0,-12,13.636363636363637,100.0,100.0,0.0,75.19685039370079,75.19685039370079,0.0,Production
3426,0,2019-03-20,133397,LIGHT & FREE FRAIS BOIS 120X4,0,0,0,LIGHT & FREE,0,Ferrières(FR),0079,0024 FR PARIS SUD (DC),451,508,382,382,0,126,126,0,57,-12.638580931263858,78,55,55,55,0,0,0,0,-23,29.487179487179485,100.0,100.0,0.0,75.19685039370079,75.19685039370079,0.0,Production
3427,0,2019-03-20,133397,LIGHT & FREE FRAIS BOIS 120X4,0,0,0,LIGHT & FREE,0,Ferrières(FR),0078,0024 FR PARIS NORD (DC),451,508,382,382,0,126,126,0,57,-12.638580931263858,72,62,62,62,0,0,0,0,-10,13.88888888888889,100.0,100.0,0.0,75.19685039370079,75.19685039370079,0.0,Production
3428,1,2019-03-20,140947,ACV 145gx2(x5) BIO PINE-MANGO FR,0,0,0,ACTIVIA,1,Ochsenfurt(ALL),0082,0024 FR VALLET (DC),158,549,549,499,50,50,0,0,391,-247.46835443037975,158,140,140,90,50,50,0,0,-18,11.39240506329114,100.0,64.28571428571429,35.71428571428571,100.0,90.89253187613843,9.107468123861565,Expe usine
3429,0,2019-03-21,59540,DANET MOU LIEG CHOCO 80gx8,0,0,0,DANETTE,1,Ochsenfurt(ALL),0084,0024 FR AIX (DC),7798,7539,7214,7207,7,332,325,0,-259,3.3213644524236985,524,518,518,517,1,1,0,0,-6,1.1450381679389312,100.0,99.8069498069498,0.19305019305019755,95.68908343281602,95.59623292213821,0.09285051067780614,Previsions
3430,0,2019-03-21,59540,DANET MOU LIEG CHOCO 80gx8,0,0,0,DANETTE,1,Ochsenfurt(ALL),0080,0024 FR METZ (DC),7798,7539,7214,7207,7,332,325,0,-259,3.3213644524236985,602,745,667,667,0,78,78,0,143,-23.754152823920265,89.53020134228188,89.53020134228188,0.0,95.68908343281602,95.59623292213821,0.09285051067780614,Previsions
3431,0,2019-03-21,59540,DANET MOU LIEG CHOCO 80gx8,0,0,0,DANETTE,1,Ochsenfurt(ALL),0081,0024 FR TOURS (DC),7798,7539,7214,7207,7,332,325,0,-259,3.3213644524236985,1355,1146,1146,1146,0,0,0,0,-209,15.424354243542435,100.0,100.0,0.0,95.68908343281602,95.59623292213821,0.09285051067780614,Previsions
3432,0,2019-03-21,59540,DANET MOU LIEG CHOCO 80gx8,0,0,0,DANETTE,1,Ochsenfurt(ALL),0082,0024 FR VALLET (DC),7798,7539,7214,7207,7,332,325,0,-259,3.3213644524236985,524,530,530,530,0,0,0,0,6,-1.1450381679389312,100.0,100.0,0.0,95.68908343281602,95.59623292213821,0.09285051067780614,Previsions
3433,0,2019-03-21,59540,DANET MOU LIEG CHOCO 80gx8,0,0,0,DANETTE,1,Ochsenfurt(ALL),0077,0024 FR LILPARK (DC),7798,7539,7214,7207,7,332,325,0,-259,3.3213644524236985,1014,1093,1093,1093,0,0,0,0,79,-7.790927021696253,100.0,100.0,0.0,95.68908343281602,95.59623292213821,0.09285051067780614,Previsions
3434,0,2019-03-21,59540,DANET MOU LIEG CHOCO 80gx8,0,0,0,DANETTE,1,Ochsenfurt(ALL),0085,0024 FR TOULOUSE (DC),7798,7539,7214,7207,7,332,325,0,-259,3.3213644524236985,933,1301,1054,1048,6,253,247,0,368,-39.442658092175776,81.01460415065334,80.55342044581091,0.4611837048424263,95.68908343281602,95.59623292213821,0.09285051067780614,Previsions
3435,1,2019-03-21,59540,DANET MOU LIEG CHOCO 80gx8,0,0,0,DANETTE,1,Ochsenfurt(ALL),0085,0024 FR TOULOUSE (DC),7798,7539,7214,7207,7,332,325,0,-259,3.3213644524236985,933,1301,1054,1048,6,253,247,0,368,-39.442658092175776,81.01460415065334,80.55342044581091,0.4611837048424263,95.68908343281602,95.59623292213821,0.09285051067780614,Previsions
3436,0,2019-03-21,59540,DANET MOU LIEG CHOCO 80gx8,0,0,0,DANETTE,1,Ochsenfurt(ALL),0083,0024 FR CHAPONNAY (DC),7798,7539,7214,7207,7,332,325,0,-259,3.3213644524236985,942,1005,1005,1005,0,0,0,0,63,-6.687898089171974,100.0,100.0,0.0,95.68908343281602,95.59623292213821,0.09285051067780614,Previsions
3437,0,2019-03-21,59540,DANET MOU LIEG CHOCO 80gx8,0,0,0,DANETTE,1,Ochsenfurt(ALL),0079,0024 FR PARIS SUD (DC),7798,7539,7214,7207,7,332,325,0,-259,3.3213644524236985,530,666,666,666,0,0,0,0,136,-25.660377358490567,100.0,100.0,0.0,95.68908343281602,95.59623292213821,0.09285051067780614,Previsions
3438,0,2019-03-21,59540,DANET MOU LIEG CHOCO 80gx8,0,0,0,DANETTE,1,Ochsenfurt(ALL),0078,0024 FR PARIS NORD (DC),7798,7539,7214,7207,7,332,325,0,-259,3.3213644524236985,441,535,535,535,0,0,0,0,94,-21.31519274376417,100.0,100.0,0.0,95.68908343281602,95.59623292213821,0.09285051067780614,Previsions
3439,0,2019-03-21,133394,LIGHT & FREE PECH PASS 120X4,0,0,0,LIGHT & FREE,0,Ferrières(FR),0084,0024 FR AIX (DC),527,557,545,544,1,13,12,0,30,-5.692599620493358,66,66,66,66,0,0,0,0,0,0.0,100.0,100.0,0.0,97.84560143626571,97.66606822262118,0.17953321364453245,Production
3440,0,2019-03-21,133394,LIGHT & FREE PECH PASS 120X4,0,0,0,LIGHT & FREE,0,Ferrières(FR),0080,0024 FR METZ (DC),527,557,545,544,1,13,12,0,30,-5.692599620493358,39,26,24,24,0,2,2,0,-13,33.333333333333336,92.3076923076923,92.3076923076923,0.0,97.84560143626571,97.66606822262118,0.17953321364453245,Production
3441,0,2019-03-21,133394,LIGHT & FREE PECH PASS 120X4,0,0,0,LIGHT & FREE,0,Ferrières(FR),0081,0024 FR TOURS (DC),527,557,545,544,1,13,12,0,30,-5.692599620493358,49,59,59,59,0,0,0,0,10,-20.408163265306122,100.0,100.0,0.0,97.84560143626571,97.66606822262118,0.17953321364453245,Production
3442,0,2019-03-21,133394,LIGHT & FREE PECH PASS 120X4,0,0,0,LIGHT & FREE,0,Ferrières(FR),0082,0024 FR VALLET (DC),527,557,545,544,1,13,12,0,30,-5.692599620493358,9,26,26,26,0,0,0,0,17,-188.88888888888889,100.0,100.0,0.0,97.84560143626571,97.66606822262118,0.17953321364453245,Production
3443,0,2019-03-21,133394,LIGHT & FREE PECH PASS 120X4,0,0,0,LIGHT & FREE,0,Ferrières(FR),0085,0024 FR TOULOUSE (DC),527,557,545,544,1,13,12,0,30,-5.692599620493358,108,116,106,106,0,10,10,0,8,-7.407407407407407,91.37931034482759,91.37931034482759,0.0,97.84560143626571,97.66606822262118,0.17953321364453245,Production
3444,0,2019-03-21,133394,LIGHT & FREE PECH PASS 120X4,0,0,0,LIGHT & FREE,0,Ferrières(FR),0079,0024 FR PARIS SUD (DC),527,557,545,544,1,13,12,0,30,-5.692599620493358,186,175,175,175,0,0,0,0,-11,5.913978494623656,100.0,100.0,0.0,97.84560143626571,97.66606822262118,0.17953321364453245,Production
3445,0,2019-03-21,133394,LIGHT & FREE PECH PASS 120X4,0,0,0,LIGHT & FREE,0,Ferrières(FR),0078,0024 FR PARIS NORD (DC),527,557,545,544,1,13,12,0,30,-5.692599620493358,70,89,89,88,1,1,0,0,19,-27.142857142857142,100.0,98.87640449438202,1.1235955056179847,97.84560143626571,97.66606822262118,0.17953321364453245,Production
3446,0,2019-03-22,133133,LIGHT&FREE FRAIS BOIS 120X4 OD,1,0,0,LIGHT & FREE,0,Ferrières(FR),0084,0024 FR AIX (DC),6282,3806,3017,2976,41,830,789,0,-2476,39.414199299586116,445,436,267,267,0,169,169,0,-9,2.0224719101123596,61.23853211009175,61.23853211009175,0.0,79.26957435627956,78.19232790331057,1.0772464529689927,Production
3447,1,2019-03-22,133133,LIGHT&FREE FRAIS BOIS 120X4 OD,1,0,0,LIGHT & FREE,0,Ferrières(FR),0084,0024 FR AIX (DC),6282,3806,3017,2976,41,830,789,0,-2476,39.414199299586116,445,436,267,267,0,169,169,0,-9,2.0224719101123596,61.23853211009175,61.23853211009175,0.0,79.26957435627956,78.19232790331057,1.0772464529689927,Production
3448,0,2019-03-22,133133,LIGHT&FREE FRAIS BOIS 120X4 OD,1,0,0,LIGHT & FREE,0,Ferrières(FR),0080,0024 FR METZ (DC),6282,3806,3017,2976,41,830,789,0,-2476,39.414199299586116,963,925,465,425,40,500,460,0,-38,3.9460020768431985,50.27027027027027,45.94594594594595,4.324324324324316,79.26957435627956,78.19232790331057,1.0772464529689927,Production
3449,1,2019-03-22,133133,LIGHT&FREE FRAIS BOIS 120X4 OD,1,0,0,LIGHT & FREE,0,Ferrières(FR),0080,0024 FR METZ (DC),6282,3806,3017,2976,41,830,789,0,-2476,39.414199299586116,963,925,465,425,40,500,460,0,-38,3.9460020768431985,50.27027027027027,45.94594594594595,4.324324324324316,79.26957435627956,78.19232790331057,1.0772464529689927,Production
3450,0,2019-03-22,133133,LIGHT&FREE FRAIS BOIS 120X4 OD,1,0,0,LIGHT & FREE,0,Ferrières(FR),0081,0024 FR TOURS (DC),6282,3806,3017,2976,41,830,789,0,-2476,39.414199299586116,221,218,218,218,0,0,0,0,-3,1.3574660633484164,100.0,100.0,0.0,79.26957435627956,78.19232790331057,1.0772464529689927,Production
3451,0,2019-03-22,133133,LIGHT&FREE FRAIS BOIS 120X4 OD,1,0,0,LIGHT & FREE,0,Ferrières(FR),0082,0024 FR VALLET (DC),6282,3806,3017,2976,41,830,789,0,-2476,39.414199299586116,1008,1003,843,842,1,161,160,0,-5,0.49603174603174605,84.04785643070788,83.9481555333998,0.0997008973080824,79.26957435627956,78.19232790331057,1.0772464529689927,Production
3452,1,2019-03-22,133133,LIGHT&FREE FRAIS BOIS 120X4 OD,1,0,0,LIGHT & FREE,0,Ferrières(FR),0082,0024 FR VALLET (DC),6282,3806,3017,2976,41,830,789,0,-2476,39.414199299586116,1008,1003,843,842,1,161,160,0,-5,0.49603174603174605,84.04785643070788,83.9481555333998,0.0997008973080824,79.26957435627956,78.19232790331057,1.0772464529689927,Production
3453,0,2019-03-22,133133,LIGHT&FREE FRAIS BOIS 120X4 OD,1,0,0,LIGHT & FREE,0,Ferrières(FR),0077,0024 FR LILPARK (DC),6282,3806,3017,2976,41,830,789,0,-2476,39.414199299586116,395,325,325,325,0,0,0,0,-70,17.72151898734177,100.0,100.0,0.0,79.26957435627956,78.19232790331057,1.0772464529689927,Production
3454,0,2019-03-22,133133,LIGHT&FREE FRAIS BOIS 120X4 OD,1,0,0,LIGHT & FREE,0,Ferrières(FR),0085,0024 FR TOULOUSE (DC),6282,3806,3017,2976,41,830,789,0,-2476,39.414199299586116,511,509,509,509,0,0,0,0,-2,0.3913894324853229,100.0,100.0,0.0,79.26957435627956,78.19232790331057,1.0772464529689927,Production
3455,0,2019-03-22,133133,LIGHT&FREE FRAIS BOIS 120X4 OD,1,0,0,LIGHT & FREE,0,Ferrières(FR),0083,0024 FR CHAPONNAY (DC),6282,3806,3017,2976,41,830,789,0,-2476,39.414199299586116,241,241,241,241,0,0,0,0,0,0.0,100.0,100.0,0.0,79.26957435627956,78.19232790331057,1.0772464529689927,Production
3456,0,2019-03-22,133133,LIGHT&FREE FRAIS BOIS 120X4 OD,1,0,0,LIGHT & FREE,0,Ferrières(FR),0079,0024 FR PARIS SUD (DC),6282,3806,3017,2976,41,830,789,0,-2476,39.414199299586116,82,134,134,134,0,0,0,0,52,-63.41463414634146,100.0,100.0,0.0,79.26957435627956,78.19232790331057,1.0772464529689927,Production
3457,0,2019-03-22,133133,LIGHT&FREE FRAIS BOIS 120X4 OD,1,0,0,LIGHT & FREE,0,Ferrières(FR),0078,0024 FR PARIS NORD (DC),6282,3806,3017,2976,41,830,789,0,-2476,39.414199299586116,0,15,15,15,0,0,0,1,15,10000.0,100.0,100.0,0.0,79.26957435627956,78.19232790331057,1.0772464529689927,Production
3458,0,2019-03-22,140280,Activia chia/raspb/muesli 170g FR-copack,0,0,0,ACTIVIA,1,Roumanie(RO),0084,0024 FR AIX (DC),749,795,604,603,1,192,191,0,46,-6.141522029372497,82,97,44,43,1,54,53,0,15,-18.29268292682927,45.36082474226804,44.329896907216494,1.0309278350515498,75.9748427672956,75.84905660377359,0.1257861635220081,Schéma
3459,0,2019-03-22,140280,Activia chia/raspb/muesli 170g FR-copack,0,0,0,ACTIVIA,1,Roumanie(RO),0080,0024 FR METZ (DC),749,795,604,603,1,192,191,0,46,-6.141522029372497,81,72,72,72,0,0,0,0,-9,11.11111111111111,100.0,100.0,0.0,75.9748427672956,75.84905660377359,0.1257861635220081,Schéma
3460,0,2019-03-22,140280,Activia chia/raspb/muesli 170g FR-copack,0,0,0,ACTIVIA,1,Roumanie(RO),0081,0024 FR TOURS (DC),749,795,604,603,1,192,191,0,46,-6.141522029372497,78,67,67,67,0,0,0,0,-11,14.102564102564102,100.0,100.0,0.0,75.9748427672956,75.84905660377359,0.1257861635220081,Schéma
3461,0,2019-03-22,140280,Activia chia/raspb/muesli 170g FR-copack,0,0,0,ACTIVIA,1,Roumanie(RO),0082,0024 FR VALLET (DC),749,795,604,603,1,192,191,0,46,-6.141522029372497,76,74,74,74,0,0,0,0,-2,2.6315789473684212,100.0,100.0,0.0,75.9748427672956,75.84905660377359,0.1257861635220081,Schéma
3462,0,2019-03-22,140280,Activia chia/raspb/muesli 170g FR-copack,0,0,0,ACTIVIA,1,Roumanie(RO),0077,0024 FR LILPARK (DC),749,795,604,603,1,192,191,0,46,-6.141522029372497,56,64,48,48,0,16,16,0,8,-14.285714285714286,75.0,75.0,0.0,75.9748427672956,75.84905660377359,0.1257861635220081,Schéma
3463,0,2019-03-22,140280,Activia chia/raspb/muesli 170g FR-copack,0,0,0,ACTIVIA,1,Roumanie(RO),0085,0024 FR TOULOUSE (DC),749,795,604,603,1,192,191,0,46,-6.141522029372497,62,56,4,4,0,52,52,0,-6,9.67741935483871,7.142857142857142,7.142857142857142,0.0,75.9748427672956,75.84905660377359,0.1257861635220081,Schéma
3464,0,2019-03-22,140280,Activia chia/raspb/muesli 170g FR-copack,0,0,0,ACTIVIA,1,Roumanie(RO),0083,0024 FR CHAPONNAY (DC),749,795,604,603,1,192,191,0,46,-6.141522029372497,77,92,80,80,0,12,12,0,15,-19.48051948051948,86.95652173913044,86.95652173913044,0.0,75.9748427672956,75.84905660377359,0.1257861635220081,Schéma
3465,0,2019-03-22,140280,Activia chia/raspb/muesli 170g FR-copack,0,0,0,ACTIVIA,1,Roumanie(RO),0079,0024 FR PARIS SUD (DC),749,795,604,603,1,192,191,0,46,-6.141522029372497,96,60,54,54,0,6,6,0,-36,37.5,90.0,90.0,0.0,75.9748427672956,75.84905660377359,0.1257861635220081,Schéma
3466,0,2019-03-22,140280,Activia chia/raspb/muesli 170g FR-copack,0,0,0,ACTIVIA,1,Roumanie(RO),0078,0024 FR PARIS NORD (DC),749,795,604,603,1,192,191,0,46,-6.141522029372497,141,213,161,161,0,52,52,0,72,-51.06382978723404,75.5868544600939,75.5868544600939,0.0,75.9748427672956,75.84905660377359,0.1257861635220081,Schéma
3467,1,2019-03-22,140869,ACV 145gx2(x5) BIO BLUE-BLCURR FR,0,0,0,ACTIVIA,1,Ochsenfurt(ALL),0080,0024 FR METZ (DC),205,571,571,520,51,51,0,0,366,-178.53658536585365,187,190,190,158,32,32,0,0,3,-1.6042780748663101,100.0,83.15789473684211,16.84210526315789,100.0,91.06830122591944,8.931698774080559,Transport
3468,1,2019-03-22,140869,ACV 145gx2(x5) BIO BLUE-BLCURR FR,0,0,0,ACTIVIA,1,Ochsenfurt(ALL),0077,0024 FR LILPARK (DC),205,571,571,520,51,51,0,0,366,-178.53658536585365,18,19,19,0,19,19,0,0,1,-5.555555555555555,100.0,0.0,100.0,100.0,91.06830122591944,8.931698774080559,Transport
3469,0,2019-03-23,81988,GERVITA COCO 100X4,0,0,0,GERVITA,0,Ferrières(FR),0084,0024 FR AIX (DC),300,279,176,156,20,123,103,0,-21,7.0,58,52,19,19,0,33,33,0,-6,10.344827586206897,36.53846153846153,36.53846153846153,0.0,63.08243727598566,55.91397849462365,7.168458781362013,Production
3470,0,2019-03-23,81988,GERVITA COCO 100X4,0,0,0,GERVITA,0,Ferrières(FR),0080,0024 FR METZ (DC),300,279,176,156,20,123,103,0,-21,7.0,16,16,16,16,0,0,0,0,0,0.0,100.0,100.0,0.0,63.08243727598566,55.91397849462365,7.168458781362013,Production
3471,0,2019-03-23,81988,GERVITA COCO 100X4,0,0,0,GERVITA,0,Ferrières(FR),0081,0024 FR TOURS (DC),300,279,176,156,20,123,103,0,-21,7.0,48,43,7,6,1,37,36,0,-5,10.416666666666666,16.27906976744186,13.953488372093023,2.325581395348838,63.08243727598566,55.91397849462365,7.168458781362013,Production
3472,0,2019-03-23,81988,GERVITA COCO 100X4,0,0,0,GERVITA,0,Ferrières(FR),0082,0024 FR VALLET (DC),300,279,176,156,20,123,103,0,-21,7.0,14,19,19,0,19,19,0,0,5,-35.714285714285715,100.0,0.0,100.0,63.08243727598566,55.91397849462365,7.168458781362013,Production
3473,0,2019-03-23,81988,GERVITA COCO 100X4,0,0,0,GERVITA,0,Ferrières(FR),0085,0024 FR TOULOUSE (DC),300,279,176,156,20,123,103,0,-21,7.0,126,121,87,87,0,34,34,0,-5,3.9682539682539684,71.900826446281,71.900826446281,0.0,63.08243727598566,55.91397849462365,7.168458781362013,Production
3474,0,2019-03-23,81988,GERVITA COCO 100X4,0,0,0,GERVITA,0,Ferrières(FR),0083,0024 FR CHAPONNAY (DC),300,279,176,156,20,123,103,0,-21,7.0,38,28,28,28,0,0,0,0,-10,26.31578947368421,100.0,100.0,0.0,63.08243727598566,55.91397849462365,7.168458781362013,Production
3475,1,2019-03-23,131482,ACTIVIA FRT PINEAPPLE 125X4 OD,1,0,0,ACTIVIA,0,Villecomtal(FR),0080,0024 FR METZ (DC),72,571,571,545,26,26,0,0,499,-693.0555555555555,72,71,71,45,26,26,0,0,-1,1.3888888888888888,100.0,63.38028169014085,36.61971830985915,100.0,95.44658493870402,4.553415061295979,A Creuser
3476,0,2019-03-25,96132,LES 2 VACHES NATURE 115X4,0,0,0,LES 2 VACHES,0,LeMolay(FR),0084,0024 FR AIX (DC),3647,3886,3310,3310,0,576,576,0,239,-6.55333150534686,1038,1080,853,853,0,227,227,0,42,-4.046242774566474,78.98148148148148,78.98148148148148,0.0,85.1775604734946,85.1775604734946,0.0,Previsions
3477,0,2019-03-25,96132,LES 2 VACHES NATURE 115X4,0,0,0,LES 2 VACHES,0,LeMolay(FR),0080,0024 FR METZ (DC),3647,3886,3310,3310,0,576,576,0,239,-6.55333150534686,238,334,334,334,0,0,0,0,96,-40.33613445378151,100.0,100.0,0.0,85.1775604734946,85.1775604734946,0.0,Previsions
3478,0,2019-03-25,96132,LES 2 VACHES NATURE 115X4,0,0,0,LES 2 VACHES,0,LeMolay(FR),0081,0024 FR TOURS (DC),3647,3886,3310,3310,0,576,576,0,239,-6.55333150534686,314,309,203,203,0,106,106,0,-5,1.5923566878980893,65.69579288025889,65.69579288025889,0.0,85.1775604734946,85.1775604734946,0.0,Previsions
3479,0,2019-03-25,96132,LES 2 VACHES NATURE 115X4,0,0,0,LES 2 VACHES,0,LeMolay(FR),0082,0024 FR VALLET (DC),3647,3886,3310,3310,0,576,576,0,239,-6.55333150534686,215,205,205,205,0,0,0,0,-10,4.651162790697675,100.0,100.0,0.0,85.1775604734946,85.1775604734946,0.0,Previsions
3480,0,2019-03-25,96132,LES 2 VACHES NATURE 115X4,0,0,0,LES 2 VACHES,0,LeMolay(FR),0077,0024 FR LILPARK (DC),3647,3886,3310,3310,0,576,576,0,239,-6.55333150534686,141,218,218,218,0,0,0,0,77,-54.60992907801418,100.0,100.0,0.0,85.1775604734946,85.1775604734946,0.0,Previsions
3481,0,2019-03-25,96132,LES 2 VACHES NATURE 115X4,0,0,0,LES 2 VACHES,0,LeMolay(FR),0085,0024 FR TOULOUSE (DC),3647,3886,3310,3310,0,576,576,0,239,-6.55333150534686,362,388,278,278,0,110,110,0,26,-7.18232044198895,71.64948453608247,71.64948453608247,0.0,85.1775604734946,85.1775604734946,0.0,Previsions
3482,0,2019-03-25,96132,LES 2 VACHES NATURE 115X4,0,0,0,LES 2 VACHES,0,LeMolay(FR),0083,0024 FR CHAPONNAY (DC),3647,3886,3310,3310,0,576,576,0,239,-6.55333150534686,585,482,482,482,0,0,0,0,-103,17.60683760683761,100.0,100.0,0.0,85.1775604734946,85.1775604734946,0.0,Previsions
3483,0,2019-03-25,96132,LES 2 VACHES NATURE 115X4,0,0,0,LES 2 VACHES,0,LeMolay(FR),0079,0024 FR PARIS SUD (DC),3647,3886,3310,3310,0,576,576,0,239,-6.55333150534686,472,568,435,435,0,133,133,0,96,-20.338983050847457,76.58450704225352,76.58450704225352,0.0,85.1775604734946,85.1775604734946,0.0,Previsions
3484,0,2019-03-25,96132,LES 2 VACHES NATURE 115X4,0,0,0,LES 2 VACHES,0,LeMolay(FR),0078,0024 FR PARIS NORD (DC),3647,3886,3310,3310,0,576,576,0,239,-6.55333150534686,282,302,302,302,0,0,0,0,20,-7.092198581560283,100.0,100.0,0.0,85.1775604734946,85.1775604734946,0.0,Previsions
3485,0,2019-03-25,115026,FJORD NATURE 125GX8 OPL,1,0,0,FJORD,0,LeMolay(FR),0084,0024 FR AIX (DC),1349,1395,1247,1247,0,148,148,0,46,-3.40993328391401,212,214,214,214,0,0,0,0,2,-0.9433962264150944,100.0,100.0,0.0,89.39068100358423,89.39068100358423,0.0,Previsions
3486,0,2019-03-25,115026,FJORD NATURE 125GX8 OPL,1,0,0,FJORD,0,LeMolay(FR),0080,0024 FR METZ (DC),1349,1395,1247,1247,0,148,148,0,46,-3.40993328391401,97,97,97,97,0,0,0,0,0,0.0,100.0,100.0,0.0,89.39068100358423,89.39068100358423,0.0,Previsions
3487,0,2019-03-25,115026,FJORD NATURE 125GX8 OPL,1,0,0,FJORD,0,LeMolay(FR),0081,0024 FR TOURS (DC),1349,1395,1247,1247,0,148,148,0,46,-3.40993328391401,185,150,150,150,0,0,0,0,-35,18.91891891891892,100.0,100.0,0.0,89.39068100358423,89.39068100358423,0.0,Previsions
3488,0,2019-03-25,115026,FJORD NATURE 125GX8 OPL,1,0,0,FJORD,0,LeMolay(FR),0082,0024 FR VALLET (DC),1349,1395,1247,1247,0,148,148,0,46,-3.40993328391401,168,148,148,148,0,0,0,0,-20,11.904761904761905,100.0,100.0,0.0,89.39068100358423,89.39068100358423,0.0,Previsions
3489,0,2019-03-25,115026,FJORD NATURE 125GX8 OPL,1,0,0,FJORD,0,LeMolay(FR),0077,0024 FR LILPARK (DC),1349,1395,1247,1247,0,148,148,0,46,-3.40993328391401,77,76,76,76,0,0,0,0,-1,1.2987012987012987,100.0,100.0,0.0,89.39068100358423,89.39068100358423,0.0,Previsions
3490,0,2019-03-25,115026,FJORD NATURE 125GX8 OPL,1,0,0,FJORD,0,LeMolay(FR),0085,0024 FR TOULOUSE (DC),1349,1395,1247,1247,0,148,148,0,46,-3.40993328391401,159,159,159,159,0,0,0,0,0,0.0,100.0,100.0,0.0,89.39068100358423,89.39068100358423,0.0,Previsions
3491,0,2019-03-25,115026,FJORD NATURE 125GX8 OPL,1,0,0,FJORD,0,LeMolay(FR),0083,0024 FR CHAPONNAY (DC),1349,1395,1247,1247,0,148,148,0,46,-3.40993328391401,291,275,275,275,0,0,0,0,-16,5.498281786941581,100.0,100.0,0.0,89.39068100358423,89.39068100358423,0.0,Previsions
3492,0,2019-03-25,115026,FJORD NATURE 125GX8 OPL,1,0,0,FJORD,0,LeMolay(FR),0079,0024 FR PARIS SUD (DC),1349,1395,1247,1247,0,148,148,0,46,-3.40993328391401,98,214,66,66,0,148,148,0,116,-118.36734693877551,30.8411214953271,30.8411214953271,0.0,89.39068100358423,89.39068100358423,0.0,Previsions
3493,0,2019-03-25,115026,FJORD NATURE 125GX8 OPL,1,0,0,FJORD,0,LeMolay(FR),0078,0024 FR PARIS NORD (DC),1349,1395,1247,1247,0,148,148,0,46,-3.40993328391401,62,62,62,62,0,0,0,0,0,0.0,100.0,100.0,0.0,89.39068100358423,89.39068100358423,0.0,Previsions
3494,0,2019-03-25,139217,ALPRO SOJA VANILLA 500X1,0,0,0,ALPRO,1,Wevelgem(BE),0084,0024 FR AIX (DC),1107,915,825,825,0,90,90,0,-192,17.344173441734416,615,63,63,63,0,0,0,0,-552,89.7560975609756,100.0,100.0,0.0,90.1639344262295,90.1639344262295,0.0,A Creuser
3495,0,2019-03-25,139217,ALPRO SOJA VANILLA 500X1,0,0,0,ALPRO,1,Wevelgem(BE),0080,0024 FR METZ (DC),1107,915,825,825,0,90,90,0,-192,17.344173441734416,0,98,98,98,0,0,0,1,98,10000.0,100.0,100.0,0.0,90.1639344262295,90.1639344262295,0.0,A Creuser
3496,0,2019-03-25,139217,ALPRO SOJA VANILLA 500X1,0,0,0,ALPRO,1,Wevelgem(BE),0081,0024 FR TOURS (DC),1107,915,825,825,0,90,90,0,-192,17.344173441734416,161,102,102,102,0,0,0,0,-59,36.64596273291925,100.0,100.0,0.0,90.1639344262295,90.1639344262295,0.0,A Creuser
3497,0,2019-03-25,139217,ALPRO SOJA VANILLA 500X1,0,0,0,ALPRO,1,Wevelgem(BE),0082,0024 FR VALLET (DC),1107,915,825,825,0,90,90,0,-192,17.344173441734416,1,65,65,65,0,0,0,0,64,-6400.0,100.0,100.0,0.0,90.1639344262295,90.1639344262295,0.0,A Creuser
3498,0,2019-03-25,139217,ALPRO SOJA VANILLA 500X1,0,0,0,ALPRO,1,Wevelgem(BE),0077,0024 FR LILPARK (DC),1107,915,825,825,0,90,90,0,-192,17.344173441734416,0,45,45,45,0,0,0,1,45,10000.0,100.0,100.0,0.0,90.1639344262295,90.1639344262295,0.0,A Creuser
3499,0,2019-03-25,139217,ALPRO SOJA VANILLA 500X1,0,0,0,ALPRO,1,Wevelgem(BE),0085,0024 FR TOULOUSE (DC),1107,915,825,825,0,90,90,0,-192,17.344173441734416,2,109,19,19,0,90,90,0,107,-5350.0,17.431192660550458,17.431192660550458,0.0,90.1639344262295,90.1639344262295,0.0,A Creuser
3500,0,2019-03-25,139217,ALPRO SOJA VANILLA 500X1,0,0,0,ALPRO,1,Wevelgem(BE),0083,0024 FR CHAPONNAY (DC),1107,915,825,825,0,90,90,0,-192,17.344173441734416,203,138,138,138,0,0,0,0,-65,32.01970443349754,100.0,100.0,0.0,90.1639344262295,90.1639344262295,0.0,A Creuser
3501,0,2019-03-25,139217,ALPRO SOJA VANILLA 500X1,0,0,0,ALPRO,1,Wevelgem(BE),0079,0024 FR PARIS SUD (DC),1107,915,825,825,0,90,90,0,-192,17.344173441734416,0,110,110,110,0,0,0,1,110,10000.0,100.0,100.0,0.0,90.1639344262295,90.1639344262295,0.0,A Creuser
3502,0,2019-03-25,139217,ALPRO SOJA VANILLA 500X1,0,0,0,ALPRO,1,Wevelgem(BE),0078,0024 FR PARIS NORD (DC),1107,915,825,825,0,90,90,0,-192,17.344173441734416,125,185,185,185,0,0,0,0,60,-48.0,100.0,100.0,0.0,90.1639344262295,90.1639344262295,0.0,A Creuser
3503,0,2019-03-25,141606,ACTIVIA BIO PLAIN 6X460G FR,0,0,0,ACTIVIA,1,Bierun(PL),0084,0024 FR AIX (DC),604,318,73,5,68,313,245,0,-286,47.35099337748344,1,3,3,0,3,3,0,0,2,-200.0,100.0,0.0,100.0,22.955974842767297,1.5723270440251573,21.38364779874214,Schéma
3504,0,2019-03-25,141606,ACTIVIA BIO PLAIN 6X460G FR,0,0,0,ACTIVIA,1,Bierun(PL),0080,0024 FR METZ (DC),604,318,73,5,68,313,245,0,-286,47.35099337748344,9,1,1,0,1,1,0,0,-8,88.88888888888889,100.0,0.0,100.0,22.955974842767297,1.5723270440251573,21.38364779874214,Schéma
3505,0,2019-03-25,141606,ACTIVIA BIO PLAIN 6X460G FR,0,0,0,ACTIVIA,1,Bierun(PL),0081,0024 FR TOURS (DC),604,318,73,5,68,313,245,0,-286,47.35099337748344,5,11,4,0,4,11,7,0,6,-120.0,36.36363636363637,0.0,36.36363636363637,22.955974842767297,1.5723270440251573,21.38364779874214,Schéma
3506,0,2019-03-25,141606,ACTIVIA BIO PLAIN 6X460G FR,0,0,0,ACTIVIA,1,Bierun(PL),0082,0024 FR VALLET (DC),604,318,73,5,68,313,245,0,-286,47.35099337748344,4,8,8,0,8,8,0,0,4,-100.0,100.0,0.0,100.0,22.955974842767297,1.5723270440251573,21.38364779874214,Schéma
3507,0,2019-03-25,141606,ACTIVIA BIO PLAIN 6X460G FR,0,0,0,ACTIVIA,1,Bierun(PL),0083,0024 FR CHAPONNAY (DC),604,318,73,5,68,313,245,0,-286,47.35099337748344,9,5,5,5,0,0,0,0,-4,44.44444444444444,100.0,100.0,0.0,22.955974842767297,1.5723270440251573,21.38364779874214,Schéma
3508,0,2019-03-25,141606,ACTIVIA BIO PLAIN 6X460G FR,0,0,0,ACTIVIA,1,Bierun(PL),0078,0024 FR PARIS NORD (DC),604,318,73,5,68,313,245,0,-286,47.35099337748344,288,290,52,0,52,290,238,0,2,-0.6944444444444444,17.93103448275862,0.0,17.93103448275862,22.955974842767297,1.5723270440251573,21.38364779874214,Schéma
3509,1,2019-03-25,141606,ACTIVIA BIO PLAIN 6X460G FR,0,0,0,ACTIVIA,1,Bierun(PL),0078,0024 FR PARIS NORD (DC),604,318,73,5,68,313,245,0,-286,47.35099337748344,288,290,52,0,52,290,238,0,2,-0.6944444444444444,17.93103448275862,0.0,17.93103448275862,22.955974842767297,1.5723270440251573,21.38364779874214,Schéma
3510,0,2019-03-26,81988,GERVITA COCO 100X4,0,0,0,GERVITA,0,Ferrières(FR),0084,0024 FR AIX (DC),456,845,764,709,55,136,81,0,389,-85.30701754385964,63,81,81,81,0,0,0,0,18,-28.571428571428573,100.0,100.0,0.0,90.41420118343196,83.90532544378698,6.508875739644978,Production
3511,0,2019-03-26,81988,GERVITA COCO 100X4,0,0,0,GERVITA,0,Ferrières(FR),0080,0024 FR METZ (DC),456,845,764,709,55,136,81,0,389,-85.30701754385964,24,30,30,30,0,0,0,0,6,-25.0,100.0,100.0,0.0,90.41420118343196,83.90532544378698,6.508875739644978,Production
3512,0,2019-03-26,81988,GERVITA COCO 100X4,0,0,0,GERVITA,0,Ferrières(FR),0081,0024 FR TOURS (DC),456,845,764,709,55,136,81,0,389,-85.30701754385964,40,69,69,69,0,0,0,0,29,-72.5,100.0,100.0,0.0,90.41420118343196,83.90532544378698,6.508875739644978,Production
3513,0,2019-03-26,81988,GERVITA COCO 100X4,0,0,0,GERVITA,0,Ferrières(FR),0082,0024 FR VALLET (DC),456,845,764,709,55,136,81,0,389,-85.30701754385964,15,34,34,34,0,0,0,0,19,-126.66666666666667,100.0,100.0,0.0,90.41420118343196,83.90532544378698,6.508875739644978,Production
3514,0,2019-03-26,81988,GERVITA COCO 100X4,0,0,0,GERVITA,0,Ferrières(FR),0077,0024 FR LILPARK (DC),456,845,764,709,55,136,81,0,389,-85.30701754385964,79,136,55,0,55,136,81,0,57,-72.15189873417721,40.44117647058824,0.0,40.44117647058824,90.41420118343196,83.90532544378698,6.508875739644978,Production
3515,0,2019-03-26,81988,GERVITA COCO 100X4,0,0,0,GERVITA,0,Ferrières(FR),0085,0024 FR TOULOUSE (DC),456,845,764,709,55,136,81,0,389,-85.30701754385964,54,117,117,117,0,0,0,0,63,-116.66666666666667,100.0,100.0,0.0,90.41420118343196,83.90532544378698,6.508875739644978,Production
3516,0,2019-03-26,81988,GERVITA COCO 100X4,0,0,0,GERVITA,0,Ferrières(FR),0083,0024 FR CHAPONNAY (DC),456,845,764,709,55,136,81,0,389,-85.30701754385964,28,27,27,27,0,0,0,0,-1,3.5714285714285716,100.0,100.0,0.0,90.41420118343196,83.90532544378698,6.508875739644978,Production
3517,0,2019-03-26,81988,GERVITA COCO 100X4,0,0,0,GERVITA,0,Ferrières(FR),0079,0024 FR PARIS SUD (DC),456,845,764,709,55,136,81,0,389,-85.30701754385964,79,159,159,159,0,0,0,0,80,-101.26582278481013,100.0,100.0,0.0,90.41420118343196,83.90532544378698,6.508875739644978,Production
3518,0,2019-03-26,81988,GERVITA COCO 100X4,0,0,0,GERVITA,0,Ferrières(FR),0078,0024 FR PARIS NORD (DC),456,845,764,709,55,136,81,0,389,-85.30701754385964,74,192,192,192,0,0,0,0,118,-159.45945945945945,100.0,100.0,0.0,90.41420118343196,83.90532544378698,6.508875739644978,Production
3519,0,2019-03-26,83924,ACTIMEL STRA 3x(14x100g) FR,0,0,0,ACTIMEL,1,Rotselaar(BE),0082,0024 FR VALLET (DC),42,33,5,0,5,33,28,0,-9,21.428571428571427,42,33,5,0,5,33,28,0,-9,21.428571428571427,15.151515151515152,0.0,15.151515151515152,15.151515151515152,0.0,15.151515151515152,Previsions
3520,0,2019-03-26,139211,ALPRO SOJA RASPB CRANB 150X1,0,0,0,ALPRO,1,Wevelgem(BE),0077,0024 FR LILPARK (DC),7,7,3,3,0,4,4,0,0,0.0,7,7,3,3,0,4,4,0,0,0.0,42.857142857142854,42.857142857142854,0.0,42.857142857142854,42.857142857142854,0.0,Client
3521,0,2019-03-26,139216,ALPRO SOJA COCONUT 500X1,0,0,0,ALPRO,1,Wevelgem(BE),0084,0024 FR AIX (DC),740,696,696,695,1,1,0,0,-44,5.945945945945946,188,131,131,131,0,0,0,0,-57,30.319148936170212,100.0,100.0,0.0,100.0,99.85632183908046,0.143678160919535,A Creuser
3522,0,2019-03-26,139216,ALPRO SOJA COCONUT 500X1,0,0,0,ALPRO,1,Wevelgem(BE),0080,0024 FR METZ (DC),740,696,696,695,1,1,0,0,-44,5.945945945945946,23,36,36,36,0,0,0,0,13,-56.52173913043478,100.0,100.0,0.0,100.0,99.85632183908046,0.143678160919535,A Creuser
3523,0,2019-03-26,139216,ALPRO SOJA COCONUT 500X1,0,0,0,ALPRO,1,Wevelgem(BE),0081,0024 FR TOURS (DC),740,696,696,695,1,1,0,0,-44,5.945945945945946,48,58,58,58,0,0,0,0,10,-20.833333333333332,100.0,100.0,0.0,100.0,99.85632183908046,0.143678160919535,A Creuser
3524,0,2019-03-26,139216,ALPRO SOJA COCONUT 500X1,0,0,0,ALPRO,1,Wevelgem(BE),0082,0024 FR VALLET (DC),740,696,696,695,1,1,0,0,-44,5.945945945945946,52,61,61,61,0,0,0,0,9,-17.307692307692307,100.0,100.0,0.0,100.0,99.85632183908046,0.143678160919535,A Creuser
3525,0,2019-03-26,139216,ALPRO SOJA COCONUT 500X1,0,0,0,ALPRO,1,Wevelgem(BE),0077,0024 FR LILPARK (DC),740,696,696,695,1,1,0,0,-44,5.945945945945946,55,67,67,66,1,1,0,0,12,-21.818181818181817,100.0,98.50746268656717,1.492537313432834,100.0,99.85632183908046,0.143678160919535,A Creuser
3526,0,2019-03-26,139216,ALPRO SOJA COCONUT 500X1,0,0,0,ALPRO,1,Wevelgem(BE),0083,0024 FR CHAPONNAY (DC),740,696,696,695,1,1,0,0,-44,5.945945945945946,96,90,90,90,0,0,0,0,-6,6.25,100.0,100.0,0.0,100.0,99.85632183908046,0.143678160919535,A Creuser
3527,0,2019-03-26,139216,ALPRO SOJA COCONUT 500X1,0,0,0,ALPRO,1,Wevelgem(BE),0079,0024 FR PARIS SUD (DC),740,696,696,695,1,1,0,0,-44,5.945945945945946,171,194,194,194,0,0,0,0,23,-13.450292397660819,100.0,100.0,0.0,100.0,99.85632183908046,0.143678160919535,A Creuser
3528,0,2019-03-26,139216,ALPRO SOJA COCONUT 500X1,0,0,0,ALPRO,1,Wevelgem(BE),0078,0024 FR PARIS NORD (DC),740,696,696,695,1,1,0,0,-44,5.945945945945946,107,59,59,59,0,0,0,0,-48,44.85981308411215,100.0,100.0,0.0,100.0,99.85632183908046,0.143678160919535,A Creuser
3529,0,2019-03-26,142727,ACTIVIA SAV VAN FRAM 125X12+4,0,0,0,ACTIVIA,0,Bailleul(FR),0084,0024 FR AIX (DC),821,995,797,788,9,207,198,0,174,-21.193666260657736,43,99,88,87,1,12,11,0,56,-130.2325581395349,88.88888888888889,87.87878787878788,1.0101010101010104,80.10050251256281,79.19597989949749,0.9045226130653248,Client
3530,0,2019-03-26,142727,ACTIVIA SAV VAN FRAM 125X12+4,0,0,0,ACTIVIA,0,Bailleul(FR),0080,0024 FR METZ (DC),821,995,797,788,9,207,198,0,174,-21.193666260657736,93,75,75,75,0,0,0,0,-18,19.35483870967742,100.0,100.0,0.0,80.10050251256281,79.19597989949749,0.9045226130653248,Client
3531,0,2019-03-26,142727,ACTIVIA SAV VAN FRAM 125X12+4,0,0,0,ACTIVIA,0,Bailleul(FR),0081,0024 FR TOURS (DC),821,995,797,788,9,207,198,0,174,-21.193666260657736,94,56,56,56,0,0,0,0,-38,40.42553191489362,100.0,100.0,0.0,80.10050251256281,79.19597989949749,0.9045226130653248,Client
3532,0,2019-03-26,142727,ACTIVIA SAV VAN FRAM 125X12+4,0,0,0,ACTIVIA,0,Bailleul(FR),0077,0024 FR LILPARK (DC),821,995,797,788,9,207,198,0,174,-21.193666260657736,169,245,98,90,8,155,147,0,76,-44.97041420118343,40.0,36.734693877551024,3.265306122448976,80.10050251256281,79.19597989949749,0.9045226130653248,Client
3533,0,2019-03-26,142727,ACTIVIA SAV VAN FRAM 125X12+4,0,0,0,ACTIVIA,0,Bailleul(FR),0085,0024 FR TOULOUSE (DC),821,995,797,788,9,207,198,0,174,-21.193666260657736,56,81,81,81,0,0,0,0,25,-44.642857142857146,100.0,100.0,0.0,80.10050251256281,79.19597989949749,0.9045226130653248,Client
3534,0,2019-03-26,142727,ACTIVIA SAV VAN FRAM 125X12+4,0,0,0,ACTIVIA,0,Bailleul(FR),0083,0024 FR CHAPONNAY (DC),821,995,797,788,9,207,198,0,174,-21.193666260657736,140,150,150,150,0,0,0,0,10,-7.142857142857143,100.0,100.0,0.0,80.10050251256281,79.19597989949749,0.9045226130653248,Client
3535,0,2019-03-26,142727,ACTIVIA SAV VAN FRAM 125X12+4,0,0,0,ACTIVIA,0,Bailleul(FR),0079,0024 FR PARIS SUD (DC),821,995,797,788,9,207,198,0,174,-21.193666260657736,131,165,165,165,0,0,0,0,34,-25.954198473282442,100.0,100.0,0.0,80.10050251256281,79.19597989949749,0.9045226130653248,Client
3536,0,2019-03-26,142727,ACTIVIA SAV VAN FRAM 125X12+4,0,0,0,ACTIVIA,0,Bailleul(FR),0078,0024 FR PARIS NORD (DC),821,995,797,788,9,207,198,0,174,-21.193666260657736,95,124,84,84,0,40,40,0,29,-30.526315789473685,67.74193548387096,67.74193548387096,0.0,80.10050251256281,79.19597989949749,0.9045226130653248,Client
3537,0,2019-03-27,120836,DANONE ARO PANACHE 125X4 AFH,0,0,1,DANONE,0,Bailleul(FR),0084,0024 FR AIX (DC),3462,3547,3394,3394,0,153,153,0,85,-2.455228191796649,584,243,243,243,0,0,0,0,-341,58.39041095890411,100.0,100.0,0.0,95.68649563010995,95.68649563010995,0.0,Previsions
3538,0,2019-03-27,120836,DANONE ARO PANACHE 125X4 AFH,0,0,1,DANONE,0,Bailleul(FR),0080,0024 FR METZ (DC),3462,3547,3394,3394,0,153,153,0,85,-2.455228191796649,26,261,261,261,0,0,0,0,235,-903.8461538461538,100.0,100.0,0.0,95.68649563010995,95.68649563010995,0.0,Previsions
3539,0,2019-03-27,120836,DANONE ARO PANACHE 125X4 AFH,0,0,1,DANONE,0,Bailleul(FR),0081,0024 FR TOURS (DC),3462,3547,3394,3394,0,153,153,0,85,-2.455228191796649,199,253,253,253,0,0,0,0,54,-27.1356783919598,100.0,100.0,0.0,95.68649563010995,95.68649563010995,0.0,Previsions
3540,0,2019-03-27,120836,DANONE ARO PANACHE 125X4 AFH,0,0,1,DANONE,0,Bailleul(FR),0082,0024 FR VALLET (DC),3462,3547,3394,3394,0,153,153,0,85,-2.455228191796649,280,304,304,304,0,0,0,0,24,-8.571428571428571,100.0,100.0,0.0,95.68649563010995,95.68649563010995,0.0,Previsions
3541,0,2019-03-27,120836,DANONE ARO PANACHE 125X4 AFH,0,0,1,DANONE,0,Bailleul(FR),0077,0024 FR LILPARK (DC),3462,3547,3394,3394,0,153,153,0,85,-2.455228191796649,434,354,354,354,0,0,0,0,-80,18.433179723502302,100.0,100.0,0.0,95.68649563010995,95.68649563010995,0.0,Previsions
3542,0,2019-03-27,120836,DANONE ARO PANACHE 125X4 AFH,0,0,1,DANONE,0,Bailleul(FR),0085,0024 FR TOULOUSE (DC),3462,3547,3394,3394,0,153,153,0,85,-2.455228191796649,293,116,116,116,0,0,0,0,-177,60.40955631399317,100.0,100.0,0.0,95.68649563010995,95.68649563010995,0.0,Previsions
3543,0,2019-03-27,120836,DANONE ARO PANACHE 125X4 AFH,0,0,1,DANONE,0,Bailleul(FR),0083,0024 FR CHAPONNAY (DC),3462,3547,3394,3394,0,153,153,0,85,-2.455228191796649,591,864,711,711,0,153,153,0,273,-46.192893401015226,82.29166666666666,82.29166666666666,0.0,95.68649563010995,95.68649563010995,0.0,Previsions
3544,0,2019-03-27,120836,DANONE ARO PANACHE 125X4 AFH,0,0,1,DANONE,0,Bailleul(FR),0079,0024 FR PARIS SUD (DC),3462,3547,3394,3394,0,153,153,0,85,-2.455228191796649,435,396,396,396,0,0,0,0,-39,8.96551724137931,100.0,100.0,0.0,95.68649563010995,95.68649563010995,0.0,Previsions
3545,0,2019-03-27,120836,DANONE ARO PANACHE 125X4 AFH,0,0,1,DANONE,0,Bailleul(FR),0078,0024 FR PARIS NORD (DC),3462,3547,3394,3394,0,153,153,0,85,-2.455228191796649,620,756,756,756,0,0,0,0,136,-21.93548387096774,100.0,100.0,0.0,95.68649563010995,95.68649563010995,0.0,Previsions
3546,0,2019-03-27,121523,TAILLEFINE FRT RASPBERRY 125X4,0,0,0,TAILLEFINE,0,Villecomtal(FR),0084,0024 FR AIX (DC),186,370,245,243,2,127,125,0,184,-98.9247311827957,20,30,30,30,0,0,0,0,10,-50.0,100.0,100.0,0.0,66.21621621621621,65.67567567567568,0.5405405405405332,Previsions
3547,0,2019-03-27,121523,TAILLEFINE FRT RASPBERRY 125X4,0,0,0,TAILLEFINE,0,Villecomtal(FR),0080,0024 FR METZ (DC),186,370,245,243,2,127,125,0,184,-98.9247311827957,30,24,24,24,0,0,0,0,-6,20.0,100.0,100.0,0.0,66.21621621621621,65.67567567567568,0.5405405405405332,Previsions
3548,0,2019-03-27,121523,TAILLEFINE FRT RASPBERRY 125X4,0,0,0,TAILLEFINE,0,Villecomtal(FR),0081,0024 FR TOURS (DC),186,370,245,243,2,127,125,0,184,-98.9247311827957,9,13,13,13,0,0,0,0,4,-44.44444444444444,100.0,100.0,0.0,66.21621621621621,65.67567567567568,0.5405405405405332,Previsions
3549,0,2019-03-27,121523,TAILLEFINE FRT RASPBERRY 125X4,0,0,0,TAILLEFINE,0,Villecomtal(FR),0082,0024 FR VALLET (DC),186,370,245,243,2,127,125,0,184,-98.9247311827957,22,29,6,4,2,25,23,0,7,-31.818181818181817,20.689655172413794,13.793103448275861,6.896551724137932,66.21621621621621,65.67567567567568,0.5405405405405332,Previsions
3550,0,2019-03-27,121523,TAILLEFINE FRT RASPBERRY 125X4,0,0,0,TAILLEFINE,0,Villecomtal(FR),0077,0024 FR LILPARK (DC),186,370,245,243,2,127,125,0,184,-98.9247311827957,18,22,22,22,0,0,0,0,4,-22.22222222222222,100.0,100.0,0.0,66.21621621621621,65.67567567567568,0.5405405405405332,Previsions
3551,0,2019-03-27,121523,TAILLEFINE FRT RASPBERRY 125X4,0,0,0,TAILLEFINE,0,Villecomtal(FR),0085,0024 FR TOULOUSE (DC),186,370,245,243,2,127,125,0,184,-98.9247311827957,19,28,25,25,0,3,3,0,9,-47.36842105263158,89.28571428571429,89.28571428571429,0.0,66.21621621621621,65.67567567567568,0.5405405405405332,Previsions
3552,0,2019-03-27,121523,TAILLEFINE FRT RASPBERRY 125X4,0,0,0,TAILLEFINE,0,Villecomtal(FR),0083,0024 FR CHAPONNAY (DC),186,370,245,243,2,127,125,0,184,-98.9247311827957,11,13,13,13,0,0,0,0,2,-18.181818181818183,100.0,100.0,0.0,66.21621621621621,65.67567567567568,0.5405405405405332,Previsions
3553,0,2019-03-27,121523,TAILLEFINE FRT RASPBERRY 125X4,0,0,0,TAILLEFINE,0,Villecomtal(FR),0079,0024 FR PARIS SUD (DC),186,370,245,243,2,127,125,0,184,-98.9247311827957,37,85,85,85,0,0,0,0,48,-129.72972972972974,100.0,100.0,0.0,66.21621621621621,65.67567567567568,0.5405405405405332,Previsions
3554,0,2019-03-27,121523,TAILLEFINE FRT RASPBERRY 125X4,0,0,0,TAILLEFINE,0,Villecomtal(FR),0078,0024 FR PARIS NORD (DC),186,370,245,243,2,127,125,0,184,-98.9247311827957,20,126,27,27,0,99,99,0,106,-530.0,21.428571428571427,21.428571428571427,0.0,66.21621621621621,65.67567567567568,0.5405405405405332,Previsions
3555,0,2019-03-27,135358,TAILLEFINE YELLOW FRUIT 125X8 D,0,0,0,TAILLEFINE,0,Villecomtal(FR),0080,0024 FR METZ (DC),469,360,272,123,149,237,88,0,-109,23.240938166311302,90,45,45,5,40,40,0,0,-45,50.0,100.0,11.11111111111111,88.88888888888889,75.55555555555556,34.166666666666664,41.38888888888889,Previsions
3556,0,2019-03-27,135358,TAILLEFINE YELLOW FRUIT 125X8 D,0,0,0,TAILLEFINE,0,Villecomtal(FR),0081,0024 FR TOURS (DC),469,360,272,123,149,237,88,0,-109,23.240938166311302,136,135,135,26,109,109,0,0,-1,0.7352941176470589,100.0,19.25925925925926,80.74074074074073,75.55555555555556,34.166666666666664,41.38888888888889,Previsions
3557,0,2019-03-27,135358,TAILLEFINE YELLOW FRUIT 125X8 D,0,0,0,TAILLEFINE,0,Villecomtal(FR),0082,0024 FR VALLET (DC),469,360,272,123,149,237,88,0,-109,23.240938166311302,88,45,45,45,0,0,0,0,-43,48.86363636363637,100.0,100.0,0.0,75.55555555555556,34.166666666666664,41.38888888888889,Previsions
3558,0,2019-03-27,135358,TAILLEFINE YELLOW FRUIT 125X8 D,0,0,0,TAILLEFINE,0,Villecomtal(FR),0077,0024 FR LILPARK (DC),469,360,272,123,149,237,88,0,-109,23.240938166311302,108,45,13,13,0,32,32,0,-63,58.333333333333336,28.888888888888886,28.888888888888886,0.0,75.55555555555556,34.166666666666664,41.38888888888889,Previsions
3559,0,2019-03-27,135358,TAILLEFINE YELLOW FRUIT 125X8 D,0,0,0,TAILLEFINE,0,Villecomtal(FR),0083,0024 FR CHAPONNAY (DC),469,360,272,123,149,237,88,0,-109,23.240938166311302,47,90,34,34,0,56,56,0,43,-91.48936170212765,37.77777777777778,37.77777777777778,0.0,75.55555555555556,34.166666666666664,41.38888888888889,Previsions
3560,0,2019-03-27,139217,ALPRO SOJA VANILLA 500X1,0,0,0,ALPRO,1,Wevelgem(BE),0084,0024 FR AIX (DC),1134,880,755,755,0,125,125,0,-254,22.39858906525573,119,98,98,98,0,0,0,0,-21,17.647058823529413,100.0,100.0,0.0,85.79545454545455,85.79545454545455,0.0,A Creuser
3561,0,2019-03-27,139217,ALPRO SOJA VANILLA 500X1,0,0,0,ALPRO,1,Wevelgem(BE),0080,0024 FR METZ (DC),1134,880,755,755,0,125,125,0,-254,22.39858906525573,101,85,85,85,0,0,0,0,-16,15.841584158415841,100.0,100.0,0.0,85.79545454545455,85.79545454545455,0.0,A Creuser
3562,0,2019-03-27,139217,ALPRO SOJA VANILLA 500X1,0,0,0,ALPRO,1,Wevelgem(BE),0081,0024 FR TOURS (DC),1134,880,755,755,0,125,125,0,-254,22.39858906525573,90,72,72,72,0,0,0,0,-18,20.0,100.0,100.0,0.0,85.79545454545455,85.79545454545455,0.0,A Creuser
3563,0,2019-03-27,139217,ALPRO SOJA VANILLA 500X1,0,0,0,ALPRO,1,Wevelgem(BE),0082,0024 FR VALLET (DC),1134,880,755,755,0,125,125,0,-254,22.39858906525573,207,100,100,100,0,0,0,0,-107,51.690821256038646,100.0,100.0,0.0,85.79545454545455,85.79545454545455,0.0,A Creuser
3564,0,2019-03-27,139217,ALPRO SOJA VANILLA 500X1,0,0,0,ALPRO,1,Wevelgem(BE),0077,0024 FR LILPARK (DC),1134,880,755,755,0,125,125,0,-254,22.39858906525573,55,46,46,46,0,0,0,0,-9,16.363636363636363,100.0,100.0,0.0,85.79545454545455,85.79545454545455,0.0,A Creuser
3565,0,2019-03-27,139217,ALPRO SOJA VANILLA 500X1,0,0,0,ALPRO,1,Wevelgem(BE),0085,0024 FR TOULOUSE (DC),1134,880,755,755,0,125,125,0,-254,22.39858906525573,133,163,66,66,0,97,97,0,30,-22.55639097744361,40.49079754601227,40.49079754601227,0.0,85.79545454545455,85.79545454545455,0.0,A Creuser
3566,0,2019-03-27,139217,ALPRO SOJA VANILLA 500X1,0,0,0,ALPRO,1,Wevelgem(BE),0083,0024 FR CHAPONNAY (DC),1134,880,755,755,0,125,125,0,-254,22.39858906525573,201,141,114,114,0,27,27,0,-60,29.850746268656717,80.85106382978722,80.85106382978722,0.0,85.79545454545455,85.79545454545455,0.0,A Creuser
3567,0,2019-03-27,139217,ALPRO SOJA VANILLA 500X1,0,0,0,ALPRO,1,Wevelgem(BE),0079,0024 FR PARIS SUD (DC),1134,880,755,755,0,125,125,0,-254,22.39858906525573,125,91,90,90,0,1,1,0,-34,27.2,98.9010989010989,98.9010989010989,0.0,85.79545454545455,85.79545454545455,0.0,A Creuser
3568,0,2019-03-27,139217,ALPRO SOJA VANILLA 500X1,0,0,0,ALPRO,1,Wevelgem(BE),0078,0024 FR PARIS NORD (DC),1134,880,755,755,0,125,125,0,-254,22.39858906525573,103,84,84,84,0,0,0,0,-19,18.446601941747574,100.0,100.0,0.0,85.79545454545455,85.79545454545455,0.0,A Creuser
3569,0,2019-03-29,107076,LES 2 VACHES VANILLA 115X4,0,0,0,LES 2 VACHES,0,LeMolay(FR),0084,0024 FR AIX (DC),5421,3845,3231,3231,0,614,614,0,-1576,29.072126913853534,576,433,433,433,0,0,0,0,-143,24.82638888888889,100.0,100.0,0.0,84.03120936280885,84.03120936280885,0.0,Previsions
3570,0,2019-03-29,107076,LES 2 VACHES VANILLA 115X4,0,0,0,LES 2 VACHES,0,LeMolay(FR),0080,0024 FR METZ (DC),5421,3845,3231,3231,0,614,614,0,-1576,29.072126913853534,239,178,158,158,0,20,20,0,-61,25.523012552301257,88.76404494382022,88.76404494382022,0.0,84.03120936280885,84.03120936280885,0.0,Previsions
3571,0,2019-03-29,107076,LES 2 VACHES VANILLA 115X4,0,0,0,LES 2 VACHES,0,LeMolay(FR),0081,0024 FR TOURS (DC),5421,3845,3231,3231,0,614,614,0,-1576,29.072126913853534,722,524,524,524,0,0,0,0,-198,27.42382271468144,100.0,100.0,0.0,84.03120936280885,84.03120936280885,0.0,Previsions
3572,0,2019-03-29,107076,LES 2 VACHES VANILLA 115X4,0,0,0,LES 2 VACHES,0,LeMolay(FR),0082,0024 FR VALLET (DC),5421,3845,3231,3231,0,614,614,0,-1576,29.072126913853534,561,357,340,340,0,17,17,0,-204,36.36363636363637,95.23809523809523,95.23809523809523,0.0,84.03120936280885,84.03120936280885,0.0,Previsions
3573,0,2019-03-29,107076,LES 2 VACHES VANILLA 115X4,0,0,0,LES 2 VACHES,0,LeMolay(FR),0077,0024 FR LILPARK (DC),5421,3845,3231,3231,0,614,614,0,-1576,29.072126913853534,318,241,123,123,0,118,118,0,-77,24.21383647798742,51.037344398340245,51.037344398340245,0.0,84.03120936280885,84.03120936280885,0.0,Previsions
3574,0,2019-03-29,107076,LES 2 VACHES VANILLA 115X4,0,0,0,LES 2 VACHES,0,LeMolay(FR),0085,0024 FR TOULOUSE (DC),5421,3845,3231,3231,0,614,614,0,-1576,29.072126913853534,857,727,727,727,0,0,0,0,-130,15.169194865810969,100.0,100.0,0.0,84.03120936280885,84.03120936280885,0.0,Previsions
3575,0,2019-03-29,107076,LES 2 VACHES VANILLA 115X4,0,0,0,LES 2 VACHES,0,LeMolay(FR),0083,0024 FR CHAPONNAY (DC),5421,3845,3231,3231,0,614,614,0,-1576,29.072126913853534,735,354,354,354,0,0,0,0,-381,51.83673469387755,100.0,100.0,0.0,84.03120936280885,84.03120936280885,0.0,Previsions
3576,0,2019-03-29,107076,LES 2 VACHES VANILLA 115X4,0,0,0,LES 2 VACHES,0,LeMolay(FR),0079,0024 FR PARIS SUD (DC),5421,3845,3231,3231,0,614,614,0,-1576,29.072126913853534,932,618,312,312,0,306,306,0,-314,33.69098712446352,50.48543689320388,50.48543689320388,0.0,84.03120936280885,84.03120936280885,0.0,Previsions
3577,0,2019-03-29,107076,LES 2 VACHES VANILLA 115X4,0,0,0,LES 2 VACHES,0,LeMolay(FR),0078,0024 FR PARIS NORD (DC),5421,3845,3231,3231,0,614,614,0,-1576,29.072126913853534,481,413,260,260,0,153,153,0,-68,14.137214137214137,62.95399515738499,62.95399515738499,0.0,84.03120936280885,84.03120936280885,0.0,Previsions
3578,0,2019-03-29,140870,ACTIVIA BIO NATURE 125X8,0,0,0,ACTIVIA,0,Bailleul(FR),0084,0024 FR AIX (DC),842,781,223,222,1,559,558,0,-61,7.244655581947743,35,35,35,35,0,0,0,0,0,0.0,100.0,100.0,0.0,28.55313700384123,28.425096030729836,0.12804097311139273,Previsions
3579,0,2019-03-29,140870,ACTIVIA BIO NATURE 125X8,0,0,0,ACTIVIA,0,Bailleul(FR),0080,0024 FR METZ (DC),842,781,223,222,1,559,558,0,-61,7.244655581947743,21,15,15,15,0,0,0,0,-6,28.571428571428573,100.0,100.0,0.0,28.55313700384123,28.425096030729836,0.12804097311139273,Previsions
3580,0,2019-03-29,140870,ACTIVIA BIO NATURE 125X8,0,0,0,ACTIVIA,0,Bailleul(FR),0081,0024 FR TOURS (DC),842,781,223,222,1,559,558,0,-61,7.244655581947743,38,41,41,41,0,0,0,0,3,-7.894736842105263,100.0,100.0,0.0,28.55313700384123,28.425096030729836,0.12804097311139273,Previsions
3581,0,2019-03-29,140870,ACTIVIA BIO NATURE 125X8,0,0,0,ACTIVIA,0,Bailleul(FR),0082,0024 FR VALLET (DC),842,781,223,222,1,559,558,0,-61,7.244655581947743,81,16,16,16,0,0,0,0,-65,80.24691358024691,100.0,100.0,0.0,28.55313700384123,28.425096030729836,0.12804097311139273,Previsions
3582,0,2019-03-29,140870,ACTIVIA BIO NATURE 125X8,0,0,0,ACTIVIA,0,Bailleul(FR),0077,0024 FR LILPARK (DC),842,781,223,222,1,559,558,0,-61,7.244655581947743,84,92,38,38,0,54,54,0,8,-9.523809523809524,41.30434782608695,41.30434782608695,0.0,28.55313700384123,28.425096030729836,0.12804097311139273,Previsions
3583,0,2019-03-29,140870,ACTIVIA BIO NATURE 125X8,0,0,0,ACTIVIA,0,Bailleul(FR),0085,0024 FR TOULOUSE (DC),842,781,223,222,1,559,558,0,-61,7.244655581947743,170,176,3,3,0,173,173,0,6,-3.5294117647058822,1.7045454545454544,1.7045454545454544,0.0,28.55313700384123,28.425096030729836,0.12804097311139273,Previsions
3584,0,2019-03-29,140870,ACTIVIA BIO NATURE 125X8,0,0,0,ACTIVIA,0,Bailleul(FR),0083,0024 FR CHAPONNAY (DC),842,781,223,222,1,559,558,0,-61,7.244655581947743,184,176,36,36,0,140,140,0,-8,4.3478260869565215,20.454545454545457,20.454545454545457,0.0,28.55313700384123,28.425096030729836,0.12804097311139273,Previsions
3585,0,2019-03-29,140870,ACTIVIA BIO NATURE 125X8,0,0,0,ACTIVIA,0,Bailleul(FR),0079,0024 FR PARIS SUD (DC),842,781,223,222,1,559,558,0,-61,7.244655581947743,112,120,15,14,1,106,105,0,8,-7.142857142857143,12.5,11.666666666666666,0.8333333333333339,28.55313700384123,28.425096030729836,0.12804097311139273,Previsions
3586,0,2019-03-29,140870,ACTIVIA BIO NATURE 125X8,0,0,0,ACTIVIA,0,Bailleul(FR),0078,0024 FR PARIS NORD (DC),842,781,223,222,1,559,558,0,-61,7.244655581947743,117,110,24,24,0,86,86,0,-7,5.982905982905983,21.818181818181817,21.818181818181817,0.0,28.55313700384123,28.425096030729836,0.12804097311139273,Previsions
3587,0,2019-03-29,141897,DANET LIEG CHOCO 100X8 PC,0,1,0,DANETTE,0,StJust(FR),0084,0024 FR AIX (DC),2422,2515,2035,1924,111,591,480,0,93,-3.8398018166804295,157,159,121,118,3,41,38,0,2,-1.2738853503184713,76.10062893081762,74.21383647798741,1.886792452830207,80.9145129224652,76.50099403578528,4.413518886679924,Production
3588,0,2019-03-29,141897,DANET LIEG CHOCO 100X8 PC,0,1,0,DANETTE,0,StJust(FR),0080,0024 FR METZ (DC),2422,2515,2035,1924,111,591,480,0,93,-3.8398018166804295,37,16,16,16,0,0,0,0,-21,56.75675675675676,100.0,100.0,0.0,80.9145129224652,76.50099403578528,4.413518886679924,Production
3589,0,2019-03-29,141897,DANET LIEG CHOCO 100X8 PC,0,1,0,DANETTE,0,StJust(FR),0081,0024 FR TOURS (DC),2422,2515,2035,1924,111,591,480,0,93,-3.8398018166804295,173,96,96,96,0,0,0,0,-77,44.50867052023121,100.0,100.0,0.0,80.9145129224652,76.50099403578528,4.413518886679924,Production
3590,0,2019-03-29,141897,DANET LIEG CHOCO 100X8 PC,0,1,0,DANETTE,0,StJust(FR),0082,0024 FR VALLET (DC),2422,2515,2035,1924,111,591,480,0,93,-3.8398018166804295,89,101,101,101,0,0,0,0,12,-13.48314606741573,100.0,100.0,0.0,80.9145129224652,76.50099403578528,4.413518886679924,Production
3591,0,2019-03-29,141897,DANET LIEG CHOCO 100X8 PC,0,1,0,DANETTE,0,StJust(FR),0077,0024 FR LILPARK (DC),2422,2515,2035,1924,111,591,480,0,93,-3.8398018166804295,335,321,218,120,98,201,103,0,-14,4.17910447761194,67.91277258566979,37.38317757009346,30.529595015576326,80.9145129224652,76.50099403578528,4.413518886679924,Production
3592,0,2019-03-29,141897,DANET LIEG CHOCO 100X8 PC,0,1,0,DANETTE,0,StJust(FR),0085,0024 FR TOULOUSE (DC),2422,2515,2035,1924,111,591,480,0,93,-3.8398018166804295,245,254,216,214,2,40,38,0,9,-3.673469387755102,85.03937007874016,84.25196850393701,0.7874015748031553,80.9145129224652,76.50099403578528,4.413518886679924,Production
3593,0,2019-03-29,141897,DANET LIEG CHOCO 100X8 PC,0,1,0,DANETTE,0,StJust(FR),0083,0024 FR CHAPONNAY (DC),2422,2515,2035,1924,111,591,480,0,93,-3.8398018166804295,525,484,484,480,4,4,0,0,-41,7.809523809523809,100.0,99.17355371900827,0.8264462809917319,80.9145129224652,76.50099403578528,4.413518886679924,Production
3594,0,2019-03-29,141897,DANET LIEG CHOCO 100X8 PC,0,1,0,DANETTE,0,StJust(FR),0079,0024 FR PARIS SUD (DC),2422,2515,2035,1924,111,591,480,0,93,-3.8398018166804295,439,456,416,412,4,44,40,0,17,-3.8724373576309796,91.22807017543859,90.35087719298247,0.8771929824561226,80.9145129224652,76.50099403578528,4.413518886679924,Production
3595,0,2019-03-29,141897,DANET LIEG CHOCO 100X8 PC,0,1,0,DANETTE,0,StJust(FR),0078,0024 FR PARIS NORD (DC),2422,2515,2035,1924,111,591,480,0,93,-3.8398018166804295,422,628,367,367,0,261,261,0,206,-48.81516587677725,58.439490445859875,58.439490445859875,0.0,80.9145129224652,76.50099403578528,4.413518886679924,Production
3596,0,2019-03-30,96132,LES 2 VACHES NATURE 115X4,0,0,0,LES 2 VACHES,0,LeMolay(FR),0084,0024 FR AIX (DC),1685,1790,1779,1622,157,168,11,0,105,-6.231454005934718,204,231,231,231,0,0,0,0,27,-13.235294117647058,100.0,100.0,0.0,99.3854748603352,90.6145251396648,8.770949720670387,Previsions
3597,0,2019-03-30,96132,LES 2 VACHES NATURE 115X4,0,0,0,LES 2 VACHES,0,LeMolay(FR),0080,0024 FR METZ (DC),1685,1790,1779,1622,157,168,11,0,105,-6.231454005934718,72,41,41,41,0,0,0,0,-31,43.05555555555556,100.0,100.0,0.0,99.3854748603352,90.6145251396648,8.770949720670387,Previsions
3598,0,2019-03-30,96132,LES 2 VACHES NATURE 115X4,0,0,0,LES 2 VACHES,0,LeMolay(FR),0081,0024 FR TOURS (DC),1685,1790,1779,1622,157,168,11,0,105,-6.231454005934718,131,158,158,1,157,157,0,0,27,-20.610687022900763,100.0,0.6329113924050633,99.36708860759494,99.3854748603352,90.6145251396648,8.770949720670387,Previsions
3599,0,2019-03-30,96132,LES 2 VACHES NATURE 115X4,0,0,0,LES 2 VACHES,0,LeMolay(FR),0082,0024 FR VALLET (DC),1685,1790,1779,1622,157,168,11,0,105,-6.231454005934718,176,159,159,159,0,0,0,0,-17,9.659090909090908,100.0,100.0,0.0,99.3854748603352,90.6145251396648,8.770949720670387,Previsions
3600,0,2019-03-30,96132,LES 2 VACHES NATURE 115X4,0,0,0,LES 2 VACHES,0,LeMolay(FR),0077,0024 FR LILPARK (DC),1685,1790,1779,1622,157,168,11,0,105,-6.231454005934718,56,46,46,46,0,0,0,0,-10,17.857142857142858,100.0,100.0,0.0,99.3854748603352,90.6145251396648,8.770949720670387,Previsions
3601,0,2019-03-30,96132,LES 2 VACHES NATURE 115X4,0,0,0,LES 2 VACHES,0,LeMolay(FR),0085,0024 FR TOULOUSE (DC),1685,1790,1779,1622,157,168,11,0,105,-6.231454005934718,189,143,132,132,0,11,11,0,-46,24.33862433862434,92.3076923076923,92.3076923076923,0.0,99.3854748603352,90.6145251396648,8.770949720670387,Previsions
3602,0,2019-03-30,96132,LES 2 VACHES NATURE 115X4,0,0,0,LES 2 VACHES,0,LeMolay(FR),0083,0024 FR CHAPONNAY (DC),1685,1790,1779,1622,157,168,11,0,105,-6.231454005934718,199,208,208,208,0,0,0,0,9,-4.522613065326633,100.0,100.0,0.0,99.3854748603352,90.6145251396648,8.770949720670387,Previsions
3603,0,2019-03-30,96132,LES 2 VACHES NATURE 115X4,0,0,0,LES 2 VACHES,0,LeMolay(FR),0079,0024 FR PARIS SUD (DC),1685,1790,1779,1622,157,168,11,0,105,-6.231454005934718,293,413,413,413,0,0,0,0,120,-40.955631399317404,100.0,100.0,0.0,99.3854748603352,90.6145251396648,8.770949720670387,Previsions
3604,0,2019-03-30,96132,LES 2 VACHES NATURE 115X4,0,0,0,LES 2 VACHES,0,LeMolay(FR),0078,0024 FR PARIS NORD (DC),1685,1790,1779,1622,157,168,11,0,105,-6.231454005934718,365,391,391,391,0,0,0,0,26,-7.123287671232877,100.0,100.0,0.0,99.3854748603352,90.6145251396648,8.770949720670387,Previsions
3605,0,2019-03-30,107076,LES 2 VACHES VANILLA 115X4,0,0,0,LES 2 VACHES,0,LeMolay(FR),0084,0024 FR AIX (DC),2205,2949,1506,1487,19,1462,1443,0,744,-33.74149659863946,311,395,182,182,0,213,213,0,84,-27.009646302250804,46.07594936708861,46.07594936708861,0.0,51.06815869786369,50.42387249915225,0.6442861987114341,Previsions
3606,0,2019-03-30,107076,LES 2 VACHES VANILLA 115X4,0,0,0,LES 2 VACHES,0,LeMolay(FR),0080,0024 FR METZ (DC),2205,2949,1506,1487,19,1462,1443,0,744,-33.74149659863946,79,84,53,53,0,31,31,0,5,-6.329113924050633,63.095238095238095,63.095238095238095,0.0,51.06815869786369,50.42387249915225,0.6442861987114341,Previsions
3607,0,2019-03-30,107076,LES 2 VACHES VANILLA 115X4,0,0,0,LES 2 VACHES,0,LeMolay(FR),0081,0024 FR TOURS (DC),2205,2949,1506,1487,19,1462,1443,0,744,-33.74149659863946,179,320,307,307,0,13,13,0,141,-78.77094972067039,95.9375,95.9375,0.0,51.06815869786369,50.42387249915225,0.6442861987114341,Previsions
3608,0,2019-03-30,107076,LES 2 VACHES VANILLA 115X4,0,0,0,LES 2 VACHES,0,LeMolay(FR),0082,0024 FR VALLET (DC),2205,2949,1506,1487,19,1462,1443,0,744,-33.74149659863946,224,253,181,181,0,72,72,0,29,-12.946428571428571,71.54150197628458,71.54150197628458,0.0,51.06815869786369,50.42387249915225,0.6442861987114341,Previsions
3609,0,2019-03-30,107076,LES 2 VACHES VANILLA 115X4,0,0,0,LES 2 VACHES,0,LeMolay(FR),0085,0024 FR TOULOUSE (DC),2205,2949,1506,1487,19,1462,1443,0,744,-33.74149659863946,303,311,185,185,0,126,126,0,8,-2.6402640264026402,59.4855305466238,59.4855305466238,0.0,51.06815869786369,50.42387249915225,0.6442861987114341,Previsions
3610,0,2019-03-30,107076,LES 2 VACHES VANILLA 115X4,0,0,0,LES 2 VACHES,0,LeMolay(FR),0083,0024 FR CHAPONNAY (DC),2205,2949,1506,1487,19,1462,1443,0,744,-33.74149659863946,297,395,395,395,0,0,0,0,98,-32.996632996633,100.0,100.0,0.0,51.06815869786369,50.42387249915225,0.6442861987114341,Previsions
3611,0,2019-03-30,107076,LES 2 VACHES VANILLA 115X4,0,0,0,LES 2 VACHES,0,LeMolay(FR),0079,0024 FR PARIS SUD (DC),2205,2949,1506,1487,19,1462,1443,0,744,-33.74149659863946,398,724,61,61,0,663,663,0,326,-81.90954773869346,8.425414364640885,8.425414364640885,0.0,51.06815869786369,50.42387249915225,0.6442861987114341,Previsions
3612,0,2019-03-30,107076,LES 2 VACHES VANILLA 115X4,0,0,0,LES 2 VACHES,0,LeMolay(FR),0078,0024 FR PARIS NORD (DC),2205,2949,1506,1487,19,1462,1443,0,744,-33.74149659863946,414,467,142,123,19,344,325,0,53,-12.801932367149758,30.406852248394006,26.33832976445396,4.068522483940047,51.06815869786369,50.42387249915225,0.6442861987114341,Previsions
3613,0,2019-03-30,127750,DANIO 0% FRAISE 150X1,0,0,0,DANIO,0,Ferrières(FR),0084,0024 FR AIX (DC),352,504,352,295,57,209,152,0,152,-43.18181818181818,26,31,31,29,2,2,0,0,5,-19.23076923076923,100.0,93.54838709677419,6.451612903225808,69.84126984126983,58.53174603174603,11.309523809523803,Schéma
3614,0,2019-03-30,127750,DANIO 0% FRAISE 150X1,0,0,0,DANIO,0,Ferrières(FR),0081,0024 FR TOURS (DC),352,504,352,295,57,209,152,0,152,-43.18181818181818,38,33,37,33,4,0,-4,0,-5,13.157894736842104,112.12121212121211,100.0,12.12121212121211,69.84126984126983,58.53174603174603,11.309523809523803,Schéma
3615,0,2019-03-30,127750,DANIO 0% FRAISE 150X1,0,0,0,DANIO,0,Ferrières(FR),0082,0024 FR VALLET (DC),352,504,352,295,57,209,152,0,152,-43.18181818181818,25,31,31,31,0,0,0,0,6,-24.0,100.0,100.0,0.0,69.84126984126983,58.53174603174603,11.309523809523803,Schéma
3616,0,2019-03-30,127750,DANIO 0% FRAISE 150X1,0,0,0,DANIO,0,Ferrières(FR),0077,0024 FR LILPARK (DC),352,504,352,295,57,209,152,0,152,-43.18181818181818,43,55,55,4,51,51,0,0,12,-27.906976744186046,100.0,7.2727272727272725,92.72727272727273,69.84126984126983,58.53174603174603,11.309523809523803,Schéma
3617,0,2019-03-30,127750,DANIO 0% FRAISE 150X1,0,0,0,DANIO,0,Ferrières(FR),0085,0024 FR TOULOUSE (DC),352,504,352,295,57,209,152,0,152,-43.18181818181818,49,48,48,48,0,0,0,0,-1,2.0408163265306123,100.0,100.0,0.0,69.84126984126983,58.53174603174603,11.309523809523803,Schéma
3618,0,2019-03-30,127750,DANIO 0% FRAISE 150X1,0,0,0,DANIO,0,Ferrières(FR),0083,0024 FR CHAPONNAY (DC),352,504,352,295,57,209,152,0,152,-43.18181818181818,54,51,51,51,0,0,0,0,-3,5.555555555555555,100.0,100.0,0.0,69.84126984126983,58.53174603174603,11.309523809523803,Schéma
3619,0,2019-03-30,127750,DANIO 0% FRAISE 150X1,0,0,0,DANIO,0,Ferrières(FR),0079,0024 FR PARIS SUD (DC),352,504,352,295,57,209,152,0,152,-43.18181818181818,58,96,49,49,0,47,47,0,38,-65.51724137931035,51.041666666666664,51.041666666666664,0.0,69.84126984126983,58.53174603174603,11.309523809523803,Schéma
3620,0,2019-03-30,127750,DANIO 0% FRAISE 150X1,0,0,0,DANIO,0,Ferrières(FR),0078,0024 FR PARIS NORD (DC),352,504,352,295,57,209,152,0,152,-43.18181818181818,59,159,50,50,0,109,109,0,100,-169.4915254237288,31.446540880503143,31.446540880503143,0.0,69.84126984126983,58.53174603174603,11.309523809523803,Schéma
3621,1,2019-03-30,133134,LIGHT & FREE FRAMB GREN 120X4 OD,1,0,0,LIGHT & FREE,0,Ferrières(FR),0078,0024 FR PARIS NORD (DC),203,1291,1288,1260,28,31,3,0,1088,-535.960591133005,203,202,199,171,28,31,3,0,-1,0.49261083743842365,98.51485148514851,84.65346534653465,13.861386138613867,99.76762199845082,97.5987606506584,2.168861347792415,Expe usine
3622,0,2019-05-13,105287,DANET MOUS CHOC LIEG 80gx4 Lidl,0,0,0,DANETTE,1,Ochsenfurt(ALL),0084,0024 FR AIX (DC),1018,1200,1048,960,88,240,152,0,182,-17.87819253438114,141,120,120,120,0,0,0,0,-21,14.893617021276595,100.0,100.0,0.0,87.33333333333333,80.0,7.333333333333329,Production
3623,0,2019-05-13,105287,DANET MOUS CHOC LIEG 80gx4 Lidl,0,0,0,DANETTE,1,Ochsenfurt(ALL),0080,0024 FR METZ (DC),1018,1200,1048,960,88,240,152,0,182,-17.87819253438114,193,240,88,0,88,240,152,0,47,-24.352331606217618,36.666666666666664,0.0,36.666666666666664,87.33333333333333,80.0,7.333333333333329,Production
3624,0,2019-05-13,105287,DANET MOUS CHOC LIEG 80gx4 Lidl,0,0,0,DANETTE,1,Ochsenfurt(ALL),0081,0024 FR TOURS (DC),1018,1200,1048,960,88,240,152,0,182,-17.87819253438114,151,240,240,240,0,0,0,0,89,-58.94039735099338,100.0,100.0,0.0,87.33333333333333,80.0,7.333333333333329,Production
3625,0,2019-05-13,105287,DANET MOUS CHOC LIEG 80gx4 Lidl,0,0,0,DANETTE,1,Ochsenfurt(ALL),0085,0024 FR TOULOUSE (DC),1018,1200,1048,960,88,240,152,0,182,-17.87819253438114,218,240,240,240,0,0,0,0,22,-10.091743119266056,100.0,100.0,0.0,87.33333333333333,80.0,7.333333333333329,Production
3626,0,2019-05-13,105287,DANET MOUS CHOC LIEG 80gx4 Lidl,0,0,0,DANETTE,1,Ochsenfurt(ALL),0083,0024 FR CHAPONNAY (DC),1018,1200,1048,960,88,240,152,0,182,-17.87819253438114,155,120,120,120,0,0,0,0,-35,22.580645161290324,100.0,100.0,0.0,87.33333333333333,80.0,7.333333333333329,Production
3627,0,2019-05-13,105287,DANET MOUS CHOC LIEG 80gx4 Lidl,0,0,0,DANETTE,1,Ochsenfurt(ALL),0078,0024 FR PARIS NORD (DC),1018,1200,1048,960,88,240,152,0,182,-17.87819253438114,160,240,240,240,0,0,0,0,80,-50.0,100.0,100.0,0.0,87.33333333333333,80.0,7.333333333333329,Production
3628,0,2019-05-13,121313,ACTIMEL MULTI 4x(10x100g) FR,0,0,0,ACTIMEL,1,Rotselaar(BE),0084,0024 FR AIX (DC),69,170,60,55,5,115,110,0,101,-146.3768115942029,8,63,31,28,3,35,32,0,55,-687.5,49.2063492063492,44.44444444444444,4.761904761904759,35.294117647058826,32.35294117647059,2.941176470588239,Previsions
3629,0,2019-05-13,121313,ACTIMEL MULTI 4x(10x100g) FR,0,0,0,ACTIMEL,1,Rotselaar(BE),0077,0024 FR LILPARK (DC),69,170,60,55,5,115,110,0,101,-146.3768115942029,30,75,8,7,1,68,67,0,45,-150.0,10.666666666666668,9.333333333333334,1.333333333333334,35.294117647058826,32.35294117647059,2.941176470588239,Previsions
3630,0,2019-05-13,121313,ACTIMEL MULTI 4x(10x100g) FR,0,0,0,ACTIMEL,1,Rotselaar(BE),0085,0024 FR TOULOUSE (DC),69,170,60,55,5,115,110,0,101,-146.3768115942029,13,6,6,6,0,0,0,0,-7,53.84615384615385,100.0,100.0,0.0,35.294117647058826,32.35294117647059,2.941176470588239,Previsions
3631,0,2019-05-13,121313,ACTIMEL MULTI 4x(10x100g) FR,0,0,0,ACTIMEL,1,Rotselaar(BE),0078,0024 FR PARIS NORD (DC),69,170,60,55,5,115,110,0,101,-146.3768115942029,18,26,15,14,1,12,11,0,8,-44.44444444444444,57.692307692307686,53.84615384615385,3.8461538461538396,35.294117647058826,32.35294117647059,2.941176470588239,Previsions
3632,1,2019-05-13,127750,DANIO 0% FRAISE 150X1,0,0,0,DANIO,0,Ferrières(FR),0084,0024 FR AIX (DC),46,645,609,507,102,138,36,0,599,-1302.1739130434783,46,101,101,0,101,101,0,0,55,-119.56521739130434,100.0,0.0,100.0,94.41860465116278,78.6046511627907,15.813953488372078,Expe usine
3633,0,2019-05-13,146376,L2V BRASS VAN 115X4,0,1,0,LES 2 VACHES,0,LeMolay(FR),0084,0024 FR AIX (DC),4501,3808,1757,1525,232,2283,2051,0,-693,15.396578538102643,354,403,139,139,0,264,264,0,49,-13.841807909604519,34.49131513647642,34.49131513647642,0.0,46.13970588235294,40.04726890756303,6.092436974789912,Production
3634,0,2019-05-13,146376,L2V BRASS VAN 115X4,0,1,0,LES 2 VACHES,0,LeMolay(FR),0080,0024 FR METZ (DC),4501,3808,1757,1525,232,2283,2051,0,-693,15.396578538102643,426,366,80,80,0,286,286,0,-60,14.084507042253522,21.85792349726776,21.85792349726776,0.0,46.13970588235294,40.04726890756303,6.092436974789912,Production
3635,0,2019-05-13,146376,L2V BRASS VAN 115X4,0,1,0,LES 2 VACHES,0,LeMolay(FR),0081,0024 FR TOURS (DC),4501,3808,1757,1525,232,2283,2051,0,-693,15.396578538102643,489,489,489,489,0,0,0,0,0,0.0,100.0,100.0,0.0,46.13970588235294,40.04726890756303,6.092436974789912,Production
3636,0,2019-05-13,146376,L2V BRASS VAN 115X4,0,1,0,LES 2 VACHES,0,LeMolay(FR),0082,0024 FR VALLET (DC),4501,3808,1757,1525,232,2283,2051,0,-693,15.396578538102643,489,466,136,136,0,330,330,0,-23,4.703476482617587,29.184549356223176,29.184549356223176,0.0,46.13970588235294,40.04726890756303,6.092436974789912,Production
3637,0,2019-05-13,146376,L2V BRASS VAN 115X4,0,1,0,LES 2 VACHES,0,LeMolay(FR),0077,0024 FR LILPARK (DC),4501,3808,1757,1525,232,2283,2051,0,-693,15.396578538102643,249,282,56,56,0,226,226,0,33,-13.25301204819277,19.858156028368796,19.858156028368796,0.0,46.13970588235294,40.04726890756303,6.092436974789912,Production
3638,0,2019-05-13,146376,L2V BRASS VAN 115X4,0,1,0,LES 2 VACHES,0,LeMolay(FR),0085,0024 FR TOULOUSE (DC),4501,3808,1757,1525,232,2283,2051,0,-693,15.396578538102643,968,743,408,408,0,335,335,0,-225,23.24380165289256,54.91251682368775,54.91251682368775,0.0,46.13970588235294,40.04726890756303,6.092436974789912,Production
3639,0,2019-05-13,146376,L2V BRASS VAN 115X4,0,1,0,LES 2 VACHES,0,LeMolay(FR),0083,0024 FR CHAPONNAY (DC),4501,3808,1757,1525,232,2283,2051,0,-693,15.396578538102643,741,440,153,153,0,287,287,0,-301,40.62078272604588,34.77272727272727,34.77272727272727,0.0,46.13970588235294,40.04726890756303,6.092436974789912,Production
3640,0,2019-05-13,146376,L2V BRASS VAN 115X4,0,1,0,LES 2 VACHES,0,LeMolay(FR),0079,0024 FR PARIS SUD (DC),4501,3808,1757,1525,232,2283,2051,0,-693,15.396578538102643,785,619,296,64,232,555,323,0,-166,21.146496815286625,47.81906300484653,10.339256865912763,37.47980613893377,46.13970588235294,40.04726890756303,6.092436974789912,Production
3641,0,2019-05-13,146525,L2V BRASS FRAI RHUB 115X4,0,1,0,LES 2 VACHES,0,LeMolay(FR),0081,0024 FR TOURS (DC),643,315,146,127,19,188,169,0,-328,51.01088646967341,64,89,10,0,10,89,79,0,25,-39.0625,11.235955056179774,0.0,11.235955056179774,46.34920634920635,40.317460317460316,6.031746031746032,Production
3642,0,2019-05-13,146525,L2V BRASS FRAI RHUB 115X4,0,1,0,LES 2 VACHES,0,LeMolay(FR),0082,0024 FR VALLET (DC),643,315,146,127,19,188,169,0,-328,51.01088646967341,499,91,78,78,0,13,13,0,-408,81.76352705410822,85.71428571428571,85.71428571428571,0.0,46.34920634920635,40.317460317460316,6.031746031746032,Production
3643,0,2019-05-13,146525,L2V BRASS FRAI RHUB 115X4,0,1,0,LES 2 VACHES,0,LeMolay(FR),0083,0024 FR CHAPONNAY (DC),643,315,146,127,19,188,169,0,-328,51.01088646967341,42,72,9,0,9,72,63,0,30,-71.42857142857143,12.5,0.0,12.5,46.34920634920635,40.317460317460316,6.031746031746032,Production
3644,0,2019-05-13,146525,L2V BRASS FRAI RHUB 115X4,0,1,0,LES 2 VACHES,0,LeMolay(FR),0079,0024 FR PARIS SUD (DC),643,315,146,127,19,188,169,0,-328,51.01088646967341,38,63,49,49,0,14,14,0,25,-65.78947368421052,77.77777777777779,77.77777777777779,0.0,46.34920634920635,40.317460317460316,6.031746031746032,Production
3645,0,2019-05-14,32803,TAILLEFINE CHEESE NAT 0% 850GX1,0,0,0,TAILLEFINE,0,Ferrières(FR),0084,0024 FR AIX (DC),615,796,638,638,0,158,158,0,181,-29.43089430894309,56,67,67,67,0,0,0,0,11,-19.642857142857142,100.0,100.0,0.0,80.15075376884423,80.15075376884423,0.0,Qualité
3646,0,2019-05-14,32803,TAILLEFINE CHEESE NAT 0% 850GX1,0,0,0,TAILLEFINE,0,Ferrières(FR),0080,0024 FR METZ (DC),615,796,638,638,0,158,158,0,181,-29.43089430894309,14,25,25,25,0,0,0,0,11,-78.57142857142857,100.0,100.0,0.0,80.15075376884423,80.15075376884423,0.0,Qualité
3647,0,2019-05-14,32803,TAILLEFINE CHEESE NAT 0% 850GX1,0,0,0,TAILLEFINE,0,Ferrières(FR),0081,0024 FR TOURS (DC),615,796,638,638,0,158,158,0,181,-29.43089430894309,59,63,63,63,0,0,0,0,4,-6.779661016949152,100.0,100.0,0.0,80.15075376884423,80.15075376884423,0.0,Qualité
3648,0,2019-05-14,32803,TAILLEFINE CHEESE NAT 0% 850GX1,0,0,0,TAILLEFINE,0,Ferrières(FR),0082,0024 FR VALLET (DC),615,796,638,638,0,158,158,0,181,-29.43089430894309,37,37,37,37,0,0,0,0,0,0.0,100.0,100.0,0.0,80.15075376884423,80.15075376884423,0.0,Qualité
3649,0,2019-05-14,32803,TAILLEFINE CHEESE NAT 0% 850GX1,0,0,0,TAILLEFINE,0,Ferrières(FR),0077,0024 FR LILPARK (DC),615,796,638,638,0,158,158,0,181,-29.43089430894309,42,56,56,56,0,0,0,0,14,-33.333333333333336,100.0,100.0,0.0,80.15075376884423,80.15075376884423,0.0,Qualité
3650,0,2019-05-14,32803,TAILLEFINE CHEESE NAT 0% 850GX1,0,0,0,TAILLEFINE,0,Ferrières(FR),0085,0024 FR TOULOUSE (DC),615,796,638,638,0,158,158,0,181,-29.43089430894309,38,49,49,49,0,0,0,0,11,-28.94736842105263,100.0,100.0,0.0,80.15075376884423,80.15075376884423,0.0,Qualité
3651,0,2019-05-14,32803,TAILLEFINE CHEESE NAT 0% 850GX1,0,0,0,TAILLEFINE,0,Ferrières(FR),0083,0024 FR CHAPONNAY (DC),615,796,638,638,0,158,158,0,181,-29.43089430894309,138,153,153,153,0,0,0,0,15,-10.869565217391305,100.0,100.0,0.0,80.15075376884423,80.15075376884423,0.0,Qualité
3652,0,2019-05-14,32803,TAILLEFINE CHEESE NAT 0% 850GX1,0,0,0,TAILLEFINE,0,Ferrières(FR),0079,0024 FR PARIS SUD (DC),615,796,638,638,0,158,158,0,181,-29.43089430894309,140,186,28,28,0,158,158,0,46,-32.857142857142854,15.053763440860216,15.053763440860216,0.0,80.15075376884423,80.15075376884423,0.0,Qualité
3653,0,2019-05-14,32803,TAILLEFINE CHEESE NAT 0% 850GX1,0,0,0,TAILLEFINE,0,Ferrières(FR),0078,0024 FR PARIS NORD (DC),615,796,638,638,0,158,158,0,181,-29.43089430894309,91,160,160,160,0,0,0,0,69,-75.82417582417582,100.0,100.0,0.0,80.15075376884423,80.15075376884423,0.0,Qualité
3654,0,2019-05-14,127660,DANONINO ARO RIGO PANACHE 125X12,1,0,0,DANONINO,0,Bailleul(FR),0084,0024 FR AIX (DC),1349,1499,1412,936,476,563,87,0,150,-11.11934766493699,86,72,72,72,0,0,0,0,-14,16.27906976744186,100.0,100.0,0.0,94.19613075383589,62.44162775183456,31.75450300200133,Previsions
3655,0,2019-05-14,127660,DANONINO ARO RIGO PANACHE 125X12,1,0,0,DANONINO,0,Bailleul(FR),0080,0024 FR METZ (DC),1349,1499,1412,936,476,563,87,0,150,-11.11934766493699,94,153,153,0,153,153,0,0,59,-62.765957446808514,100.0,0.0,100.0,94.19613075383589,62.44162775183456,31.75450300200133,Previsions
3656,0,2019-05-14,127660,DANONINO ARO RIGO PANACHE 125X12,1,0,0,DANONINO,0,Bailleul(FR),0081,0024 FR TOURS (DC),1349,1499,1412,936,476,563,87,0,150,-11.11934766493699,226,243,243,243,0,0,0,0,17,-7.522123893805309,100.0,100.0,0.0,94.19613075383589,62.44162775183456,31.75450300200133,Previsions
3657,0,2019-05-14,127660,DANONINO ARO RIGO PANACHE 125X12,1,0,0,DANONINO,0,Bailleul(FR),0082,0024 FR VALLET (DC),1349,1499,1412,936,476,563,87,0,150,-11.11934766493699,91,131,100,92,8,39,31,0,40,-43.956043956043956,76.33587786259542,70.22900763358778,6.10687022900764,94.19613075383589,62.44162775183456,31.75450300200133,Previsions
3658,0,2019-05-14,127660,DANONINO ARO RIGO PANACHE 125X12,1,0,0,DANONINO,0,Bailleul(FR),0077,0024 FR LILPARK (DC),1349,1499,1412,936,476,563,87,0,150,-11.11934766493699,164,218,187,94,93,124,31,0,54,-32.926829268292686,85.77981651376146,43.11926605504588,42.66055045871558,94.19613075383589,62.44162775183456,31.75450300200133,Previsions
3659,0,2019-05-14,127660,DANONINO ARO RIGO PANACHE 125X12,1,0,0,DANONINO,0,Bailleul(FR),0085,0024 FR TOULOUSE (DC),1349,1499,1412,936,476,563,87,0,150,-11.11934766493699,119,120,120,120,0,0,0,0,1,-0.8403361344537815,100.0,100.0,0.0,94.19613075383589,62.44162775183456,31.75450300200133,Previsions
3660,0,2019-05-14,127660,DANONINO ARO RIGO PANACHE 125X12,1,0,0,DANONINO,0,Bailleul(FR),0083,0024 FR CHAPONNAY (DC),1349,1499,1412,936,476,563,87,0,150,-11.11934766493699,219,196,196,196,0,0,0,0,-23,10.502283105022832,100.0,100.0,0.0,94.19613075383589,62.44162775183456,31.75450300200133,Previsions
3661,0,2019-05-14,127660,DANONINO ARO RIGO PANACHE 125X12,1,0,0,DANONINO,0,Bailleul(FR),0079,0024 FR PARIS SUD (DC),1349,1499,1412,936,476,563,87,0,150,-11.11934766493699,209,163,163,20,143,143,0,0,-46,22.00956937799043,100.0,12.269938650306749,87.73006134969324,94.19613075383589,62.44162775183456,31.75450300200133,Previsions
3662,0,2019-05-14,127660,DANONINO ARO RIGO PANACHE 125X12,1,0,0,DANONINO,0,Bailleul(FR),0078,0024 FR PARIS NORD (DC),1349,1499,1412,936,476,563,87,0,150,-11.11934766493699,141,203,178,99,79,104,25,0,62,-43.97163120567376,87.68472906403942,48.76847290640394,38.91625615763547,94.19613075383589,62.44162775183456,31.75450300200133,Previsions
3663,0,2019-05-14,146172,DANONE KEFIR 265MLX1,0,1,0,DANONE,1,Krasny(PL),0080,0024 FR METZ (DC),20,59,8,8,0,51,51,0,39,-195.0,6,29,2,2,0,27,27,0,23,-383.3333333333333,6.896551724137931,6.896551724137931,0.0,13.559322033898304,13.559322033898304,0.0,A Creuser
3664,0,2019-05-14,146172,DANONE KEFIR 265MLX1,0,1,0,DANONE,1,Krasny(PL),0082,0024 FR VALLET (DC),20,59,8,8,0,51,51,0,39,-195.0,4,3,3,3,0,0,0,0,-1,25.0,100.0,100.0,0.0,13.559322033898304,13.559322033898304,0.0,A Creuser
3665,0,2019-05-14,146172,DANONE KEFIR 265MLX1,0,1,0,DANONE,1,Krasny(PL),0083,0024 FR CHAPONNAY (DC),20,59,8,8,0,51,51,0,39,-195.0,10,27,3,3,0,24,24,0,17,-170.0,11.11111111111111,11.11111111111111,0.0,13.559322033898304,13.559322033898304,0.0,A Creuser
3666,0,2019-05-14,146376,L2V BRASS VAN 115X4,0,1,0,LES 2 VACHES,0,LeMolay(FR),0084,0024 FR AIX (DC),6312,6072,6072,3204,2868,2868,0,0,-240,3.802281368821293,986,920,920,687,233,233,0,0,-66,6.693711967545639,100.0,74.67391304347825,25.32608695652175,100.0,52.76679841897233,47.23320158102767,Production
3667,0,2019-05-14,146376,L2V BRASS VAN 115X4,0,1,0,LES 2 VACHES,0,LeMolay(FR),0080,0024 FR METZ (DC),6312,6072,6072,3204,2868,2868,0,0,-240,3.802281368821293,281,221,221,221,0,0,0,0,-60,21.352313167259787,100.0,100.0,0.0,100.0,52.76679841897233,47.23320158102767,Production
3668,0,2019-05-14,146376,L2V BRASS VAN 115X4,0,1,0,LES 2 VACHES,0,LeMolay(FR),0081,0024 FR TOURS (DC),6312,6072,6072,3204,2868,2868,0,0,-240,3.802281368821293,928,621,621,173,448,448,0,0,-307,33.081896551724135,100.0,27.858293075684383,72.14170692431561,100.0,52.76679841897233,47.23320158102767,Production
3669,0,2019-05-14,146376,L2V BRASS VAN 115X4,0,1,0,LES 2 VACHES,0,LeMolay(FR),0082,0024 FR VALLET (DC),6312,6072,6072,3204,2868,2868,0,0,-240,3.802281368821293,664,487,487,425,62,62,0,0,-177,26.656626506024097,100.0,87.26899383983573,12.73100616016427,100.0,52.76679841897233,47.23320158102767,Production
3670,0,2019-05-14,146376,L2V BRASS VAN 115X4,0,1,0,LES 2 VACHES,0,LeMolay(FR),0077,0024 FR LILPARK (DC),6312,6072,6072,3204,2868,2868,0,0,-240,3.802281368821293,293,353,353,0,353,353,0,0,60,-20.477815699658702,100.0,0.0,100.0,100.0,52.76679841897233,47.23320158102767,Production
3671,0,2019-05-14,146376,L2V BRASS VAN 115X4,0,1,0,LES 2 VACHES,0,LeMolay(FR),0085,0024 FR TOULOUSE (DC),6312,6072,6072,3204,2868,2868,0,0,-240,3.802281368821293,665,705,705,207,498,498,0,0,40,-6.015037593984962,100.0,29.361702127659573,70.63829787234043,100.0,52.76679841897233,47.23320158102767,Production
3672,0,2019-05-14,146376,L2V BRASS VAN 115X4,0,1,0,LES 2 VACHES,0,LeMolay(FR),0083,0024 FR CHAPONNAY (DC),6312,6072,6072,3204,2868,2868,0,0,-240,3.802281368821293,816,614,614,106,508,508,0,0,-202,24.754901960784313,100.0,17.263843648208468,82.73615635179154,100.0,52.76679841897233,47.23320158102767,Production
3673,0,2019-05-14,146376,L2V BRASS VAN 115X4,0,1,0,LES 2 VACHES,0,LeMolay(FR),0079,0024 FR PARIS SUD (DC),6312,6072,6072,3204,2868,2868,0,0,-240,3.802281368821293,864,1091,1091,1079,12,12,0,0,227,-26.27314814814815,100.0,98.9000916590284,1.099908340971595,100.0,52.76679841897233,47.23320158102767,Production
3674,0,2019-05-14,146376,L2V BRASS VAN 115X4,0,1,0,LES 2 VACHES,0,LeMolay(FR),0078,0024 FR PARIS NORD (DC),6312,6072,6072,3204,2868,2868,0,0,-240,3.802281368821293,815,1060,1060,306,754,754,0,0,245,-30.061349693251532,100.0,28.867924528301884,71.13207547169812,100.0,52.76679841897233,47.23320158102767,Production
3675,0,2019-05-14,146531,L2V BRASS NAT 115X4,0,1,0,LES 2 VACHES,0,LeMolay(FR),0084,0024 FR AIX (DC),2701,6376,4350,4316,34,2060,2026,0,3675,-136.06071825249907,349,1165,466,466,0,699,699,0,816,-233.810888252149,40.0,40.0,0.0,68.2245922208281,67.6913425345044,0.5332496863236997,Production
3676,0,2019-05-14,146531,L2V BRASS NAT 115X4,0,1,0,LES 2 VACHES,0,LeMolay(FR),0080,0024 FR METZ (DC),2701,6376,4350,4316,34,2060,2026,0,3675,-136.06071825249907,237,386,386,386,0,0,0,0,149,-62.869198312236286,100.0,100.0,0.0,68.2245922208281,67.6913425345044,0.5332496863236997,Production
3677,0,2019-05-14,146531,L2V BRASS NAT 115X4,0,1,0,LES 2 VACHES,0,LeMolay(FR),0081,0024 FR TOURS (DC),2701,6376,4350,4316,34,2060,2026,0,3675,-136.06071825249907,607,967,825,825,0,142,142,0,360,-59.308072487644154,85.31540847983455,85.31540847983455,0.0,68.2245922208281,67.6913425345044,0.5332496863236997,Production
3678,0,2019-05-14,146531,L2V BRASS NAT 115X4,0,1,0,LES 2 VACHES,0,LeMolay(FR),0082,0024 FR VALLET (DC),2701,6376,4350,4316,34,2060,2026,0,3675,-136.06071825249907,192,584,584,584,0,0,0,0,392,-204.16666666666666,100.0,100.0,0.0,68.2245922208281,67.6913425345044,0.5332496863236997,Production
3679,0,2019-05-14,146531,L2V BRASS NAT 115X4,0,1,0,LES 2 VACHES,0,LeMolay(FR),0077,0024 FR LILPARK (DC),2701,6376,4350,4316,34,2060,2026,0,3675,-136.06071825249907,96,192,114,114,0,78,78,0,96,-100.0,59.375,59.375,0.0,68.2245922208281,67.6913425345044,0.5332496863236997,Production
3680,0,2019-05-14,146531,L2V BRASS NAT 115X4,0,1,0,LES 2 VACHES,0,LeMolay(FR),0085,0024 FR TOULOUSE (DC),2701,6376,4350,4316,34,2060,2026,0,3675,-136.06071825249907,227,569,482,453,29,116,87,0,342,-150.66079295154185,84.71001757469244,79.61335676625659,5.096660808435857,68.2245922208281,67.6913425345044,0.5332496863236997,Production
3681,0,2019-05-14,146531,L2V BRASS NAT 115X4,0,1,0,LES 2 VACHES,0,LeMolay(FR),0083,0024 FR CHAPONNAY (DC),2701,6376,4350,4316,34,2060,2026,0,3675,-136.06071825249907,313,913,660,660,0,253,253,0,600,-191.69329073482427,72.28915662650603,72.28915662650603,0.0,68.2245922208281,67.6913425345044,0.5332496863236997,Production
3682,0,2019-05-14,146531,L2V BRASS NAT 115X4,0,1,0,LES 2 VACHES,0,LeMolay(FR),0079,0024 FR PARIS SUD (DC),2701,6376,4350,4316,34,2060,2026,0,3675,-136.06071825249907,473,1038,722,722,0,316,316,0,565,-119.45031712473573,69.55684007707129,69.55684007707129,0.0,68.2245922208281,67.6913425345044,0.5332496863236997,Production
3683,0,2019-05-14,146531,L2V BRASS NAT 115X4,0,1,0,LES 2 VACHES,0,LeMolay(FR),0078,0024 FR PARIS NORD (DC),2701,6376,4350,4316,34,2060,2026,0,3675,-136.06071825249907,207,562,111,106,5,456,451,0,355,-171.4975845410628,19.750889679715304,18.86120996441281,0.889679715302492,68.2245922208281,67.6913425345044,0.5332496863236997,Production
3684,1,2019-05-15,122048,VELOUTE NATURE 125X8 OD,1,0,0,VELOUTE,0,StJust(FR),0082,0024 FR VALLET (DC),84,1354,1354,1284,70,70,0,0,1270,-1511.904761904762,84,79,79,14,65,65,0,0,-5,5.9523809523809526,100.0,17.72151898734177,82.27848101265823,100.0,94.8301329394387,5.169867060561302,Transport
3685,0,2019-05-15,127660,DANONINO ARO RIGO PANACHE 125X12,1,0,0,DANONINO,0,Bailleul(FR),0084,0024 FR AIX (DC),1258,1369,1352,1213,139,156,17,0,111,-8.823529411764707,126,105,105,105,0,0,0,0,-21,16.666666666666668,100.0,100.0,0.0,98.7582176771366,88.60482103725347,10.153396639883127,Previsions
3686,0,2019-05-15,127660,DANONINO ARO RIGO PANACHE 125X12,1,0,0,DANONINO,0,Bailleul(FR),0080,0024 FR METZ (DC),1258,1369,1352,1213,139,156,17,0,111,-8.823529411764707,169,214,214,187,27,27,0,0,45,-26.62721893491124,100.0,87.38317757009347,12.616822429906534,98.7582176771366,88.60482103725347,10.153396639883127,Previsions
3687,0,2019-05-15,127660,DANONINO ARO RIGO PANACHE 125X12,1,0,0,DANONINO,0,Bailleul(FR),0081,0024 FR TOURS (DC),1258,1369,1352,1213,139,156,17,0,111,-8.823529411764707,186,167,167,167,0,0,0,0,-19,10.21505376344086,100.0,100.0,0.0,98.7582176771366,88.60482103725347,10.153396639883127,Previsions
3688,0,2019-05-15,127660,DANONINO ARO RIGO PANACHE 125X12,1,0,0,DANONINO,0,Bailleul(FR),0082,0024 FR VALLET (DC),1258,1369,1352,1213,139,156,17,0,111,-8.823529411764707,161,183,183,183,0,0,0,0,22,-13.664596273291925,100.0,100.0,0.0,98.7582176771366,88.60482103725347,10.153396639883127,Previsions
3689,0,2019-05-15,127660,DANONINO ARO RIGO PANACHE 125X12,1,0,0,DANONINO,0,Bailleul(FR),0077,0024 FR LILPARK (DC),1258,1369,1352,1213,139,156,17,0,111,-8.823529411764707,55,90,90,63,27,27,0,0,35,-63.63636363636363,100.0,70.0,30.0,98.7582176771366,88.60482103725347,10.153396639883127,Previsions
3690,0,2019-05-15,127660,DANONINO ARO RIGO PANACHE 125X12,1,0,0,DANONINO,0,Bailleul(FR),0085,0024 FR TOULOUSE (DC),1258,1369,1352,1213,139,156,17,0,111,-8.823529411764707,126,103,103,103,0,0,0,0,-23,18.253968253968253,100.0,100.0,0.0,98.7582176771366,88.60482103725347,10.153396639883127,Previsions
3691,0,2019-05-15,127660,DANONINO ARO RIGO PANACHE 125X12,1,0,0,DANONINO,0,Bailleul(FR),0083,0024 FR CHAPONNAY (DC),1258,1369,1352,1213,139,156,17,0,111,-8.823529411764707,216,197,197,197,0,0,0,0,-19,8.796296296296296,100.0,100.0,0.0,98.7582176771366,88.60482103725347,10.153396639883127,Previsions
3692,0,2019-05-15,127660,DANONINO ARO RIGO PANACHE 125X12,1,0,0,DANONINO,0,Bailleul(FR),0079,0024 FR PARIS SUD (DC),1258,1369,1352,1213,139,156,17,0,111,-8.823529411764707,70,123,106,100,6,23,17,0,53,-75.71428571428571,86.1788617886179,81.30081300813008,4.878048780487816,98.7582176771366,88.60482103725347,10.153396639883127,Previsions
3693,0,2019-05-15,127660,DANONINO ARO RIGO PANACHE 125X12,1,0,0,DANONINO,0,Bailleul(FR),0078,0024 FR PARIS NORD (DC),1258,1369,1352,1213,139,156,17,0,111,-8.823529411764707,149,187,187,108,79,79,0,0,38,-25.503355704697988,100.0,57.75401069518716,42.24598930481284,98.7582176771366,88.60482103725347,10.153396639883127,Previsions
3694,0,2019-05-15,134010,VELOUTE FRUIX PANACHE 125X16 OD,1,0,0,VELOUTE,0,Villecomtal(FR),0084,0024 FR AIX (DC),3588,6532,6299,6299,0,233,233,0,2944,-82.05128205128206,237,237,237,237,0,0,0,0,0,0.0,100.0,100.0,0.0,96.43294549908144,96.43294549908144,0.0,Previsions
3695,0,2019-05-15,134010,VELOUTE FRUIX PANACHE 125X16 OD,1,0,0,VELOUTE,0,Villecomtal(FR),0081,0024 FR TOURS (DC),3588,6532,6299,6299,0,233,233,0,2944,-82.05128205128206,40,20,20,20,0,0,0,0,-20,50.0,100.0,100.0,0.0,96.43294549908144,96.43294549908144,0.0,Previsions
3696,0,2019-05-15,134010,VELOUTE FRUIX PANACHE 125X16 OD,1,0,0,VELOUTE,0,Villecomtal(FR),0082,0024 FR VALLET (DC),3588,6532,6299,6299,0,233,233,0,2944,-82.05128205128206,131,131,131,131,0,0,0,0,0,0.0,100.0,100.0,0.0,96.43294549908144,96.43294549908144,0.0,Previsions
3697,0,2019-05-15,134010,VELOUTE FRUIX PANACHE 125X16 OD,1,0,0,VELOUTE,0,Villecomtal(FR),0077,0024 FR LILPARK (DC),3588,6532,6299,6299,0,233,233,0,2944,-82.05128205128206,344,926,693,693,0,233,233,0,582,-169.1860465116279,74.83801295896329,74.83801295896329,0.0,96.43294549908144,96.43294549908144,0.0,Previsions
3698,0,2019-05-15,134010,VELOUTE FRUIX PANACHE 125X16 OD,1,0,0,VELOUTE,0,Villecomtal(FR),0085,0024 FR TOULOUSE (DC),3588,6532,6299,6299,0,233,233,0,2944,-82.05128205128206,289,503,503,503,0,0,0,0,214,-74.0484429065744,100.0,100.0,0.0,96.43294549908144,96.43294549908144,0.0,Previsions
3699,0,2019-05-15,134010,VELOUTE FRUIX PANACHE 125X16 OD,1,0,0,VELOUTE,0,Villecomtal(FR),0083,0024 FR CHAPONNAY (DC),3588,6532,6299,6299,0,233,233,0,2944,-82.05128205128206,767,1589,1589,1589,0,0,0,0,822,-107.17079530638853,100.0,100.0,0.0,96.43294549908144,96.43294549908144,0.0,Previsions
3700,0,2019-05-15,134010,VELOUTE FRUIX PANACHE 125X16 OD,1,0,0,VELOUTE,0,Villecomtal(FR),0079,0024 FR PARIS SUD (DC),3588,6532,6299,6299,0,233,233,0,2944,-82.05128205128206,685,1548,1548,1548,0,0,0,0,863,-125.98540145985402,100.0,100.0,0.0,96.43294549908144,96.43294549908144,0.0,Previsions
3701,0,2019-05-15,134010,VELOUTE FRUIX PANACHE 125X16 OD,1,0,0,VELOUTE,0,Villecomtal(FR),0078,0024 FR PARIS NORD (DC),3588,6532,6299,6299,0,233,233,0,2944,-82.05128205128206,1095,1578,1578,1578,0,0,0,0,483,-44.10958904109589,100.0,100.0,0.0,96.43294549908144,96.43294549908144,0.0,Previsions
3702,1,2019-05-15,138336,ACTIVIA STRAW-RAS-GOJI FF X4 FR,1,0,0,ACTIVIA,1,Parets(ES),0082,0024 FR VALLET (DC),13,190,190,177,13,13,0,0,177,-1361.5384615384614,13,13,13,0,13,13,0,0,0,0.0,100.0,0.0,100.0,100.0,93.15789473684211,6.84210526315789,Déploiement/Quarantaine
3703,0,2019-05-15,146161,LIGHT&FREE SKYR MANG PASS 145X1,0,1,0,LIGHT & FREE,0,Ferrières(FR),0084,0024 FR AIX (DC),156,273,273,56,217,217,0,0,117,-75.0,15,37,37,0,37,37,0,0,22,-146.66666666666666,100.0,0.0,100.0,100.0,20.51282051282051,79.48717948717949,Production
3704,0,2019-05-15,146161,LIGHT&FREE SKYR MANG PASS 145X1,0,1,0,LIGHT & FREE,0,Ferrières(FR),0080,0024 FR METZ (DC),156,273,273,56,217,217,0,0,117,-75.0,21,19,19,15,4,4,0,0,-2,9.523809523809524,100.0,78.94736842105263,21.05263157894737,100.0,20.51282051282051,79.48717948717949,Production
3705,0,2019-05-15,146161,LIGHT&FREE SKYR MANG PASS 145X1,0,1,0,LIGHT & FREE,0,Ferrières(FR),0081,0024 FR TOURS (DC),156,273,273,56,217,217,0,0,117,-75.0,13,8,8,1,7,7,0,0,-5,38.46153846153846,100.0,12.5,87.5,100.0,20.51282051282051,79.48717948717949,Production
3706,0,2019-05-15,146161,LIGHT&FREE SKYR MANG PASS 145X1,0,1,0,LIGHT & FREE,0,Ferrières(FR),0082,0024 FR VALLET (DC),156,273,273,56,217,217,0,0,117,-75.0,11,11,11,0,11,11,0,0,0,0.0,100.0,0.0,100.0,100.0,20.51282051282051,79.48717948717949,Production
3707,0,2019-05-15,146161,LIGHT&FREE SKYR MANG PASS 145X1,0,1,0,LIGHT & FREE,0,Ferrières(FR),0077,0024 FR LILPARK (DC),156,273,273,56,217,217,0,0,117,-75.0,11,24,24,0,24,24,0,0,13,-118.18181818181819,100.0,0.0,100.0,100.0,20.51282051282051,79.48717948717949,Production
3708,0,2019-05-15,146161,LIGHT&FREE SKYR MANG PASS 145X1,0,1,0,LIGHT & FREE,0,Ferrières(FR),0085,0024 FR TOULOUSE (DC),156,273,273,56,217,217,0,0,117,-75.0,21,34,34,0,34,34,0,0,13,-61.904761904761905,100.0,0.0,100.0,100.0,20.51282051282051,79.48717948717949,Production
3709,0,2019-05-15,146161,LIGHT&FREE SKYR MANG PASS 145X1,0,1,0,LIGHT & FREE,0,Ferrières(FR),0083,0024 FR CHAPONNAY (DC),156,273,273,56,217,217,0,0,117,-75.0,33,58,58,0,58,58,0,0,25,-75.75757575757575,100.0,0.0,100.0,100.0,20.51282051282051,79.48717948717949,Production
3710,0,2019-05-15,146161,LIGHT&FREE SKYR MANG PASS 145X1,0,1,0,LIGHT & FREE,0,Ferrières(FR),0079,0024 FR PARIS SUD (DC),156,273,273,56,217,217,0,0,117,-75.0,19,59,59,40,19,19,0,0,40,-210.52631578947367,100.0,67.79661016949152,32.203389830508485,100.0,20.51282051282051,79.48717948717949,Production
3711,0,2019-05-15,146161,LIGHT&FREE SKYR MANG PASS 145X1,0,1,0,LIGHT & FREE,0,Ferrières(FR),0078,0024 FR PARIS NORD (DC),156,273,273,56,217,217,0,0,117,-75.0,12,23,23,0,23,23,0,0,11,-91.66666666666667,100.0,0.0,100.0,100.0,20.51282051282051,79.48717948717949,Production
3712,0,2019-05-15,146172,DANONE KEFIR 265MLX1,0,1,0,DANONE,1,Krasny(PL),0082,0024 FR VALLET (DC),45,17,16,16,0,1,1,0,-28,62.22222222222222,13,2,2,2,0,0,0,0,-11,84.61538461538461,100.0,100.0,0.0,94.11764705882352,94.11764705882352,0.0,A Creuser
3713,0,2019-05-15,146172,DANONE KEFIR 265MLX1,0,1,0,DANONE,1,Krasny(PL),0083,0024 FR CHAPONNAY (DC),45,17,16,16,0,1,1,0,-28,62.22222222222222,32,15,14,14,0,1,1,0,-17,53.125,93.33333333333333,93.33333333333333,0.0,94.11764705882352,94.11764705882352,0.0,A Creuser
3714,0,2019-05-15,146531,L2V BRASS NAT 115X4,0,1,0,LES 2 VACHES,0,LeMolay(FR),0082,0024 FR VALLET (DC),618,984,100,84,16,900,884,0,366,-59.22330097087379,320,377,84,84,0,293,293,0,57,-17.8125,22.281167108753316,22.281167108753316,0.0,10.16260162601626,8.536585365853659,1.6260162601626007,Production
3715,0,2019-05-15,146531,L2V BRASS NAT 115X4,0,1,0,LES 2 VACHES,0,LeMolay(FR),0078,0024 FR PARIS NORD (DC),618,984,100,84,16,900,884,0,366,-59.22330097087379,298,607,16,0,16,607,591,0,309,-103.69127516778524,2.6359143327841847,0.0,2.6359143327841847,10.16260162601626,8.536585365853659,1.6260162601626007,Production
3716,0,2019-05-16,123537,ACTIVIA 4X120G(X6) MUESLI  FR,0,0,0,ACTIVIA,1,Ochsenfurt(ALL),0084,0024 FR AIX (DC),2789,3293,3293,2586,707,707,0,0,504,-18.070993187522408,307,367,367,367,0,0,0,0,60,-19.54397394136808,100.0,100.0,0.0,100.0,78.5302156088673,21.469784391132706,Transport
3717,0,2019-05-16,123537,ACTIVIA 4X120G(X6) MUESLI  FR,0,0,0,ACTIVIA,1,Ochsenfurt(ALL),0080,0024 FR METZ (DC),2789,3293,3293,2586,707,707,0,0,504,-18.070993187522408,254,261,261,261,0,0,0,0,7,-2.7559055118110236,100.0,100.0,0.0,100.0,78.5302156088673,21.469784391132706,Transport
3718,0,2019-05-16,123537,ACTIVIA 4X120G(X6) MUESLI  FR,0,0,0,ACTIVIA,1,Ochsenfurt(ALL),0081,0024 FR TOURS (DC),2789,3293,3293,2586,707,707,0,0,504,-18.070993187522408,339,357,357,357,0,0,0,0,18,-5.3097345132743365,100.0,100.0,0.0,100.0,78.5302156088673,21.469784391132706,Transport
3719,0,2019-05-16,123537,ACTIVIA 4X120G(X6) MUESLI  FR,0,0,0,ACTIVIA,1,Ochsenfurt(ALL),0082,0024 FR VALLET (DC),2789,3293,3293,2586,707,707,0,0,504,-18.070993187522408,199,200,200,200,0,0,0,0,1,-0.5025125628140703,100.0,100.0,0.0,100.0,78.5302156088673,21.469784391132706,Transport
3720,0,2019-05-16,123537,ACTIVIA 4X120G(X6) MUESLI  FR,0,0,0,ACTIVIA,1,Ochsenfurt(ALL),0077,0024 FR LILPARK (DC),2789,3293,3293,2586,707,707,0,0,504,-18.070993187522408,202,240,240,206,34,34,0,0,38,-18.81188118811881,100.0,85.83333333333333,14.166666666666671,100.0,78.5302156088673,21.469784391132706,Transport
3721,0,2019-05-16,123537,ACTIVIA 4X120G(X6) MUESLI  FR,0,0,0,ACTIVIA,1,Ochsenfurt(ALL),0085,0024 FR TOULOUSE (DC),2789,3293,3293,2586,707,707,0,0,504,-18.070993187522408,289,407,407,407,0,0,0,0,118,-40.83044982698962,100.0,100.0,0.0,100.0,78.5302156088673,21.469784391132706,Transport
3722,0,2019-05-16,123537,ACTIVIA 4X120G(X6) MUESLI  FR,0,0,0,ACTIVIA,1,Ochsenfurt(ALL),0083,0024 FR CHAPONNAY (DC),2789,3293,3293,2586,707,707,0,0,504,-18.070993187522408,320,420,420,420,0,0,0,0,100,-31.25,100.0,100.0,0.0,100.0,78.5302156088673,21.469784391132706,Transport
3723,0,2019-05-16,123537,ACTIVIA 4X120G(X6) MUESLI  FR,0,0,0,ACTIVIA,1,Ochsenfurt(ALL),0079,0024 FR PARIS SUD (DC),2789,3293,3293,2586,707,707,0,0,504,-18.070993187522408,535,595,595,309,286,286,0,0,60,-11.214953271028037,100.0,51.932773109243705,48.067226890756295,100.0,78.5302156088673,21.469784391132706,Transport
3724,0,2019-05-16,123537,ACTIVIA 4X120G(X6) MUESLI  FR,0,0,0,ACTIVIA,1,Ochsenfurt(ALL),0078,0024 FR PARIS NORD (DC),2789,3293,3293,2586,707,707,0,0,504,-18.070993187522408,344,446,446,59,387,387,0,0,102,-29.651162790697676,100.0,13.228699551569505,86.7713004484305,100.0,78.5302156088673,21.469784391132706,Transport
3725,1,2019-05-16,134010,VELOUTE FRUIX PANACHE 125X16 OD,1,0,0,VELOUTE,0,Villecomtal(FR),0079,0024 FR PARIS SUD (DC),4821,7075,7075,7075,0,0,0,0,2254,-46.753785521676,1359,949,949,949,0,0,0,0,-410,30.169242089771892,100.0,100.0,0.0,100.0,100.0,0.0,Previsions
3726,1,2019-05-16,134010,VELOUTE FRUIX PANACHE 125X16 OD,1,0,0,VELOUTE,0,Villecomtal(FR),0078,0024 FR PARIS NORD (DC),4821,7075,7075,7075,0,0,0,0,2254,-46.753785521676,3462,2798,2798,2798,0,0,0,0,-664,19.179664933564414,100.0,100.0,0.0,100.0,100.0,0.0,Previsions
3727,1,2019-05-16,138336,ACTIVIA STRAW-RAS-GOJI FF X4 FR,1,0,0,ACTIVIA,1,Parets(ES),0082,0024 FR VALLET (DC),16,358,358,321,37,37,0,0,342,-2137.5,16,16,16,0,16,16,0,0,0,0.0,100.0,0.0,100.0,100.0,89.66480446927375,10.335195530726253,Déploiement/Quarantaine
3728,1,2019-05-16,143410,DANET CHOCO LAIT 125X8 PC,0,0,0,DANETTE,0,StJust(FR),0079,0024 FR PARIS SUD (DC),61,375,376,364,12,11,-1,0,314,-514.7540983606557,61,139,139,128,11,11,0,0,78,-127.8688524590164,100.0,92.08633093525181,7.913669064748191,100.26666666666667,97.06666666666666,3.200000000000003,A Creuser
3729,0,2019-05-17,101199,DANETTE POP CHOCO MAGIX 120X4,0,0,0,DANETTE,0,LeMolay(FR),0084,0024 FR AIX (DC),9232,8992,8775,8775,0,217,217,0,-240,2.5996533795493932,1295,1326,1288,1288,0,38,38,0,31,-2.393822393822394,97.1342383107089,97.1342383107089,0.0,97.58674377224199,97.58674377224199,0.0,A Creuser
3730,0,2019-05-17,101199,DANETTE POP CHOCO MAGIX 120X4,0,0,0,DANETTE,0,LeMolay(FR),0080,0024 FR METZ (DC),9232,8992,8775,8775,0,217,217,0,-240,2.5996533795493932,1691,1748,1747,1747,0,1,1,0,57,-3.3707865168539324,99.94279176201373,99.94279176201373,0.0,97.58674377224199,97.58674377224199,0.0,A Creuser
3731,0,2019-05-17,101199,DANETTE POP CHOCO MAGIX 120X4,0,0,0,DANETTE,0,LeMolay(FR),0081,0024 FR TOURS (DC),9232,8992,8775,8775,0,217,217,0,-240,2.5996533795493932,1460,1341,1341,1341,0,0,0,0,-119,8.150684931506849,100.0,100.0,0.0,97.58674377224199,97.58674377224199,0.0,A Creuser
3732,0,2019-05-17,101199,DANETTE POP CHOCO MAGIX 120X4,0,0,0,DANETTE,0,LeMolay(FR),0082,0024 FR VALLET (DC),9232,8992,8775,8775,0,217,217,0,-240,2.5996533795493932,1518,1465,1448,1448,0,17,17,0,-53,3.4914361001317524,98.839590443686,98.839590443686,0.0,97.58674377224199,97.58674377224199,0.0,A Creuser
3733,0,2019-05-17,101199,DANETTE POP CHOCO MAGIX 120X4,0,0,0,DANETTE,0,LeMolay(FR),0077,0024 FR LILPARK (DC),9232,8992,8775,8775,0,217,217,0,-240,2.5996533795493932,477,453,359,359,0,94,94,0,-24,5.031446540880503,79.24944812362031,79.24944812362031,0.0,97.58674377224199,97.58674377224199,0.0,A Creuser
3734,0,2019-05-17,101199,DANETTE POP CHOCO MAGIX 120X4,0,0,0,DANETTE,0,LeMolay(FR),0085,0024 FR TOULOUSE (DC),9232,8992,8775,8775,0,217,217,0,-240,2.5996533795493932,1232,1243,1214,1214,0,29,29,0,11,-0.8928571428571429,97.66693483507642,97.66693483507642,0.0,97.58674377224199,97.58674377224199,0.0,A Creuser
3735,0,2019-05-17,101199,DANETTE POP CHOCO MAGIX 120X4,0,0,0,DANETTE,0,LeMolay(FR),0083,0024 FR CHAPONNAY (DC),9232,8992,8775,8775,0,217,217,0,-240,2.5996533795493932,690,603,603,603,0,0,0,0,-87,12.608695652173912,100.0,100.0,0.0,97.58674377224199,97.58674377224199,0.0,A Creuser
3736,0,2019-05-17,101199,DANETTE POP CHOCO MAGIX 120X4,0,0,0,DANETTE,0,LeMolay(FR),0079,0024 FR PARIS SUD (DC),9232,8992,8775,8775,0,217,217,0,-240,2.5996533795493932,562,543,543,543,0,0,0,0,-19,3.380782918149466,100.0,100.0,0.0,97.58674377224199,97.58674377224199,0.0,A Creuser
3737,0,2019-05-17,101199,DANETTE POP CHOCO MAGIX 120X4,0,0,0,DANETTE,0,LeMolay(FR),0078,0024 FR PARIS NORD (DC),9232,8992,8775,8775,0,217,217,0,-240,2.5996533795493932,307,270,232,232,0,38,38,0,-37,12.052117263843648,85.92592592592592,85.92592592592592,0.0,97.58674377224199,97.58674377224199,0.0,A Creuser
3738,0,2019-05-17,101202,DANETTE POP CHOC 3 CHOCO 117X4,0,0,0,DANETTE,0,LeMolay(FR),0084,0024 FR AIX (DC),10101,9914,9685,9678,7,236,229,0,-187,1.8513018513018513,1369,1443,1383,1376,7,67,60,0,74,-5.405405405405405,95.84199584199584,95.35689535689535,0.48510048510048875,97.6901351623966,97.61952794028646,0.07060722211014081,A Creuser
3739,0,2019-05-17,101202,DANETTE POP CHOC 3 CHOCO 117X4,0,0,0,DANETTE,0,LeMolay(FR),0080,0024 FR METZ (DC),10101,9914,9685,9678,7,236,229,0,-187,1.8513018513018513,1780,1867,1837,1837,0,30,30,0,87,-4.887640449438202,98.39314408141404,98.39314408141404,0.0,97.6901351623966,97.61952794028646,0.07060722211014081,A Creuser
3740,0,2019-05-17,101202,DANETTE POP CHOC 3 CHOCO 117X4,0,0,0,DANETTE,0,LeMolay(FR),0081,0024 FR TOURS (DC),10101,9914,9685,9678,7,236,229,0,-187,1.8513018513018513,1494,1340,1339,1339,0,1,1,0,-154,10.307898259705489,99.92537313432835,99.92537313432835,0.0,97.6901351623966,97.61952794028646,0.07060722211014081,A Creuser
3741,0,2019-05-17,101202,DANETTE POP CHOC 3 CHOCO 117X4,0,0,0,DANETTE,0,LeMolay(FR),0082,0024 FR VALLET (DC),10101,9914,9685,9678,7,236,229,0,-187,1.8513018513018513,1566,1527,1512,1512,0,15,15,0,-39,2.4904214559386975,99.01768172888016,99.01768172888016,0.0,97.6901351623966,97.61952794028646,0.07060722211014081,A Creuser
3742,0,2019-05-17,101202,DANETTE POP CHOC 3 CHOCO 117X4,0,0,0,DANETTE,0,LeMolay(FR),0077,0024 FR LILPARK (DC),10101,9914,9685,9678,7,236,229,0,-187,1.8513018513018513,600,597,597,597,0,0,0,0,-3,0.5,100.0,100.0,0.0,97.6901351623966,97.61952794028646,0.07060722211014081,A Creuser
3743,0,2019-05-17,101202,DANETTE POP CHOC 3 CHOCO 117X4,0,0,0,DANETTE,0,LeMolay(FR),0085,0024 FR TOULOUSE (DC),10101,9914,9685,9678,7,236,229,0,-187,1.8513018513018513,1385,1305,1191,1191,0,114,114,0,-80,5.776173285198556,91.26436781609195,91.26436781609195,0.0,97.6901351623966,97.61952794028646,0.07060722211014081,A Creuser
3744,0,2019-05-17,101202,DANETTE POP CHOC 3 CHOCO 117X4,0,0,0,DANETTE,0,LeMolay(FR),0083,0024 FR CHAPONNAY (DC),10101,9914,9685,9678,7,236,229,0,-187,1.8513018513018513,772,668,668,668,0,0,0,0,-104,13.471502590673575,100.0,100.0,0.0,97.6901351623966,97.61952794028646,0.07060722211014081,A Creuser
3745,0,2019-05-17,101202,DANETTE POP CHOC 3 CHOCO 117X4,0,0,0,DANETTE,0,LeMolay(FR),0079,0024 FR PARIS SUD (DC),10101,9914,9685,9678,7,236,229,0,-187,1.8513018513018513,788,879,870,870,0,9,9,0,91,-11.548223350253807,98.97610921501706,98.97610921501706,0.0,97.6901351623966,97.61952794028646,0.07060722211014081,A Creuser
3746,0,2019-05-17,101202,DANETTE POP CHOC 3 CHOCO 117X4,0,0,0,DANETTE,0,LeMolay(FR),0078,0024 FR PARIS NORD (DC),10101,9914,9685,9678,7,236,229,0,-187,1.8513018513018513,347,288,288,288,0,0,0,0,-59,17.002881844380404,100.0,100.0,0.0,97.6901351623966,97.61952794028646,0.07060722211014081,A Creuser
3747,0,2019-05-17,130581,TAILLEFINE FRT PANACHE 125X16 OD,1,0,0,TAILLEFINE,0,Villecomtal(FR),0080,0024 FR METZ (DC),1688,844,844,637,207,207,0,0,-844,50.0,844,844,844,637,207,207,0,0,0,0.0,100.0,75.47393364928911,24.52606635071089,100.0,75.47393364928911,24.52606635071089,Previsions
3748,1,2019-05-17,130581,TAILLEFINE FRT PANACHE 125X16 OD,1,0,0,TAILLEFINE,0,Villecomtal(FR),0080,0024 FR METZ (DC),1688,844,844,637,207,207,0,0,-844,50.0,844,844,844,637,207,207,0,0,0,0.0,100.0,75.47393364928911,24.52606635071089,100.0,75.47393364928911,24.52606635071089,Previsions
3749,1,2019-05-17,131423,ACTIVIA ABR PO FI MU/FR 125X8 OD,1,0,0,ACTIVIA,0,Villecomtal(FR),0082,0024 FR VALLET (DC),31,403,403,372,31,31,0,0,372,-1200.0,31,31,31,0,31,31,0,0,0,0.0,100.0,0.0,100.0,100.0,92.3076923076923,7.692307692307693,Déploiement/Quarantaine
3750,0,2019-05-17,146543,L2V BRASS MYRT 115X4,0,1,0,LES 2 VACHES,0,LeMolay(FR),0084,0024 FR AIX (DC),2597,2328,2328,2092,236,236,0,0,-269,10.358105506353485,195,197,197,197,0,0,0,0,2,-1.0256410256410255,100.0,100.0,0.0,100.0,89.86254295532646,10.137457044673539,Production
3751,0,2019-05-17,146543,L2V BRASS MYRT 115X4,0,1,0,LES 2 VACHES,0,LeMolay(FR),0080,0024 FR METZ (DC),2597,2328,2328,2092,236,236,0,0,-269,10.358105506353485,215,180,180,180,0,0,0,0,-35,16.27906976744186,100.0,100.0,0.0,100.0,89.86254295532646,10.137457044673539,Production
3752,0,2019-05-17,146543,L2V BRASS MYRT 115X4,0,1,0,LES 2 VACHES,0,LeMolay(FR),0081,0024 FR TOURS (DC),2597,2328,2328,2092,236,236,0,0,-269,10.358105506353485,388,299,299,299,0,0,0,0,-89,22.938144329896907,100.0,100.0,0.0,100.0,89.86254295532646,10.137457044673539,Production
3753,0,2019-05-17,146543,L2V BRASS MYRT 115X4,0,1,0,LES 2 VACHES,0,LeMolay(FR),0082,0024 FR VALLET (DC),2597,2328,2328,2092,236,236,0,0,-269,10.358105506353485,353,230,230,230,0,0,0,0,-123,34.844192634560905,100.0,100.0,0.0,100.0,89.86254295532646,10.137457044673539,Production
3754,0,2019-05-17,146543,L2V BRASS MYRT 115X4,0,1,0,LES 2 VACHES,0,LeMolay(FR),0077,0024 FR LILPARK (DC),2597,2328,2328,2092,236,236,0,0,-269,10.358105506353485,122,236,236,0,236,236,0,0,114,-93.44262295081967,100.0,0.0,100.0,100.0,89.86254295532646,10.137457044673539,Production
3755,0,2019-05-17,146543,L2V BRASS MYRT 115X4,0,1,0,LES 2 VACHES,0,LeMolay(FR),0085,0024 FR TOULOUSE (DC),2597,2328,2328,2092,236,236,0,0,-269,10.358105506353485,352,258,258,258,0,0,0,0,-94,26.704545454545453,100.0,100.0,0.0,100.0,89.86254295532646,10.137457044673539,Production
3756,0,2019-05-17,146543,L2V BRASS MYRT 115X4,0,1,0,LES 2 VACHES,0,LeMolay(FR),0083,0024 FR CHAPONNAY (DC),2597,2328,2328,2092,236,236,0,0,-269,10.358105506353485,450,316,316,316,0,0,0,0,-134,29.77777777777778,100.0,100.0,0.0,100.0,89.86254295532646,10.137457044673539,Production
3757,0,2019-05-17,146543,L2V BRASS MYRT 115X4,0,1,0,LES 2 VACHES,0,LeMolay(FR),0079,0024 FR PARIS SUD (DC),2597,2328,2328,2092,236,236,0,0,-269,10.358105506353485,349,319,319,319,0,0,0,0,-30,8.595988538681949,100.0,100.0,0.0,100.0,89.86254295532646,10.137457044673539,Production
3758,0,2019-05-17,146543,L2V BRASS MYRT 115X4,0,1,0,LES 2 VACHES,0,LeMolay(FR),0078,0024 FR PARIS NORD (DC),2597,2328,2328,2092,236,236,0,0,-269,10.358105506353485,173,293,293,293,0,0,0,0,120,-69.36416184971098,100.0,100.0,0.0,100.0,89.86254295532646,10.137457044673539,Production
3759,1,2019-05-18,83923,ACTIMEL NATU 3x(14x100g) FR,0,0,0,ACTIMEL,1,Rotselaar(BE),0078,0024 FR PARIS NORD (DC),359,2721,2721,2707,14,14,0,0,2362,-657.9387186629526,359,332,332,319,13,13,0,0,-27,7.520891364902507,100.0,96.08433734939759,3.915662650602414,100.0,99.48548327820654,0.5145167217934556,A Creuser
3760,1,2019-05-18,101201,DANETTE POP SA VA BIL CA 120X4,0,0,0,DANETTE,0,LeMolay(FR),0078,0024 FR PARIS NORD (DC),351,2732,2727,2714,13,18,5,0,2381,-678.3475783475783,351,347,347,334,13,13,0,0,-4,1.1396011396011396,100.0,96.25360230547551,3.7463976945244895,99.81698389458272,99.34114202049781,0.47584187408490664,A Creuser
3761,0,2019-05-18,106828,TAILLEFINE FROMAGE NAT 100X8,0,0,0,TAILLEFINE,0,Ferrières(FR),0084,0024 FR AIX (DC),1218,1315,903,106,797,1209,412,0,97,-7.963875205254515,173,181,181,10,171,171,0,0,8,-4.624277456647399,100.0,5.524861878453039,94.47513812154696,68.66920152091255,8.060836501901141,60.60836501901141,Qualité
3762,0,2019-05-18,106828,TAILLEFINE FROMAGE NAT 100X8,0,0,0,TAILLEFINE,0,Ferrières(FR),0080,0024 FR METZ (DC),1218,1315,903,106,797,1209,412,0,97,-7.963875205254515,67,71,71,71,0,0,0,0,4,-5.970149253731344,100.0,100.0,0.0,68.66920152091255,8.060836501901141,60.60836501901141,Qualité
3763,0,2019-05-18,106828,TAILLEFINE FROMAGE NAT 100X8,0,0,0,TAILLEFINE,0,Ferrières(FR),0081,0024 FR TOURS (DC),1218,1315,903,106,797,1209,412,0,97,-7.963875205254515,259,316,252,0,252,316,64,0,57,-22.00772200772201,79.74683544303798,0.0,79.74683544303798,68.66920152091255,8.060836501901141,60.60836501901141,Qualité
3764,0,2019-05-18,106828,TAILLEFINE FROMAGE NAT 100X8,0,0,0,TAILLEFINE,0,Ferrières(FR),0082,0024 FR VALLET (DC),1218,1315,903,106,797,1209,412,0,97,-7.963875205254515,117,118,46,0,46,118,72,0,1,-0.8547008547008547,38.983050847457626,0.0,38.983050847457626,68.66920152091255,8.060836501901141,60.60836501901141,Qualité
3765,0,2019-05-18,106828,TAILLEFINE FROMAGE NAT 100X8,0,0,0,TAILLEFINE,0,Ferrières(FR),0077,0024 FR LILPARK (DC),1218,1315,903,106,797,1209,412,0,97,-7.963875205254515,136,132,132,0,132,132,0,0,-4,2.9411764705882355,100.0,0.0,100.0,68.66920152091255,8.060836501901141,60.60836501901141,Qualité
3766,0,2019-05-18,106828,TAILLEFINE FROMAGE NAT 100X8,0,0,0,TAILLEFINE,0,Ferrières(FR),0085,0024 FR TOULOUSE (DC),1218,1315,903,106,797,1209,412,0,97,-7.963875205254515,256,312,36,5,31,307,276,0,56,-21.875,11.538461538461538,1.6025641025641024,9.935897435897436,68.66920152091255,8.060836501901141,60.60836501901141,Qualité
3767,0,2019-05-18,106828,TAILLEFINE FROMAGE NAT 100X8,0,0,0,TAILLEFINE,0,Ferrières(FR),0078,0024 FR PARIS NORD (DC),1218,1315,903,106,797,1209,412,0,97,-7.963875205254515,210,185,185,20,165,165,0,0,-25,11.904761904761905,100.0,10.81081081081081,89.1891891891892,68.66920152091255,8.060836501901141,60.60836501901141,Qualité
3768,0,2019-05-18,131413,DANONINO FRTS PANACHE 50X18 OD,1,0,0,DANONINO,0,Ferrières(FR),0084,0024 FR AIX (DC),3886,3335,3335,3181,154,154,0,0,-551,14.17910447761194,325,325,325,325,0,0,0,0,0,0.0,100.0,100.0,0.0,100.0,95.38230884557721,4.617691154422786,A Creuser
3769,0,2019-05-18,131413,DANONINO FRTS PANACHE 50X18 OD,1,0,0,DANONINO,0,Ferrières(FR),0080,0024 FR METZ (DC),3886,3335,3335,3181,154,154,0,0,-551,14.17910447761194,249,250,250,250,0,0,0,0,1,-0.40160642570281124,100.0,100.0,0.0,100.0,95.38230884557721,4.617691154422786,A Creuser
3770,0,2019-05-18,131413,DANONINO FRTS PANACHE 50X18 OD,1,0,0,DANONINO,0,Ferrières(FR),0081,0024 FR TOURS (DC),3886,3335,3335,3181,154,154,0,0,-551,14.17910447761194,202,202,202,202,0,0,0,0,0,0.0,100.0,100.0,0.0,100.0,95.38230884557721,4.617691154422786,A Creuser
3771,0,2019-05-18,131413,DANONINO FRTS PANACHE 50X18 OD,1,0,0,DANONINO,0,Ferrières(FR),0082,0024 FR VALLET (DC),3886,3335,3335,3181,154,154,0,0,-551,14.17910447761194,1,1,1,1,0,0,0,0,0,0.0,100.0,100.0,0.0,100.0,95.38230884557721,4.617691154422786,A Creuser
3772,0,2019-05-18,131413,DANONINO FRTS PANACHE 50X18 OD,1,0,0,DANONINO,0,Ferrières(FR),0077,0024 FR LILPARK (DC),3886,3335,3335,3181,154,154,0,0,-551,14.17910447761194,516,516,516,428,88,88,0,0,0,0.0,100.0,82.94573643410853,17.054263565891475,100.0,95.38230884557721,4.617691154422786,A Creuser
3773,0,2019-05-18,131413,DANONINO FRTS PANACHE 50X18 OD,1,0,0,DANONINO,0,Ferrières(FR),0085,0024 FR TOULOUSE (DC),3886,3335,3335,3181,154,154,0,0,-551,14.17910447761194,189,179,179,179,0,0,0,0,-10,5.291005291005291,100.0,100.0,0.0,100.0,95.38230884557721,4.617691154422786,A Creuser
3774,0,2019-05-18,131413,DANONINO FRTS PANACHE 50X18 OD,1,0,0,DANONINO,0,Ferrières(FR),0083,0024 FR CHAPONNAY (DC),3886,3335,3335,3181,154,154,0,0,-551,14.17910447761194,522,522,522,522,0,0,0,0,0,0.0,100.0,100.0,0.0,100.0,95.38230884557721,4.617691154422786,A Creuser
3775,0,2019-05-18,131413,DANONINO FRTS PANACHE 50X18 OD,1,0,0,DANONINO,0,Ferrières(FR),0079,0024 FR PARIS SUD (DC),3886,3335,3335,3181,154,154,0,0,-551,14.17910447761194,836,837,837,837,0,0,0,0,1,-0.11961722488038277,100.0,100.0,0.0,100.0,95.38230884557721,4.617691154422786,A Creuser
3776,0,2019-05-18,131413,DANONINO FRTS PANACHE 50X18 OD,1,0,0,DANONINO,0,Ferrières(FR),0078,0024 FR PARIS NORD (DC),3886,3335,3335,3181,154,154,0,0,-551,14.17910447761194,523,503,503,437,66,66,0,0,-20,3.8240917782026767,100.0,86.87872763419483,13.121272365805169,100.0,95.38230884557721,4.617691154422786,A Creuser
3777,1,2019-05-18,131413,DANONINO FRTS PANACHE 50X18 OD,1,0,0,DANONINO,0,Ferrières(FR),0078,0024 FR PARIS NORD (DC),3886,3335,3335,3181,154,154,0,0,-551,14.17910447761194,523,503,503,437,66,66,0,0,-20,3.8240917782026767,100.0,86.87872763419483,13.121272365805169,100.0,95.38230884557721,4.617691154422786,A Creuser
3778,1,2019-05-18,137033,ACTIVIA 0% NATURE 125X16 OD,0,0,0,ACTIVIA,0,Bailleul(FR),0079,0024 FR PARIS SUD (DC),133,1060,1060,1035,25,25,0,0,927,-696.9924812030075,133,133,133,108,25,25,0,0,0,0.0,100.0,81.203007518797,18.796992481203006,100.0,97.64150943396226,2.3584905660377444,Déploiement/Quarantaine
3779,1,2019-05-18,137715,DANET LIEG CHOCO 100X8,0,0,0,DANETTE,0,StJust(FR),0078,0024 FR PARIS NORD (DC),327,3501,3312,3290,22,211,189,0,3174,-970.6422018348624,327,338,338,321,17,17,0,0,11,-3.363914373088685,100.0,94.97041420118343,5.029585798816569,94.60154241645245,93.97315052842045,0.6283918880319987,A Creuser
3780,1,2019-05-18,138215,ACTIVIA FRT PANACHE 125X16 OD,1,0,0,ACTIVIA,0,Villecomtal(FR),0078,0024 FR PARIS NORD (DC),914,6348,6280,6270,10,78,68,0,5434,-594.5295404814004,914,916,916,906,10,10,0,0,2,-0.2188183807439825,100.0,98.90829694323145,1.0917030567685515,98.92879647132955,98.77126654064273,0.1575299306868203,A Creuser
3781,1,2019-05-18,138217,ACTIVIA 0% FRTS PAN 125X16 OD,0,0,0,ACTIVIA,0,Villecomtal(FR),0078,0024 FR PARIS NORD (DC),613,4368,4344,4332,12,36,24,0,3755,-612.5611745513867,613,605,605,593,12,12,0,0,-8,1.3050570962479608,100.0,98.01652892561984,1.9834710743801622,99.45054945054946,99.17582417582418,0.2747252747252844,A Creuser
3782,1,2019-05-18,139555,FJORD FRT FRAM CRAN 125X4,0,0,0,FJORD,0,LeMolay(FR),0079,0024 FR PARIS SUD (DC),117,473,370,370,0,103,103,0,356,-304.2735042735043,117,117,92,92,0,25,25,0,0,0.0,78.63247863247864,78.63247863247864,0.0,78.22410147991543,78.22410147991543,0.0,Production
3783,1,2019-05-18,142563,VELOUTE NAT 125X12 OD,1,0,0,VELOUTE,0,StJust(FR),0078,0024 FR PARIS NORD (DC),514,3039,3039,3012,27,27,0,0,2525,-491.2451361867704,514,519,519,492,27,27,0,0,5,-0.9727626459143969,100.0,94.79768786127167,5.202312138728331,100.0,99.11154985192498,0.8884501480750231,A Creuser
3784,0,2019-05-18,146523,L2V BRASS FRAM 115X4,0,1,0,LES 2 VACHES,0,LeMolay(FR),0084,0024 FR AIX (DC),2440,2718,2299,2092,207,626,419,0,278,-11.39344262295082,188,239,116,116,0,123,123,0,51,-27.127659574468087,48.53556485355649,48.53556485355649,0.0,84.58425312729948,76.96835908756438,7.615894039735096,Production
3785,0,2019-05-18,146523,L2V BRASS FRAM 115X4,0,1,0,LES 2 VACHES,0,LeMolay(FR),0080,0024 FR METZ (DC),2440,2718,2299,2092,207,626,419,0,278,-11.39344262295082,97,133,67,67,0,66,66,0,36,-37.11340206185567,50.37593984962406,50.37593984962406,0.0,84.58425312729948,76.96835908756438,7.615894039735096,Production
3786,0,2019-05-18,146523,L2V BRASS FRAM 115X4,0,1,0,LES 2 VACHES,0,LeMolay(FR),0081,0024 FR TOURS (DC),2440,2718,2299,2092,207,626,419,0,278,-11.39344262295082,301,286,286,286,0,0,0,0,-15,4.983388704318937,100.0,100.0,0.0,84.58425312729948,76.96835908756438,7.615894039735096,Production
3787,0,2019-05-18,146523,L2V BRASS FRAM 115X4,0,1,0,LES 2 VACHES,0,LeMolay(FR),0082,0024 FR VALLET (DC),2440,2718,2299,2092,207,626,419,0,278,-11.39344262295082,183,195,195,195,0,0,0,0,12,-6.557377049180328,100.0,100.0,0.0,84.58425312729948,76.96835908756438,7.615894039735096,Production
3788,0,2019-05-18,146523,L2V BRASS FRAM 115X4,0,1,0,LES 2 VACHES,0,LeMolay(FR),0077,0024 FR LILPARK (DC),2440,2718,2299,2092,207,626,419,0,278,-11.39344262295082,70,67,67,67,0,0,0,0,-3,4.285714285714286,100.0,100.0,0.0,84.58425312729948,76.96835908756438,7.615894039735096,Production
3789,0,2019-05-18,146523,L2V BRASS FRAM 115X4,0,1,0,LES 2 VACHES,0,LeMolay(FR),0085,0024 FR TOULOUSE (DC),2440,2718,2299,2092,207,626,419,0,278,-11.39344262295082,136,187,187,187,0,0,0,0,51,-37.5,100.0,100.0,0.0,84.58425312729948,76.96835908756438,7.615894039735096,Production
3790,0,2019-05-18,146523,L2V BRASS FRAM 115X4,0,1,0,LES 2 VACHES,0,LeMolay(FR),0083,0024 FR CHAPONNAY (DC),2440,2718,2299,2092,207,626,419,0,278,-11.39344262295082,330,345,345,345,0,0,0,0,15,-4.545454545454546,100.0,100.0,0.0,84.58425312729948,76.96835908756438,7.615894039735096,Production
3791,0,2019-05-18,146523,L2V BRASS FRAM 115X4,0,1,0,LES 2 VACHES,0,LeMolay(FR),0079,0024 FR PARIS SUD (DC),2440,2718,2299,2092,207,626,419,0,278,-11.39344262295082,370,410,389,182,207,228,21,0,40,-10.81081081081081,94.8780487804878,44.390243902439025,50.48780487804878,84.58425312729948,76.96835908756438,7.615894039735096,Production
3792,0,2019-05-18,146523,L2V BRASS FRAM 115X4,0,1,0,LES 2 VACHES,0,LeMolay(FR),0078,0024 FR PARIS NORD (DC),2440,2718,2299,2092,207,626,419,0,278,-11.39344262295082,765,856,647,647,0,209,209,0,91,-11.895424836601308,75.58411214953271,75.58411214953271,0.0,84.58425312729948,76.96835908756438,7.615894039735096,Production
3793,0,2019-05-20,69190,FJORD NATURE 125GX8,0,0,0,FJORD,0,LeMolay(FR),0084,0024 FR AIX (DC),4238,4381,3931,3929,2,452,450,0,143,-3.374233128834356,523,590,460,458,2,132,130,0,67,-12.810707456978967,77.96610169491525,77.62711864406779,0.3389830508474603,89.72837251769002,89.68272083999086,0.0456516776991549,Production
3794,0,2019-05-20,69190,FJORD NATURE 125GX8,0,0,0,FJORD,0,LeMolay(FR),0081,0024 FR TOURS (DC),4238,4381,3931,3929,2,452,450,0,143,-3.374233128834356,528,476,476,476,0,0,0,0,-52,9.848484848484848,100.0,100.0,0.0,89.72837251769002,89.68272083999086,0.0456516776991549,Production
3795,0,2019-05-20,69190,FJORD NATURE 125GX8,0,0,0,FJORD,0,LeMolay(FR),0082,0024 FR VALLET (DC),4238,4381,3931,3929,2,452,450,0,143,-3.374233128834356,363,358,358,358,0,0,0,0,-5,1.3774104683195592,100.0,100.0,0.0,89.72837251769002,89.68272083999086,0.0456516776991549,Production
3796,0,2019-05-20,69190,FJORD NATURE 125GX8,0,0,0,FJORD,0,LeMolay(FR),0085,0024 FR TOULOUSE (DC),4238,4381,3931,3929,2,452,450,0,143,-3.374233128834356,738,806,655,655,0,151,151,0,68,-9.214092140921409,81.26550868486352,81.26550868486352,0.0,89.72837251769002,89.68272083999086,0.0456516776991549,Production
3797,0,2019-05-20,69190,FJORD NATURE 125GX8,0,0,0,FJORD,0,LeMolay(FR),0083,0024 FR CHAPONNAY (DC),4238,4381,3931,3929,2,452,450,0,143,-3.374233128834356,901,1028,1028,1028,0,0,0,0,127,-14.095449500554938,100.0,100.0,0.0,89.72837251769002,89.68272083999086,0.0456516776991549,Production
3798,0,2019-05-20,69190,FJORD NATURE 125GX8,0,0,0,FJORD,0,LeMolay(FR),0079,0024 FR PARIS SUD (DC),4238,4381,3931,3929,2,452,450,0,143,-3.374233128834356,671,576,576,576,0,0,0,0,-95,14.157973174366617,100.0,100.0,0.0,89.72837251769002,89.68272083999086,0.0456516776991549,Production
3799,0,2019-05-20,69190,FJORD NATURE 125GX8,0,0,0,FJORD,0,LeMolay(FR),0078,0024 FR PARIS NORD (DC),4238,4381,3931,3929,2,452,450,0,143,-3.374233128834356,514,547,378,378,0,169,169,0,33,-6.42023346303502,69.10420475319927,69.10420475319927,0.0,89.72837251769002,89.68272083999086,0.0456516776991549,Production
3800,1,2019-05-20,113943,ACTIVIA NATURE 125X16 OD,1,0,0,ACTIVIA,0,Bailleul(FR),0080,0024 FR METZ (DC),115,1308,1296,1296,0,12,12,0,1193,-1037.391304347826,115,115,103,103,0,12,12,0,0,0.0,89.56521739130436,89.56521739130436,0.0,99.08256880733946,99.08256880733946,0.0,Expe usine
3801,0,2019-05-20,135094,ACTIVIA SAV FRAMBOISE 125X4,0,0,0,ACTIVIA,0,Bailleul(FR),0084,0024 FR AIX (DC),328,722,501,501,0,221,221,0,394,-120.1219512195122,35,46,46,46,0,0,0,0,11,-31.428571428571427,100.0,100.0,0.0,69.39058171745152,69.39058171745152,0.0,Previsions
3802,0,2019-05-20,135094,ACTIVIA SAV FRAMBOISE 125X4,0,0,0,ACTIVIA,0,Bailleul(FR),0080,0024 FR METZ (DC),328,722,501,501,0,221,221,0,394,-120.1219512195122,60,83,83,83,0,0,0,0,23,-38.333333333333336,100.0,100.0,0.0,69.39058171745152,69.39058171745152,0.0,Previsions
3803,0,2019-05-20,135094,ACTIVIA SAV FRAMBOISE 125X4,0,0,0,ACTIVIA,0,Bailleul(FR),0081,0024 FR TOURS (DC),328,722,501,501,0,221,221,0,394,-120.1219512195122,36,39,39,39,0,0,0,0,3,-8.333333333333334,100.0,100.0,0.0,69.39058171745152,69.39058171745152,0.0,Previsions
3804,0,2019-05-20,135094,ACTIVIA SAV FRAMBOISE 125X4,0,0,0,ACTIVIA,0,Bailleul(FR),0082,0024 FR VALLET (DC),328,722,501,501,0,221,221,0,394,-120.1219512195122,39,42,42,42,0,0,0,0,3,-7.6923076923076925,100.0,100.0,0.0,69.39058171745152,69.39058171745152,0.0,Previsions
3805,0,2019-05-20,135094,ACTIVIA SAV FRAMBOISE 125X4,0,0,0,ACTIVIA,0,Bailleul(FR),0077,0024 FR LILPARK (DC),328,722,501,501,0,221,221,0,394,-120.1219512195122,42,15,15,15,0,0,0,0,-27,64.28571428571429,100.0,100.0,0.0,69.39058171745152,69.39058171745152,0.0,Previsions
3806,0,2019-05-20,135094,ACTIVIA SAV FRAMBOISE 125X4,0,0,0,ACTIVIA,0,Bailleul(FR),0085,0024 FR TOULOUSE (DC),328,722,501,501,0,221,221,0,394,-120.1219512195122,24,29,29,29,0,0,0,0,5,-20.833333333333332,100.0,100.0,0.0,69.39058171745152,69.39058171745152,0.0,Previsions
3807,0,2019-05-20,135094,ACTIVIA SAV FRAMBOISE 125X4,0,0,0,ACTIVIA,0,Bailleul(FR),0083,0024 FR CHAPONNAY (DC),328,722,501,501,0,221,221,0,394,-120.1219512195122,52,408,187,187,0,221,221,0,356,-684.6153846153846,45.83333333333333,45.83333333333333,0.0,69.39058171745152,69.39058171745152,0.0,Previsions
3808,0,2019-05-20,135094,ACTIVIA SAV FRAMBOISE 125X4,0,0,0,ACTIVIA,0,Bailleul(FR),0079,0024 FR PARIS SUD (DC),328,722,501,501,0,221,221,0,394,-120.1219512195122,21,24,24,24,0,0,0,0,3,-14.285714285714286,100.0,100.0,0.0,69.39058171745152,69.39058171745152,0.0,Previsions
3809,0,2019-05-20,135094,ACTIVIA SAV FRAMBOISE 125X4,0,0,0,ACTIVIA,0,Bailleul(FR),0078,0024 FR PARIS NORD (DC),328,722,501,501,0,221,221,0,394,-120.1219512195122,19,36,36,36,0,0,0,0,17,-89.47368421052632,100.0,100.0,0.0,69.39058171745152,69.39058171745152,0.0,Previsions
3810,0,2019-05-20,140280,Activia chia/raspb/muesli 170g FR-copack,0,0,0,ACTIVIA,1,Roumanie(RO),0084,0024 FR AIX (DC),693,776,764,444,320,332,12,0,83,-11.976911976911977,82,58,58,20,38,38,0,0,-24,29.26829268292683,100.0,34.48275862068966,65.51724137931035,98.4536082474227,57.21649484536082,41.23711340206187,Transport
3811,0,2019-05-20,140280,Activia chia/raspb/muesli 170g FR-copack,0,0,0,ACTIVIA,1,Roumanie(RO),0080,0024 FR METZ (DC),693,776,764,444,320,332,12,0,83,-11.976911976911977,67,108,108,107,1,1,0,0,41,-61.19402985074627,100.0,99.07407407407408,0.9259259259259238,98.4536082474227,57.21649484536082,41.23711340206187,Transport
3812,0,2019-05-20,140280,Activia chia/raspb/muesli 170g FR-copack,0,0,0,ACTIVIA,1,Roumanie(RO),0081,0024 FR TOURS (DC),693,776,764,444,320,332,12,0,83,-11.976911976911977,56,58,58,58,0,0,0,0,2,-3.5714285714285716,100.0,100.0,0.0,98.4536082474227,57.21649484536082,41.23711340206187,Transport
3813,0,2019-05-20,140280,Activia chia/raspb/muesli 170g FR-copack,0,0,0,ACTIVIA,1,Roumanie(RO),0077,0024 FR LILPARK (DC),693,776,764,444,320,332,12,0,83,-11.976911976911977,77,50,50,0,50,50,0,0,-27,35.064935064935064,100.0,0.0,100.0,98.4536082474227,57.21649484536082,41.23711340206187,Transport
3814,0,2019-05-20,140280,Activia chia/raspb/muesli 170g FR-copack,0,0,0,ACTIVIA,1,Roumanie(RO),0085,0024 FR TOULOUSE (DC),693,776,764,444,320,332,12,0,83,-11.976911976911977,77,81,81,79,2,2,0,0,4,-5.194805194805195,100.0,97.53086419753086,2.4691358024691397,98.4536082474227,57.21649484536082,41.23711340206187,Transport
3815,0,2019-05-20,140280,Activia chia/raspb/muesli 170g FR-copack,0,0,0,ACTIVIA,1,Roumanie(RO),0083,0024 FR CHAPONNAY (DC),693,776,764,444,320,332,12,0,83,-11.976911976911977,126,127,115,0,115,127,12,0,1,-0.7936507936507936,90.5511811023622,0.0,90.5511811023622,98.4536082474227,57.21649484536082,41.23711340206187,Transport
3816,0,2019-05-20,140280,Activia chia/raspb/muesli 170g FR-copack,0,0,0,ACTIVIA,1,Roumanie(RO),0079,0024 FR PARIS SUD (DC),693,776,764,444,320,332,12,0,83,-11.976911976911977,100,80,80,80,0,0,0,0,-20,20.0,100.0,100.0,0.0,98.4536082474227,57.21649484536082,41.23711340206187,Transport
3817,0,2019-05-20,140280,Activia chia/raspb/muesli 170g FR-copack,0,0,0,ACTIVIA,1,Roumanie(RO),0078,0024 FR PARIS NORD (DC),693,776,764,444,320,332,12,0,83,-11.976911976911977,108,214,214,100,114,114,0,0,106,-98.14814814814815,100.0,46.728971962616825,53.271028037383175,98.4536082474227,57.21649484536082,41.23711340206187,Transport
3818,0,2019-05-20,146534,L2V BRASS CIT 115X4,0,1,0,LES 2 VACHES,0,LeMolay(FR),0080,0024 FR METZ (DC),663,834,306,296,10,538,528,0,171,-25.79185520361991,129,117,104,104,0,13,13,0,-12,9.30232558139535,88.88888888888889,88.88888888888889,0.0,36.69064748201439,35.4916067146283,1.1990407673860943,Production
3819,0,2019-05-20,146534,L2V BRASS CIT 115X4,0,1,0,LES 2 VACHES,0,LeMolay(FR),0082,0024 FR VALLET (DC),663,834,306,296,10,538,528,0,171,-25.79185520361991,146,134,15,15,0,119,119,0,-12,8.219178082191782,11.194029850746269,11.194029850746269,0.0,36.69064748201439,35.4916067146283,1.1990407673860943,Production
3820,0,2019-05-20,146534,L2V BRASS CIT 115X4,0,1,0,LES 2 VACHES,0,LeMolay(FR),0077,0024 FR LILPARK (DC),663,834,306,296,10,538,528,0,171,-25.79185520361991,52,91,34,34,0,57,57,0,39,-75.0,37.362637362637365,37.362637362637365,0.0,36.69064748201439,35.4916067146283,1.1990407673860943,Production
3821,0,2019-05-20,146534,L2V BRASS CIT 115X4,0,1,0,LES 2 VACHES,0,LeMolay(FR),0083,0024 FR CHAPONNAY (DC),663,834,306,296,10,538,528,0,171,-25.79185520361991,153,184,21,11,10,173,163,0,31,-20.26143790849673,11.41304347826087,5.978260869565218,5.434782608695651,36.69064748201439,35.4916067146283,1.1990407673860943,Production
3822,0,2019-05-20,146534,L2V BRASS CIT 115X4,0,1,0,LES 2 VACHES,0,LeMolay(FR),0079,0024 FR PARIS SUD (DC),663,834,306,296,10,538,528,0,171,-25.79185520361991,110,154,96,96,0,58,58,0,44,-40.0,62.33766233766234,62.33766233766234,0.0,36.69064748201439,35.4916067146283,1.1990407673860943,Production
3823,0,2019-05-20,146534,L2V BRASS CIT 115X4,0,1,0,LES 2 VACHES,0,LeMolay(FR),0078,0024 FR PARIS NORD (DC),663,834,306,296,10,538,528,0,171,-25.79185520361991,73,154,36,36,0,118,118,0,81,-110.95890410958904,23.376623376623375,23.376623376623375,0.0,36.69064748201439,35.4916067146283,1.1990407673860943,Production
3824,0,2019-05-20,146543,L2V BRASS MYRT 115X4,0,1,0,LES 2 VACHES,0,LeMolay(FR),0084,0024 FR AIX (DC),1770,2167,1545,1466,79,701,622,0,397,-22.429378531073446,84,134,82,78,4,56,52,0,50,-59.523809523809526,61.19402985074627,58.2089552238806,2.985074626865668,71.29672358098755,67.65113059529303,3.6455929856945204,Production
3825,0,2019-05-20,146543,L2V BRASS MYRT 115X4,0,1,0,LES 2 VACHES,0,LeMolay(FR),0080,0024 FR METZ (DC),1770,2167,1545,1466,79,701,622,0,397,-22.429378531073446,199,231,116,116,0,115,115,0,32,-16.08040201005025,50.21645021645021,50.21645021645021,0.0,71.29672358098755,67.65113059529303,3.6455929856945204,Production
3826,0,2019-05-20,146543,L2V BRASS MYRT 115X4,0,1,0,LES 2 VACHES,0,LeMolay(FR),0081,0024 FR TOURS (DC),1770,2167,1545,1466,79,701,622,0,397,-22.429378531073446,271,258,150,148,2,110,108,0,-13,4.797047970479705,58.139534883720934,57.36434108527132,0.7751937984496138,71.29672358098755,67.65113059529303,3.6455929856945204,Production
3827,0,2019-05-20,146543,L2V BRASS MYRT 115X4,0,1,0,LES 2 VACHES,0,LeMolay(FR),0082,0024 FR VALLET (DC),1770,2167,1545,1466,79,701,622,0,397,-22.429378531073446,219,224,164,164,0,60,60,0,5,-2.2831050228310503,73.21428571428571,73.21428571428571,0.0,71.29672358098755,67.65113059529303,3.6455929856945204,Production
3828,0,2019-05-20,146543,L2V BRASS MYRT 115X4,0,1,0,LES 2 VACHES,0,LeMolay(FR),0077,0024 FR LILPARK (DC),1770,2167,1545,1466,79,701,622,0,397,-22.429378531073446,96,299,172,168,4,131,127,0,203,-211.45833333333334,57.52508361204013,56.187290969899664,1.3377926421404638,71.29672358098755,67.65113059529303,3.6455929856945204,Production
3829,0,2019-05-20,146543,L2V BRASS MYRT 115X4,0,1,0,LES 2 VACHES,0,LeMolay(FR),0085,0024 FR TOULOUSE (DC),1770,2167,1545,1466,79,701,622,0,397,-22.429378531073446,277,314,252,252,0,62,62,0,37,-13.35740072202166,80.2547770700637,80.2547770700637,0.0,71.29672358098755,67.65113059529303,3.6455929856945204,Production
3830,0,2019-05-20,146543,L2V BRASS MYRT 115X4,0,1,0,LES 2 VACHES,0,LeMolay(FR),0083,0024 FR CHAPONNAY (DC),1770,2167,1545,1466,79,701,622,0,397,-22.429378531073446,338,348,313,313,0,35,35,0,10,-2.9585798816568047,89.9425287356322,89.9425287356322,0.0,71.29672358098755,67.65113059529303,3.6455929856945204,Production
3831,0,2019-05-20,146543,L2V BRASS MYRT 115X4,0,1,0,LES 2 VACHES,0,LeMolay(FR),0079,0024 FR PARIS SUD (DC),1770,2167,1545,1466,79,701,622,0,397,-22.429378531073446,286,359,296,227,69,132,63,0,73,-25.524475524475523,82.45125348189416,63.231197771587745,19.22005571030641,71.29672358098755,67.65113059529303,3.6455929856945204,Production
3832,0,2019-05-21,101201,DANETTE POP SA VA BIL CA 120X4,0,0,0,DANETTE,0,LeMolay(FR),0084,0024 FR AIX (DC),1924,1140,855,853,2,287,285,0,-784,40.74844074844075,60,42,42,42,0,0,0,0,-18,30.0,100.0,100.0,0.0,75.0,74.82456140350877,0.17543859649123306,A Creuser
3833,0,2019-05-21,101201,DANETTE POP SA VA BIL CA 120X4,0,0,0,DANETTE,0,LeMolay(FR),0080,0024 FR METZ (DC),1924,1140,855,853,2,287,285,0,-784,40.74844074844075,54,65,65,65,0,0,0,0,11,-20.37037037037037,100.0,100.0,0.0,75.0,74.82456140350877,0.17543859649123306,A Creuser
3834,0,2019-05-21,101201,DANETTE POP SA VA BIL CA 120X4,0,0,0,DANETTE,0,LeMolay(FR),0081,0024 FR TOURS (DC),1924,1140,855,853,2,287,285,0,-784,40.74844074844075,369,343,245,243,2,100,98,0,-26,7.046070460704607,71.42857142857143,70.8454810495627,0.5830903790087376,75.0,74.82456140350877,0.17543859649123306,A Creuser
3835,1,2019-05-21,101201,DANETTE POP SA VA BIL CA 120X4,0,0,0,DANETTE,0,LeMolay(FR),0081,0024 FR TOURS (DC),1924,1140,855,853,2,287,285,0,-784,40.74844074844075,369,343,245,243,2,100,98,0,-26,7.046070460704607,71.42857142857143,70.8454810495627,0.5830903790087376,75.0,74.82456140350877,0.17543859649123306,A Creuser
3836,0,2019-05-21,101201,DANETTE POP SA VA BIL CA 120X4,0,0,0,DANETTE,0,LeMolay(FR),0082,0024 FR VALLET (DC),1924,1140,855,853,2,287,285,0,-784,40.74844074844075,66,57,54,54,0,3,3,0,-9,13.636363636363637,94.73684210526315,94.73684210526315,0.0,75.0,74.82456140350877,0.17543859649123306,A Creuser
3837,0,2019-05-21,101201,DANETTE POP SA VA BIL CA 120X4,0,0,0,DANETTE,0,LeMolay(FR),0077,0024 FR LILPARK (DC),1924,1140,855,853,2,287,285,0,-784,40.74844074844075,131,91,25,25,0,66,66,0,-40,30.53435114503817,27.472527472527474,27.472527472527474,0.0,75.0,74.82456140350877,0.17543859649123306,A Creuser
3838,1,2019-05-21,101201,DANETTE POP SA VA BIL CA 120X4,0,0,0,DANETTE,0,LeMolay(FR),0077,0024 FR LILPARK (DC),1924,1140,855,853,2,287,285,0,-784,40.74844074844075,131,91,25,25,0,66,66,0,-40,30.53435114503817,27.472527472527474,27.472527472527474,0.0,75.0,74.82456140350877,0.17543859649123306,A Creuser
3839,0,2019-05-21,101201,DANETTE POP SA VA BIL CA 120X4,0,0,0,DANETTE,0,LeMolay(FR),0085,0024 FR TOULOUSE (DC),1924,1140,855,853,2,287,285,0,-784,40.74844074844075,115,108,10,10,0,98,98,0,-7,6.086956521739131,9.25925925925926,9.25925925925926,0.0,75.0,74.82456140350877,0.17543859649123306,A Creuser
3840,1,2019-05-21,101201,DANETTE POP SA VA BIL CA 120X4,0,0,0,DANETTE,0,LeMolay(FR),0085,0024 FR TOULOUSE (DC),1924,1140,855,853,2,287,285,0,-784,40.74844074844075,115,108,10,10,0,98,98,0,-7,6.086956521739131,9.25925925925926,9.25925925925926,0.0,75.0,74.82456140350877,0.17543859649123306,A Creuser
3841,0,2019-05-21,101201,DANETTE POP SA VA BIL CA 120X4,0,0,0,DANETTE,0,LeMolay(FR),0083,0024 FR CHAPONNAY (DC),1924,1140,855,853,2,287,285,0,-784,40.74844074844075,174,154,152,152,0,2,2,0,-20,11.494252873563218,98.7012987012987,98.7012987012987,0.0,75.0,74.82456140350877,0.17543859649123306,A Creuser
3842,0,2019-05-21,101201,DANETTE POP SA VA BIL CA 120X4,0,0,0,DANETTE,0,LeMolay(FR),0079,0024 FR PARIS SUD (DC),1924,1140,855,853,2,287,285,0,-784,40.74844074844075,97,45,45,45,0,0,0,0,-52,53.608247422680414,100.0,100.0,0.0,75.0,74.82456140350877,0.17543859649123306,A Creuser
3843,0,2019-05-21,101201,DANETTE POP SA VA BIL CA 120X4,0,0,0,DANETTE,0,LeMolay(FR),0078,0024 FR PARIS NORD (DC),1924,1140,855,853,2,287,285,0,-784,40.74844074844075,243,235,217,217,0,18,18,0,-8,3.292181069958848,92.34042553191489,92.34042553191489,0.0,75.0,74.82456140350877,0.17543859649123306,A Creuser
3844,1,2019-05-21,139555,FJORD FRT FRAM CRAN 125X4,0,0,0,FJORD,0,LeMolay(FR),0079,0024 FR PARIS SUD (DC),88,256,69,68,1,188,187,0,168,-190.9090909090909,88,99,11,11,0,88,88,0,11,-12.5,11.11111111111111,11.11111111111111,0.0,26.953125,26.5625,0.390625,Production
3845,0,2019-05-21,147230,L2V GOURMEUH MARRON VAN 115X2,0,1,0,LES 2 VACHES,0,LeMolay(FR),0080,0024 FR METZ (DC),13,42,34,34,0,8,8,0,29,-223.07692307692307,3,16,8,8,0,8,8,0,13,-433.3333333333333,50.0,50.0,0.0,80.95238095238095,80.95238095238095,0.0,Production
3846,0,2019-05-21,147230,L2V GOURMEUH MARRON VAN 115X2,0,1,0,LES 2 VACHES,0,LeMolay(FR),0081,0024 FR TOURS (DC),13,42,34,34,0,8,8,0,29,-223.07692307692307,10,26,26,26,0,0,0,0,16,-160.0,100.0,100.0,0.0,80.95238095238095,80.95238095238095,0.0,Production
3847,0,2019-05-22,25528,DANACOL DR PLAIN 0% 100GX4 FR,0,0,0,DANACOL,1,Aldaya(ES),0084,0024 FR AIX (DC),398,404,198,187,11,217,206,0,6,-1.5075376884422111,54,61,39,39,0,22,22,0,7,-12.962962962962964,63.934426229508205,63.934426229508205,0.0,49.00990099009901,46.28712871287129,2.722772277227726,Production
3848,0,2019-05-22,25528,DANACOL DR PLAIN 0% 100GX4 FR,0,0,0,DANACOL,1,Aldaya(ES),0080,0024 FR METZ (DC),398,404,198,187,11,217,206,0,6,-1.5075376884422111,32,47,16,16,0,31,31,0,15,-46.875,34.04255319148936,34.04255319148936,0.0,49.00990099009901,46.28712871287129,2.722772277227726,Production
3849,0,2019-05-22,25528,DANACOL DR PLAIN 0% 100GX4 FR,0,0,0,DANACOL,1,Aldaya(ES),0081,0024 FR TOURS (DC),398,404,198,187,11,217,206,0,6,-1.5075376884422111,75,72,44,44,0,28,28,0,-3,4.0,61.111111111111114,61.111111111111114,0.0,49.00990099009901,46.28712871287129,2.722772277227726,Production
3850,0,2019-05-22,25528,DANACOL DR PLAIN 0% 100GX4 FR,0,0,0,DANACOL,1,Aldaya(ES),0082,0024 FR VALLET (DC),398,404,198,187,11,217,206,0,6,-1.5075376884422111,35,37,37,26,11,11,0,0,2,-5.714285714285714,100.0,70.27027027027027,29.729729729729726,49.00990099009901,46.28712871287129,2.722772277227726,Production
3851,0,2019-05-22,25528,DANACOL DR PLAIN 0% 100GX4 FR,0,0,0,DANACOL,1,Aldaya(ES),0077,0024 FR LILPARK (DC),398,404,198,187,11,217,206,0,6,-1.5075376884422111,35,17,10,10,0,7,7,0,-18,51.42857142857143,58.82352941176471,58.82352941176471,0.0,49.00990099009901,46.28712871287129,2.722772277227726,Production
3852,0,2019-05-22,25528,DANACOL DR PLAIN 0% 100GX4 FR,0,0,0,DANACOL,1,Aldaya(ES),0085,0024 FR TOULOUSE (DC),398,404,198,187,11,217,206,0,6,-1.5075376884422111,52,50,50,50,0,0,0,0,-2,3.8461538461538463,100.0,100.0,0.0,49.00990099009901,46.28712871287129,2.722772277227726,Production
3853,0,2019-05-22,25528,DANACOL DR PLAIN 0% 100GX4 FR,0,0,0,DANACOL,1,Aldaya(ES),0083,0024 FR CHAPONNAY (DC),398,404,198,187,11,217,206,0,6,-1.5075376884422111,60,68,1,1,0,67,67,0,8,-13.333333333333334,1.4705882352941175,1.4705882352941175,0.0,49.00990099009901,46.28712871287129,2.722772277227726,Production
3854,0,2019-05-22,25528,DANACOL DR PLAIN 0% 100GX4 FR,0,0,0,DANACOL,1,Aldaya(ES),0078,0024 FR PARIS NORD (DC),398,404,198,187,11,217,206,0,6,-1.5075376884422111,55,52,1,1,0,51,51,0,-3,5.454545454545454,1.9230769230769231,1.9230769230769231,0.0,49.00990099009901,46.28712871287129,2.722772277227726,Production
3855,0,2019-05-22,101202,DANETTE POP CHOC 3 CHOCO 117X4,0,0,0,DANETTE,0,LeMolay(FR),0084,0024 FR AIX (DC),2785,2872,2625,2613,12,259,247,0,87,-3.1238779174147218,254,214,214,214,0,0,0,0,-40,15.748031496062993,100.0,100.0,0.0,91.39972144846796,90.98189415041783,0.41782729805012764,A Creuser
3856,0,2019-05-22,101202,DANETTE POP CHOC 3 CHOCO 117X4,0,0,0,DANETTE,0,LeMolay(FR),0080,0024 FR METZ (DC),2785,2872,2625,2613,12,259,247,0,87,-3.1238779174147218,243,206,206,206,0,0,0,0,-37,15.22633744855967,100.0,100.0,0.0,91.39972144846796,90.98189415041783,0.41782729805012764,A Creuser
3857,0,2019-05-22,101202,DANETTE POP CHOC 3 CHOCO 117X4,0,0,0,DANETTE,0,LeMolay(FR),0081,0024 FR TOURS (DC),2785,2872,2625,2613,12,259,247,0,87,-3.1238779174147218,283,199,199,199,0,0,0,0,-84,29.681978798586574,100.0,100.0,0.0,91.39972144846796,90.98189415041783,0.41782729805012764,A Creuser
3858,0,2019-05-22,101202,DANETTE POP CHOC 3 CHOCO 117X4,0,0,0,DANETTE,0,LeMolay(FR),0082,0024 FR VALLET (DC),2785,2872,2625,2613,12,259,247,0,87,-3.1238779174147218,319,314,314,314,0,0,0,0,-5,1.567398119122257,100.0,100.0,0.0,91.39972144846796,90.98189415041783,0.41782729805012764,A Creuser
3859,0,2019-05-22,101202,DANETTE POP CHOC 3 CHOCO 117X4,0,0,0,DANETTE,0,LeMolay(FR),0077,0024 FR LILPARK (DC),2785,2872,2625,2613,12,259,247,0,87,-3.1238779174147218,226,232,232,232,0,0,0,0,6,-2.6548672566371683,100.0,100.0,0.0,91.39972144846796,90.98189415041783,0.41782729805012764,A Creuser
3860,0,2019-05-22,101202,DANETTE POP CHOC 3 CHOCO 117X4,0,0,0,DANETTE,0,LeMolay(FR),0085,0024 FR TOULOUSE (DC),2785,2872,2625,2613,12,259,247,0,87,-3.1238779174147218,450,476,476,476,0,0,0,0,26,-5.777777777777778,100.0,100.0,0.0,91.39972144846796,90.98189415041783,0.41782729805012764,A Creuser
3861,0,2019-05-22,101202,DANETTE POP CHOC 3 CHOCO 117X4,0,0,0,DANETTE,0,LeMolay(FR),0083,0024 FR CHAPONNAY (DC),2785,2872,2625,2613,12,259,247,0,87,-3.1238779174147218,362,299,299,299,0,0,0,0,-63,17.403314917127073,100.0,100.0,0.0,91.39972144846796,90.98189415041783,0.41782729805012764,A Creuser
3862,0,2019-05-22,101202,DANETTE POP CHOC 3 CHOCO 117X4,0,0,0,DANETTE,0,LeMolay(FR),0079,0024 FR PARIS SUD (DC),2785,2872,2625,2613,12,259,247,0,87,-3.1238779174147218,396,696,449,437,12,259,247,0,300,-75.75757575757575,64.51149425287356,62.787356321839084,1.7241379310344769,91.39972144846796,90.98189415041783,0.41782729805012764,A Creuser
3863,0,2019-05-22,101202,DANETTE POP CHOC 3 CHOCO 117X4,0,0,0,DANETTE,0,LeMolay(FR),0078,0024 FR PARIS NORD (DC),2785,2872,2625,2613,12,259,247,0,87,-3.1238779174147218,252,236,236,236,0,0,0,0,-16,6.349206349206349,100.0,100.0,0.0,91.39972144846796,90.98189415041783,0.41782729805012764,A Creuser
3864,0,2019-05-22,127750,DANIO 0% FRAISE 150X1,0,0,0,DANIO,0,Ferrières(FR),0084,0024 FR AIX (DC),301,379,145,118,27,261,234,0,78,-25.91362126245847,68,72,12,0,12,72,60,0,4,-5.882352941176471,16.666666666666664,0.0,16.666666666666664,38.258575197889186,31.13456464379947,7.124010554089715,Qualité
3865,0,2019-05-22,127750,DANIO 0% FRAISE 150X1,0,0,0,DANIO,0,Ferrières(FR),0080,0024 FR METZ (DC),301,379,145,118,27,261,234,0,78,-25.91362126245847,19,34,18,18,0,16,16,0,15,-78.94736842105263,52.94117647058824,52.94117647058824,0.0,38.258575197889186,31.13456464379947,7.124010554089715,Qualité
3866,0,2019-05-22,127750,DANIO 0% FRAISE 150X1,0,0,0,DANIO,0,Ferrières(FR),0081,0024 FR TOURS (DC),301,379,145,118,27,261,234,0,78,-25.91362126245847,43,33,7,0,7,33,26,0,-10,23.25581395348837,21.21212121212121,0.0,21.21212121212121,38.258575197889186,31.13456464379947,7.124010554089715,Qualité
3867,0,2019-05-22,127750,DANIO 0% FRAISE 150X1,0,0,0,DANIO,0,Ferrières(FR),0082,0024 FR VALLET (DC),301,379,145,118,27,261,234,0,78,-25.91362126245847,32,49,49,49,0,0,0,0,17,-53.125,100.0,100.0,0.0,38.258575197889186,31.13456464379947,7.124010554089715,Qualité
3868,0,2019-05-22,127750,DANIO 0% FRAISE 150X1,0,0,0,DANIO,0,Ferrières(FR),0077,0024 FR LILPARK (DC),301,379,145,118,27,261,234,0,78,-25.91362126245847,53,83,6,0,6,83,77,0,30,-56.60377358490566,7.228915662650602,0.0,7.228915662650602,38.258575197889186,31.13456464379947,7.124010554089715,Qualité
3869,0,2019-05-22,127750,DANIO 0% FRAISE 150X1,0,0,0,DANIO,0,Ferrières(FR),0085,0024 FR TOULOUSE (DC),301,379,145,118,27,261,234,0,78,-25.91362126245847,33,57,2,0,2,57,55,0,24,-72.72727272727273,3.508771929824561,0.0,3.508771929824561,38.258575197889186,31.13456464379947,7.124010554089715,Qualité
3870,0,2019-05-22,127750,DANIO 0% FRAISE 150X1,0,0,0,DANIO,0,Ferrières(FR),0083,0024 FR CHAPONNAY (DC),301,379,145,118,27,261,234,0,78,-25.91362126245847,53,51,51,51,0,0,0,0,-2,3.7735849056603774,100.0,100.0,0.0,38.258575197889186,31.13456464379947,7.124010554089715,Qualité
3871,0,2019-05-22,140278,Activia almond/muesli/chia 170g FR-copac,0,0,0,ACTIVIA,1,Roumanie(RO),0082,0024 FR VALLET (DC),203,232,158,73,85,159,74,0,29,-14.285714285714286,61,86,66,7,59,79,20,0,25,-40.98360655737705,76.74418604651163,8.13953488372093,68.6046511627907,68.10344827586206,31.46551724137931,36.637931034482754,Transport
3872,0,2019-05-22,140278,Activia almond/muesli/chia 170g FR-copac,0,0,0,ACTIVIA,1,Roumanie(RO),0077,0024 FR LILPARK (DC),203,232,158,73,85,159,74,0,29,-14.285714285714286,20,25,14,14,0,11,11,0,5,-25.0,56.00000000000001,56.00000000000001,0.0,68.10344827586206,31.46551724137931,36.637931034482754,Transport
3873,0,2019-05-22,140278,Activia almond/muesli/chia 170g FR-copac,0,0,0,ACTIVIA,1,Roumanie(RO),0083,0024 FR CHAPONNAY (DC),203,232,158,73,85,159,74,0,29,-14.285714285714286,66,56,46,39,7,17,10,0,-10,15.151515151515152,82.14285714285714,69.64285714285714,12.5,68.10344827586206,31.46551724137931,36.637931034482754,Transport
3874,0,2019-05-22,140278,Activia almond/muesli/chia 170g FR-copac,0,0,0,ACTIVIA,1,Roumanie(RO),0079,0024 FR PARIS SUD (DC),203,232,158,73,85,159,74,0,29,-14.285714285714286,56,65,32,13,19,52,33,0,9,-16.071428571428573,49.23076923076923,20.0,29.230769230769234,68.10344827586206,31.46551724137931,36.637931034482754,Transport
3875,0,2019-05-22,147230,L2V GOURMEUH MARRON VAN 115X2,0,1,0,LES 2 VACHES,0,LeMolay(FR),0081,0024 FR TOURS (DC),7,56,4,3,1,53,52,0,49,-700.0,7,56,4,3,1,53,52,0,49,-700.0,7.142857142857142,5.357142857142857,1.7857142857142856,7.142857142857142,5.357142857142857,1.7857142857142856,Production
3876,0,2019-05-23,25528,DANACOL DR PLAIN 0% 100GX4 FR,0,0,0,DANACOL,1,Aldaya(ES),0084,0024 FR AIX (DC),172,184,67,22,45,162,117,0,12,-6.976744186046512,52,49,1,1,0,48,48,0,-3,5.769230769230769,2.0408163265306123,2.0408163265306123,0.0,36.41304347826087,11.956521739130435,24.45652173913043,Production
3877,0,2019-05-23,25528,DANACOL DR PLAIN 0% 100GX4 FR,0,0,0,DANACOL,1,Aldaya(ES),0082,0024 FR VALLET (DC),172,184,67,22,45,162,117,0,12,-6.976744186046512,31,25,25,6,19,19,0,0,-6,19.35483870967742,100.0,24.0,76.0,36.41304347826087,11.956521739130435,24.45652173913043,Production
3878,0,2019-05-23,25528,DANACOL DR PLAIN 0% 100GX4 FR,0,0,0,DANACOL,1,Aldaya(ES),0077,0024 FR LILPARK (DC),172,184,67,22,45,162,117,0,12,-6.976744186046512,30,48,15,4,11,44,33,0,18,-60.0,31.25,8.333333333333332,22.916666666666668,36.41304347826087,11.956521739130435,24.45652173913043,Production
3879,0,2019-05-23,25528,DANACOL DR PLAIN 0% 100GX4 FR,0,0,0,DANACOL,1,Aldaya(ES),0085,0024 FR TOULOUSE (DC),172,184,67,22,45,162,117,0,12,-6.976744186046512,59,62,26,11,15,51,36,0,3,-5.084745762711864,41.935483870967744,17.741935483870968,24.193548387096776,36.41304347826087,11.956521739130435,24.45652173913043,Production
3880,0,2019-05-23,127750,DANIO 0% FRAISE 150X1,0,0,0,DANIO,0,Ferrières(FR),0084,0024 FR AIX (DC),155,198,47,34,13,164,151,0,43,-27.741935483870968,43,66,12,0,12,66,54,0,23,-53.48837209302326,18.181818181818183,0.0,18.181818181818183,23.737373737373737,17.17171717171717,6.5656565656565675,Qualité
3881,0,2019-05-23,127750,DANIO 0% FRAISE 150X1,0,0,0,DANIO,0,Ferrières(FR),0082,0024 FR VALLET (DC),155,198,47,34,13,164,151,0,43,-27.741935483870968,28,23,10,10,0,13,13,0,-5,17.857142857142858,43.47826086956522,43.47826086956522,0.0,23.737373737373737,17.17171717171717,6.5656565656565675,Qualité
3882,0,2019-05-23,127750,DANIO 0% FRAISE 150X1,0,0,0,DANIO,0,Ferrières(FR),0085,0024 FR TOULOUSE (DC),155,198,47,34,13,164,151,0,43,-27.741935483870968,36,70,1,0,1,70,69,0,34,-94.44444444444444,1.4285714285714286,0.0,1.4285714285714286,23.737373737373737,17.17171717171717,6.5656565656565675,Qualité
3883,0,2019-05-23,127750,DANIO 0% FRAISE 150X1,0,0,0,DANIO,0,Ferrières(FR),0083,0024 FR CHAPONNAY (DC),155,198,47,34,13,164,151,0,43,-27.741935483870968,48,39,24,24,0,15,15,0,-9,18.75,61.53846153846154,61.53846153846154,0.0,23.737373737373737,17.17171717171717,6.5656565656565675,Qualité
3884,0,2019-05-23,127764,DANIO 0% MYRTILLE 150X1,0,0,0,DANIO,0,Ferrières(FR),0084,0024 FR AIX (DC),264,260,104,103,1,157,156,0,-4,1.5151515151515151,23,18,18,18,0,0,0,0,-5,21.73913043478261,100.0,100.0,0.0,40.0,39.61538461538461,0.3846153846153868,Qualité
3885,0,2019-05-23,127764,DANIO 0% MYRTILLE 150X1,0,0,0,DANIO,0,Ferrières(FR),0080,0024 FR METZ (DC),264,260,104,103,1,157,156,0,-4,1.5151515151515151,25,15,15,15,0,0,0,0,-10,40.0,100.0,100.0,0.0,40.0,39.61538461538461,0.3846153846153868,Qualité
3886,0,2019-05-23,127764,DANIO 0% MYRTILLE 150X1,0,0,0,DANIO,0,Ferrières(FR),0081,0024 FR TOURS (DC),264,260,104,103,1,157,156,0,-4,1.5151515151515151,33,13,13,13,0,0,0,0,-20,60.60606060606061,100.0,100.0,0.0,40.0,39.61538461538461,0.3846153846153868,Qualité
3887,0,2019-05-23,127764,DANIO 0% MYRTILLE 150X1,0,0,0,DANIO,0,Ferrières(FR),0082,0024 FR VALLET (DC),264,260,104,103,1,157,156,0,-4,1.5151515151515151,9,4,4,4,0,0,0,0,-5,55.55555555555556,100.0,100.0,0.0,40.0,39.61538461538461,0.3846153846153868,Qualité
3888,0,2019-05-23,127764,DANIO 0% MYRTILLE 150X1,0,0,0,DANIO,0,Ferrières(FR),0077,0024 FR LILPARK (DC),264,260,104,103,1,157,156,0,-4,1.5151515151515151,15,16,16,16,0,0,0,0,1,-6.666666666666667,100.0,100.0,0.0,40.0,39.61538461538461,0.3846153846153868,Qualité
3889,0,2019-05-23,127764,DANIO 0% MYRTILLE 150X1,0,0,0,DANIO,0,Ferrières(FR),0085,0024 FR TOULOUSE (DC),264,260,104,103,1,157,156,0,-4,1.5151515151515151,19,11,11,11,0,0,0,0,-8,42.10526315789474,100.0,100.0,0.0,40.0,39.61538461538461,0.3846153846153868,Qualité
3890,0,2019-05-23,127764,DANIO 0% MYRTILLE 150X1,0,0,0,DANIO,0,Ferrières(FR),0083,0024 FR CHAPONNAY (DC),264,260,104,103,1,157,156,0,-4,1.5151515151515151,47,26,26,26,0,0,0,0,-21,44.680851063829785,100.0,100.0,0.0,40.0,39.61538461538461,0.3846153846153868,Qualité
3891,0,2019-05-23,127764,DANIO 0% MYRTILLE 150X1,0,0,0,DANIO,0,Ferrières(FR),0078,0024 FR PARIS NORD (DC),264,260,104,103,1,157,156,0,-4,1.5151515151515151,93,157,1,0,1,157,156,0,64,-68.81720430107526,0.6369426751592357,0.0,0.6369426751592357,40.0,39.61538461538461,0.3846153846153868,Qualité
3892,0,2019-05-23,133234,VELOUTE FRUIX PANACHE 125X12 D,1,0,0,VELOUTE,0,Villecomtal(FR),0084,0024 FR AIX (DC),2729,2928,2612,2612,0,316,316,0,199,-7.292048369366068,176,432,432,432,0,0,0,0,256,-145.45454545454547,100.0,100.0,0.0,89.20765027322405,89.20765027322405,0.0,A Creuser
3893,0,2019-05-23,133234,VELOUTE FRUIX PANACHE 125X12 D,1,0,0,VELOUTE,0,Villecomtal(FR),0080,0024 FR METZ (DC),2729,2928,2612,2612,0,316,316,0,199,-7.292048369366068,280,336,336,336,0,0,0,0,56,-20.0,100.0,100.0,0.0,89.20765027322405,89.20765027322405,0.0,A Creuser
3894,0,2019-05-23,133234,VELOUTE FRUIX PANACHE 125X12 D,1,0,0,VELOUTE,0,Villecomtal(FR),0081,0024 FR TOURS (DC),2729,2928,2612,2612,0,316,316,0,199,-7.292048369366068,190,144,144,144,0,0,0,0,-46,24.210526315789473,100.0,100.0,0.0,89.20765027322405,89.20765027322405,0.0,A Creuser
3895,0,2019-05-23,133234,VELOUTE FRUIX PANACHE 125X12 D,1,0,0,VELOUTE,0,Villecomtal(FR),0077,0024 FR LILPARK (DC),2729,2928,2612,2612,0,316,316,0,199,-7.292048369366068,478,288,288,288,0,0,0,0,-190,39.7489539748954,100.0,100.0,0.0,89.20765027322405,89.20765027322405,0.0,A Creuser
3896,0,2019-05-23,133234,VELOUTE FRUIX PANACHE 125X12 D,1,0,0,VELOUTE,0,Villecomtal(FR),0085,0024 FR TOULOUSE (DC),2729,2928,2612,2612,0,316,316,0,199,-7.292048369366068,340,432,156,156,0,276,276,0,92,-27.058823529411764,36.11111111111111,36.11111111111111,0.0,89.20765027322405,89.20765027322405,0.0,A Creuser
3897,0,2019-05-23,133234,VELOUTE FRUIX PANACHE 125X12 D,1,0,0,VELOUTE,0,Villecomtal(FR),0083,0024 FR CHAPONNAY (DC),2729,2928,2612,2612,0,316,316,0,199,-7.292048369366068,671,576,576,576,0,0,0,0,-95,14.157973174366617,100.0,100.0,0.0,89.20765027322405,89.20765027322405,0.0,A Creuser
3898,0,2019-05-23,133234,VELOUTE FRUIX PANACHE 125X12 D,1,0,0,VELOUTE,0,Villecomtal(FR),0079,0024 FR PARIS SUD (DC),2729,2928,2612,2612,0,316,316,0,199,-7.292048369366068,167,288,248,248,0,40,40,0,121,-72.45508982035928,86.11111111111111,86.11111111111111,0.0,89.20765027322405,89.20765027322405,0.0,A Creuser
3899,0,2019-05-23,133234,VELOUTE FRUIX PANACHE 125X12 D,1,0,0,VELOUTE,0,Villecomtal(FR),0078,0024 FR PARIS NORD (DC),2729,2928,2612,2612,0,316,316,0,199,-7.292048369366068,427,432,432,432,0,0,0,0,5,-1.17096018735363,100.0,100.0,0.0,89.20765027322405,89.20765027322405,0.0,A Creuser
3900,0,2019-05-23,139104,ALPRO COCONUT-ALMOND DRINK 8X1L,0,0,0,ALPRO,1,Wevelgem(BE),0084,0024 FR AIX (DC),137,389,389,132,257,257,0,0,252,-183.94160583941607,72,85,85,85,0,0,0,0,13,-18.055555555555557,100.0,100.0,0.0,100.0,33.933161953727506,66.0668380462725,A Creuser
3901,0,2019-05-23,139104,ALPRO COCONUT-ALMOND DRINK 8X1L,0,0,0,ALPRO,1,Wevelgem(BE),0081,0024 FR TOURS (DC),137,389,389,132,257,257,0,0,252,-183.94160583941607,49,32,32,32,0,0,0,0,-17,34.69387755102041,100.0,100.0,0.0,100.0,33.933161953727506,66.0668380462725,A Creuser
3902,0,2019-05-23,139104,ALPRO COCONUT-ALMOND DRINK 8X1L,0,0,0,ALPRO,1,Wevelgem(BE),0077,0024 FR LILPARK (DC),137,389,389,132,257,257,0,0,252,-183.94160583941607,2,3,3,3,0,0,0,0,1,-50.0,100.0,100.0,0.0,100.0,33.933161953727506,66.0668380462725,A Creuser
3903,0,2019-05-23,139104,ALPRO COCONUT-ALMOND DRINK 8X1L,0,0,0,ALPRO,1,Wevelgem(BE),0085,0024 FR TOULOUSE (DC),137,389,389,132,257,257,0,0,252,-183.94160583941607,7,3,3,3,0,0,0,0,-4,57.142857142857146,100.0,100.0,0.0,100.0,33.933161953727506,66.0668380462725,A Creuser
3904,0,2019-05-23,139104,ALPRO COCONUT-ALMOND DRINK 8X1L,0,0,0,ALPRO,1,Wevelgem(BE),0079,0024 FR PARIS SUD (DC),137,389,389,132,257,257,0,0,252,-183.94160583941607,7,9,9,9,0,0,0,0,2,-28.571428571428573,100.0,100.0,0.0,100.0,33.933161953727506,66.0668380462725,A Creuser
3905,1,2019-05-23,139139,ALPRO SOJA PEACH 150X1,0,0,0,ALPRO,1,Wevelgem(BE),0084,0024 FR AIX (DC),47,105,105,72,33,33,0,0,58,-123.40425531914893,47,44,44,11,33,33,0,0,-3,6.382978723404255,100.0,25.0,75.0,100.0,68.57142857142857,31.42857142857143,A Creuser
3906,0,2019-05-24,120160,DANONE FERME NATURE 125X8,0,0,0,DANONE,0,Bailleul(FR),0084,0024 FR AIX (DC),3609,3353,3224,3079,145,274,129,0,-256,7.093377666943752,547,447,429,426,3,21,18,0,-100,18.281535648994517,95.9731543624161,95.30201342281879,0.6711409395973078,96.15269907545482,91.82821354011334,4.324485535341481,A Creuser
3907,0,2019-05-24,120160,DANONE FERME NATURE 125X8,0,0,0,DANONE,0,Bailleul(FR),0080,0024 FR METZ (DC),3609,3353,3224,3079,145,274,129,0,-256,7.093377666943752,229,231,231,231,0,0,0,0,2,-0.8733624454148472,100.0,100.0,0.0,96.15269907545482,91.82821354011334,4.324485535341481,A Creuser
3908,0,2019-05-24,120160,DANONE FERME NATURE 125X8,0,0,0,DANONE,0,Bailleul(FR),0081,0024 FR TOURS (DC),3609,3353,3224,3079,145,274,129,0,-256,7.093377666943752,567,518,518,413,105,105,0,0,-49,8.641975308641975,100.0,79.72972972972973,20.270270270270274,96.15269907545482,91.82821354011334,4.324485535341481,A Creuser
3909,0,2019-05-24,120160,DANONE FERME NATURE 125X8,0,0,0,DANONE,0,Bailleul(FR),0082,0024 FR VALLET (DC),3609,3353,3224,3079,145,274,129,0,-256,7.093377666943752,428,373,373,373,0,0,0,0,-55,12.850467289719626,100.0,100.0,0.0,96.15269907545482,91.82821354011334,4.324485535341481,A Creuser
3910,0,2019-05-24,120160,DANONE FERME NATURE 125X8,0,0,0,DANONE,0,Bailleul(FR),0077,0024 FR LILPARK (DC),3609,3353,3224,3079,145,274,129,0,-256,7.093377666943752,102,130,130,130,0,0,0,0,28,-27.45098039215686,100.0,100.0,0.0,96.15269907545482,91.82821354011334,4.324485535341481,A Creuser
3911,0,2019-05-24,120160,DANONE FERME NATURE 125X8,0,0,0,DANONE,0,Bailleul(FR),0085,0024 FR TOULOUSE (DC),3609,3353,3224,3079,145,274,129,0,-256,7.093377666943752,363,314,314,314,0,0,0,0,-49,13.49862258953168,100.0,100.0,0.0,96.15269907545482,91.82821354011334,4.324485535341481,A Creuser
3912,0,2019-05-24,120160,DANONE FERME NATURE 125X8,0,0,0,DANONE,0,Bailleul(FR),0083,0024 FR CHAPONNAY (DC),3609,3353,3224,3079,145,274,129,0,-256,7.093377666943752,599,476,476,476,0,0,0,0,-123,20.534223706176963,100.0,100.0,0.0,96.15269907545482,91.82821354011334,4.324485535341481,A Creuser
3913,0,2019-05-24,120160,DANONE FERME NATURE 125X8,0,0,0,DANONE,0,Bailleul(FR),0079,0024 FR PARIS SUD (DC),3609,3353,3224,3079,145,274,129,0,-256,7.093377666943752,316,307,307,307,0,0,0,0,-9,2.848101265822785,100.0,100.0,0.0,96.15269907545482,91.82821354011334,4.324485535341481,A Creuser
3914,0,2019-05-24,120160,DANONE FERME NATURE 125X8,0,0,0,DANONE,0,Bailleul(FR),0078,0024 FR PARIS NORD (DC),3609,3353,3224,3079,145,274,129,0,-256,7.093377666943752,458,557,446,409,37,148,111,0,99,-21.61572052401747,80.07181328545781,73.4290843806104,6.642728904847402,96.15269907545482,91.82821354011334,4.324485535341481,A Creuser
3915,1,2019-05-24,122050,VELOUTE FRUIX ROUGES 125X8 OD,1,0,0,VELOUTE,0,Villecomtal(FR),0084,0024 FR AIX (DC),1202,11805,11803,11791,12,14,2,0,10603,-882.1131447587354,1202,1168,1166,1154,12,14,2,0,-34,2.8286189683860234,99.82876712328768,98.8013698630137,1.0273972602739718,99.98305802626007,99.88140618382042,0.10165184243965086,Transport
3916,0,2019-05-24,127750,DANIO 0% FRAISE 150X1,0,0,0,DANIO,0,Ferrières(FR),0084,0024 FR AIX (DC),176,235,22,5,17,230,213,0,59,-33.52272727272727,48,78,13,0,13,78,65,0,30,-62.5,16.666666666666664,0.0,16.666666666666664,9.361702127659575,2.127659574468085,7.23404255319149,Qualité
3917,0,2019-05-24,127750,DANIO 0% FRAISE 150X1,0,0,0,DANIO,0,Ferrières(FR),0082,0024 FR VALLET (DC),176,235,22,5,17,230,213,0,59,-33.52272727272727,40,35,2,2,0,33,33,0,-5,12.5,5.714285714285714,5.714285714285714,0.0,9.361702127659575,2.127659574468085,7.23404255319149,Qualité
3918,0,2019-05-24,127750,DANIO 0% FRAISE 150X1,0,0,0,DANIO,0,Ferrières(FR),0085,0024 FR TOULOUSE (DC),176,235,22,5,17,230,213,0,59,-33.52272727272727,24,84,4,0,4,84,80,0,60,-250.0,4.761904761904762,0.0,4.761904761904762,9.361702127659575,2.127659574468085,7.23404255319149,Qualité
3919,0,2019-05-24,127750,DANIO 0% FRAISE 150X1,0,0,0,DANIO,0,Ferrières(FR),0083,0024 FR CHAPONNAY (DC),176,235,22,5,17,230,213,0,59,-33.52272727272727,64,38,3,3,0,35,35,0,-26,40.625,7.894736842105263,7.894736842105263,0.0,9.361702127659575,2.127659574468085,7.23404255319149,Qualité
3920,0,2019-05-24,127764,DANIO 0% MYRTILLE 150X1,0,0,0,DANIO,0,Ferrières(FR),0084,0024 FR AIX (DC),205,175,133,132,1,43,42,0,-30,14.634146341463415,25,33,33,33,0,0,0,0,8,-32.0,100.0,100.0,0.0,76.0,75.42857142857143,0.5714285714285694,Qualité
3921,0,2019-05-24,127764,DANIO 0% MYRTILLE 150X1,0,0,0,DANIO,0,Ferrières(FR),0080,0024 FR METZ (DC),205,175,133,132,1,43,42,0,-30,14.634146341463415,18,22,22,22,0,0,0,0,4,-22.22222222222222,100.0,100.0,0.0,76.0,75.42857142857143,0.5714285714285694,Qualité
3922,0,2019-05-24,127764,DANIO 0% MYRTILLE 150X1,0,0,0,DANIO,0,Ferrières(FR),0081,0024 FR TOURS (DC),205,175,133,132,1,43,42,0,-30,14.634146341463415,22,16,16,16,0,0,0,0,-6,27.272727272727273,100.0,100.0,0.0,76.0,75.42857142857143,0.5714285714285694,Qualité
3923,0,2019-05-24,127764,DANIO 0% MYRTILLE 150X1,0,0,0,DANIO,0,Ferrières(FR),0082,0024 FR VALLET (DC),205,175,133,132,1,43,42,0,-30,14.634146341463415,19,6,6,6,0,0,0,0,-13,68.42105263157895,100.0,100.0,0.0,76.0,75.42857142857143,0.5714285714285694,Qualité
3924,0,2019-05-24,127764,DANIO 0% MYRTILLE 150X1,0,0,0,DANIO,0,Ferrières(FR),0077,0024 FR LILPARK (DC),205,175,133,132,1,43,42,0,-30,14.634146341463415,28,13,13,13,0,0,0,0,-15,53.57142857142857,100.0,100.0,0.0,76.0,75.42857142857143,0.5714285714285694,Qualité
3925,0,2019-05-24,127764,DANIO 0% MYRTILLE 150X1,0,0,0,DANIO,0,Ferrières(FR),0085,0024 FR TOULOUSE (DC),205,175,133,132,1,43,42,0,-30,14.634146341463415,16,6,6,6,0,0,0,0,-10,62.5,100.0,100.0,0.0,76.0,75.42857142857143,0.5714285714285694,Qualité
3926,0,2019-05-24,127764,DANIO 0% MYRTILLE 150X1,0,0,0,DANIO,0,Ferrières(FR),0083,0024 FR CHAPONNAY (DC),205,175,133,132,1,43,42,0,-30,14.634146341463415,41,36,36,36,0,0,0,0,-5,12.195121951219512,100.0,100.0,0.0,76.0,75.42857142857143,0.5714285714285694,Qualité
3927,0,2019-05-24,127764,DANIO 0% MYRTILLE 150X1,0,0,0,DANIO,0,Ferrières(FR),0078,0024 FR PARIS NORD (DC),205,175,133,132,1,43,42,0,-30,14.634146341463415,36,43,1,0,1,43,42,0,7,-19.444444444444443,2.3255813953488373,0.0,2.3255813953488373,76.0,75.42857142857143,0.5714285714285694,Qualité
3928,0,2019-05-24,133234,VELOUTE FRUIX PANACHE 125X12 D,1,0,0,VELOUTE,0,Villecomtal(FR),0084,0024 FR AIX (DC),2135,1728,1728,1506,222,222,0,0,-407,19.063231850117095,366,144,144,144,0,0,0,0,-222,60.65573770491803,100.0,100.0,0.0,100.0,87.15277777777779,12.847222222222214,Production
3929,0,2019-05-24,133234,VELOUTE FRUIX PANACHE 125X12 D,1,0,0,VELOUTE,0,Villecomtal(FR),0080,0024 FR METZ (DC),2135,1728,1728,1506,222,222,0,0,-407,19.063231850117095,266,288,288,288,0,0,0,0,22,-8.270676691729323,100.0,100.0,0.0,100.0,87.15277777777779,12.847222222222214,Production
3930,0,2019-05-24,133234,VELOUTE FRUIX PANACHE 125X12 D,1,0,0,VELOUTE,0,Villecomtal(FR),0081,0024 FR TOURS (DC),2135,1728,1728,1506,222,222,0,0,-407,19.063231850117095,201,144,144,144,0,0,0,0,-57,28.35820895522388,100.0,100.0,0.0,100.0,87.15277777777779,12.847222222222214,Production
3931,0,2019-05-24,133234,VELOUTE FRUIX PANACHE 125X12 D,1,0,0,VELOUTE,0,Villecomtal(FR),0082,0024 FR VALLET (DC),2135,1728,1728,1506,222,222,0,0,-407,19.063231850117095,121,288,288,288,0,0,0,0,167,-138.01652892561984,100.0,100.0,0.0,100.0,87.15277777777779,12.847222222222214,Production
3932,0,2019-05-24,133234,VELOUTE FRUIX PANACHE 125X12 D,1,0,0,VELOUTE,0,Villecomtal(FR),0085,0024 FR TOULOUSE (DC),2135,1728,1728,1506,222,222,0,0,-407,19.063231850117095,201,288,288,66,222,222,0,0,87,-43.28358208955224,100.0,22.916666666666664,77.08333333333334,100.0,87.15277777777779,12.847222222222214,Production
3933,0,2019-05-24,133234,VELOUTE FRUIX PANACHE 125X12 D,1,0,0,VELOUTE,0,Villecomtal(FR),0083,0024 FR CHAPONNAY (DC),2135,1728,1728,1506,222,222,0,0,-407,19.063231850117095,236,288,288,288,0,0,0,0,52,-22.033898305084747,100.0,100.0,0.0,100.0,87.15277777777779,12.847222222222214,Production
3934,0,2019-05-24,133234,VELOUTE FRUIX PANACHE 125X12 D,1,0,0,VELOUTE,0,Villecomtal(FR),0079,0024 FR PARIS SUD (DC),2135,1728,1728,1506,222,222,0,0,-407,19.063231850117095,251,144,144,144,0,0,0,0,-107,42.62948207171315,100.0,100.0,0.0,100.0,87.15277777777779,12.847222222222214,Production
3935,0,2019-05-24,133234,VELOUTE FRUIX PANACHE 125X12 D,1,0,0,VELOUTE,0,Villecomtal(FR),0078,0024 FR PARIS NORD (DC),2135,1728,1728,1506,222,222,0,0,-407,19.063231850117095,493,144,144,144,0,0,0,0,-349,70.79107505070994,100.0,100.0,0.0,100.0,87.15277777777779,12.847222222222214,Production
3936,1,2019-05-24,139408,ALPRO COCO DRINK CHOCOLATE 1LX8,0,0,0,ALPRO,1,Wevelgem(BE),0080,0024 FR METZ (DC),157,274,273,190,83,84,1,0,117,-74.52229299363057,60,59,59,45,14,14,0,0,-1,1.6666666666666667,100.0,76.27118644067797,23.728813559322035,99.63503649635037,69.34306569343066,30.291970802919707,A Creuser
3937,1,2019-05-24,139408,ALPRO COCO DRINK CHOCOLATE 1LX8,0,0,0,ALPRO,1,Wevelgem(BE),0081,0024 FR TOURS (DC),157,274,273,190,83,84,1,0,117,-74.52229299363057,45,22,22,0,22,22,0,0,-23,51.111111111111114,100.0,0.0,100.0,99.63503649635037,69.34306569343066,30.291970802919707,A Creuser
3938,1,2019-05-24,139408,ALPRO COCO DRINK CHOCOLATE 1LX8,0,0,0,ALPRO,1,Wevelgem(BE),0085,0024 FR TOULOUSE (DC),157,274,273,190,83,84,1,0,117,-74.52229299363057,52,50,49,19,30,31,1,0,-2,3.8461538461538463,98.0,38.0,60.0,99.63503649635037,69.34306569343066,30.291970802919707,A Creuser
3939,0,2019-05-24,146534,L2V BRASS CIT 115X4,0,1,0,LES 2 VACHES,0,LeMolay(FR),0084,0024 FR AIX (DC),3400,2965,2685,2684,1,281,280,0,-435,12.794117647058824,401,377,314,314,0,63,63,0,-24,5.985037406483791,83.28912466843501,83.28912466843501,0.0,90.55649241146712,90.52276559865092,0.03372681281619805,Production
3940,0,2019-05-24,146534,L2V BRASS CIT 115X4,0,1,0,LES 2 VACHES,0,LeMolay(FR),0080,0024 FR METZ (DC),3400,2965,2685,2684,1,281,280,0,-435,12.794117647058824,135,133,133,133,0,0,0,0,-2,1.4814814814814814,100.0,100.0,0.0,90.55649241146712,90.52276559865092,0.03372681281619805,Production
3941,0,2019-05-24,146534,L2V BRASS CIT 115X4,0,1,0,LES 2 VACHES,0,LeMolay(FR),0081,0024 FR TOURS (DC),3400,2965,2685,2684,1,281,280,0,-435,12.794117647058824,322,299,231,231,0,68,68,0,-23,7.142857142857143,77.25752508361204,77.25752508361204,0.0,90.55649241146712,90.52276559865092,0.03372681281619805,Production
3942,0,2019-05-24,146534,L2V BRASS CIT 115X4,0,1,0,LES 2 VACHES,0,LeMolay(FR),0082,0024 FR VALLET (DC),3400,2965,2685,2684,1,281,280,0,-435,12.794117647058824,336,249,249,249,0,0,0,0,-87,25.892857142857142,100.0,100.0,0.0,90.55649241146712,90.52276559865092,0.03372681281619805,Production
3943,0,2019-05-24,146534,L2V BRASS CIT 115X4,0,1,0,LES 2 VACHES,0,LeMolay(FR),0077,0024 FR LILPARK (DC),3400,2965,2685,2684,1,281,280,0,-435,12.794117647058824,367,362,341,340,1,22,21,0,-5,1.3623978201634876,94.1988950276243,93.92265193370166,0.2762430939226448,90.55649241146712,90.52276559865092,0.03372681281619805,Production
3944,0,2019-05-24,146534,L2V BRASS CIT 115X4,0,1,0,LES 2 VACHES,0,LeMolay(FR),0085,0024 FR TOULOUSE (DC),3400,2965,2685,2684,1,281,280,0,-435,12.794117647058824,529,479,472,472,0,7,7,0,-50,9.45179584120983,98.53862212943632,98.53862212943632,0.0,90.55649241146712,90.52276559865092,0.03372681281619805,Production
3945,0,2019-05-24,146534,L2V BRASS CIT 115X4,0,1,0,LES 2 VACHES,0,LeMolay(FR),0083,0024 FR CHAPONNAY (DC),3400,2965,2685,2684,1,281,280,0,-435,12.794117647058824,427,402,402,402,0,0,0,0,-25,5.85480093676815,100.0,100.0,0.0,90.55649241146712,90.52276559865092,0.03372681281619805,Production
3946,0,2019-05-24,146534,L2V BRASS CIT 115X4,0,1,0,LES 2 VACHES,0,LeMolay(FR),0079,0024 FR PARIS SUD (DC),3400,2965,2685,2684,1,281,280,0,-435,12.794117647058824,632,522,444,444,0,78,78,0,-110,17.40506329113924,85.0574712643678,85.0574712643678,0.0,90.55649241146712,90.52276559865092,0.03372681281619805,Production
3947,0,2019-05-24,146534,L2V BRASS CIT 115X4,0,1,0,LES 2 VACHES,0,LeMolay(FR),0078,0024 FR PARIS NORD (DC),3400,2965,2685,2684,1,281,280,0,-435,12.794117647058824,251,142,99,99,0,43,43,0,-109,43.42629482071713,69.71830985915493,69.71830985915493,0.0,90.55649241146712,90.52276559865092,0.03372681281619805,Production
3948,0,2019-05-24,146543,L2V BRASS MYRT 115X4,0,1,0,LES 2 VACHES,0,LeMolay(FR),0084,0024 FR AIX (DC),5205,4879,3362,3360,2,1519,1517,0,-326,6.263208453410183,541,531,309,309,0,222,222,0,-10,1.8484288354898337,58.19209039548022,58.19209039548022,0.0,68.90756302521008,68.86657101865137,0.04099200655871016,Production
3949,0,2019-05-24,146543,L2V BRASS MYRT 115X4,0,1,0,LES 2 VACHES,0,LeMolay(FR),0080,0024 FR METZ (DC),5205,4879,3362,3360,2,1519,1517,0,-326,6.263208453410183,204,236,54,52,2,184,182,0,32,-15.686274509803921,22.88135593220339,22.033898305084744,0.8474576271186471,68.90756302521008,68.86657101865137,0.04099200655871016,Production
3950,0,2019-05-24,146543,L2V BRASS MYRT 115X4,0,1,0,LES 2 VACHES,0,LeMolay(FR),0081,0024 FR TOURS (DC),5205,4879,3362,3360,2,1519,1517,0,-326,6.263208453410183,404,445,74,74,0,371,371,0,41,-10.148514851485148,16.629213483146067,16.629213483146067,0.0,68.90756302521008,68.86657101865137,0.04099200655871016,Production
3951,0,2019-05-24,146543,L2V BRASS MYRT 115X4,0,1,0,LES 2 VACHES,0,LeMolay(FR),0082,0024 FR VALLET (DC),5205,4879,3362,3360,2,1519,1517,0,-326,6.263208453410183,438,306,306,306,0,0,0,0,-132,30.136986301369863,100.0,100.0,0.0,68.90756302521008,68.86657101865137,0.04099200655871016,Production
3952,0,2019-05-24,146543,L2V BRASS MYRT 115X4,0,1,0,LES 2 VACHES,0,LeMolay(FR),0077,0024 FR LILPARK (DC),5205,4879,3362,3360,2,1519,1517,0,-326,6.263208453410183,1056,1030,925,925,0,105,105,0,-26,2.462121212121212,89.80582524271846,89.80582524271846,0.0,68.90756302521008,68.86657101865137,0.04099200655871016,Production
3953,0,2019-05-24,146543,L2V BRASS MYRT 115X4,0,1,0,LES 2 VACHES,0,LeMolay(FR),0085,0024 FR TOULOUSE (DC),5205,4879,3362,3360,2,1519,1517,0,-326,6.263208453410183,706,595,396,396,0,199,199,0,-111,15.722379603399434,66.55462184873949,66.55462184873949,0.0,68.90756302521008,68.86657101865137,0.04099200655871016,Production
3954,0,2019-05-24,146543,L2V BRASS MYRT 115X4,0,1,0,LES 2 VACHES,0,LeMolay(FR),0083,0024 FR CHAPONNAY (DC),5205,4879,3362,3360,2,1519,1517,0,-326,6.263208453410183,629,633,621,621,0,12,12,0,4,-0.6359300476947536,98.10426540284361,98.10426540284361,0.0,68.90756302521008,68.86657101865137,0.04099200655871016,Production
3955,0,2019-05-24,146543,L2V BRASS MYRT 115X4,0,1,0,LES 2 VACHES,0,LeMolay(FR),0079,0024 FR PARIS SUD (DC),5205,4879,3362,3360,2,1519,1517,0,-326,6.263208453410183,830,902,476,476,0,426,426,0,72,-8.674698795180722,52.77161862527716,52.77161862527716,0.0,68.90756302521008,68.86657101865137,0.04099200655871016,Production
3956,0,2019-05-24,146543,L2V BRASS MYRT 115X4,0,1,0,LES 2 VACHES,0,LeMolay(FR),0078,0024 FR PARIS NORD (DC),5205,4879,3362,3360,2,1519,1517,0,-326,6.263208453410183,397,201,201,201,0,0,0,0,-196,49.37027707808564,100.0,100.0,0.0,68.90756302521008,68.86657101865137,0.04099200655871016,Production
3957,0,2019-05-24,147199,L2V GOURMEUH POM CARA 115X2,0,1,0,LES 2 VACHES,0,LeMolay(FR),0085,0024 FR TOULOUSE (DC),38,94,17,16,1,78,77,0,56,-147.3684210526316,35,58,13,12,1,46,45,0,23,-65.71428571428571,22.413793103448278,20.689655172413794,1.724137931034484,18.085106382978726,17.02127659574468,1.0638297872340452,Qualité
3958,0,2019-05-24,147199,L2V GOURMEUH POM CARA 115X2,0,1,0,LES 2 VACHES,0,LeMolay(FR),0079,0024 FR PARIS SUD (DC),38,94,17,16,1,78,77,0,56,-147.3684210526316,3,36,4,4,0,32,32,0,33,-1100.0,11.11111111111111,11.11111111111111,0.0,18.085106382978726,17.02127659574468,1.0638297872340452,Qualité
3959,0,2019-05-24,147230,L2V GOURMEUH MARRON VAN 115X2,0,1,0,LES 2 VACHES,0,LeMolay(FR),0079,0024 FR PARIS SUD (DC),9,77,40,40,0,37,37,0,68,-755.5555555555555,9,77,40,40,0,37,37,0,68,-755.5555555555555,51.94805194805194,51.94805194805194,0.0,51.94805194805194,51.94805194805194,0.0,Qualité
3960,0,2019-05-25,69190,FJORD NATURE 125GX8,0,0,0,FJORD,0,LeMolay(FR),0084,0024 FR AIX (DC),4606,4893,4393,4297,96,596,500,0,287,-6.231003039513678,353,556,400,399,1,157,156,0,203,-57.507082152974505,71.94244604316546,71.76258992805755,0.1798561151079099,89.78132025342326,87.81933374208052,1.9619865113427437,Production
3961,0,2019-05-25,69190,FJORD NATURE 125GX8,0,0,0,FJORD,0,LeMolay(FR),0080,0024 FR METZ (DC),4606,4893,4393,4297,96,596,500,0,287,-6.231003039513678,157,199,104,94,10,105,95,0,42,-26.751592356687897,52.26130653266332,47.23618090452261,5.025125628140707,89.78132025342326,87.81933374208052,1.9619865113427437,Production
3962,0,2019-05-25,69190,FJORD NATURE 125GX8,0,0,0,FJORD,0,LeMolay(FR),0081,0024 FR TOURS (DC),4606,4893,4393,4297,96,596,500,0,287,-6.231003039513678,452,436,436,436,0,0,0,0,-16,3.5398230088495577,100.0,100.0,0.0,89.78132025342326,87.81933374208052,1.9619865113427437,Production
3963,0,2019-05-25,69190,FJORD NATURE 125GX8,0,0,0,FJORD,0,LeMolay(FR),0082,0024 FR VALLET (DC),4606,4893,4393,4297,96,596,500,0,287,-6.231003039513678,294,411,411,411,0,0,0,0,117,-39.795918367346935,100.0,100.0,0.0,89.78132025342326,87.81933374208052,1.9619865113427437,Production
3964,0,2019-05-25,69190,FJORD NATURE 125GX8,0,0,0,FJORD,0,LeMolay(FR),0077,0024 FR LILPARK (DC),4606,4893,4393,4297,96,596,500,0,287,-6.231003039513678,174,259,259,259,0,0,0,0,85,-48.85057471264368,100.0,100.0,0.0,89.78132025342326,87.81933374208052,1.9619865113427437,Production
3965,0,2019-05-25,69190,FJORD NATURE 125GX8,0,0,0,FJORD,0,LeMolay(FR),0085,0024 FR TOULOUSE (DC),4606,4893,4393,4297,96,596,500,0,287,-6.231003039513678,666,678,678,678,0,0,0,0,12,-1.8018018018018018,100.0,100.0,0.0,89.78132025342326,87.81933374208052,1.9619865113427437,Production
3966,0,2019-05-25,69190,FJORD NATURE 125GX8,0,0,0,FJORD,0,LeMolay(FR),0083,0024 FR CHAPONNAY (DC),4606,4893,4393,4297,96,596,500,0,287,-6.231003039513678,1018,925,925,925,0,0,0,0,-93,9.135559921414538,100.0,100.0,0.0,89.78132025342326,87.81933374208052,1.9619865113427437,Production
3967,0,2019-05-25,69190,FJORD NATURE 125GX8,0,0,0,FJORD,0,LeMolay(FR),0079,0024 FR PARIS SUD (DC),4606,4893,4393,4297,96,596,500,0,287,-6.231003039513678,1105,995,746,661,85,334,249,0,-110,9.95475113122172,74.9748743718593,66.4321608040201,8.5427135678392,89.78132025342326,87.81933374208052,1.9619865113427437,Production
3968,0,2019-05-25,69190,FJORD NATURE 125GX8,0,0,0,FJORD,0,LeMolay(FR),0078,0024 FR PARIS NORD (DC),4606,4893,4393,4297,96,596,500,0,287,-6.231003039513678,387,434,434,434,0,0,0,0,47,-12.144702842377262,100.0,100.0,0.0,89.78132025342326,87.81933374208052,1.9619865113427437,Production
3969,0,2019-05-25,127750,DANIO 0% FRAISE 150X1,0,0,0,DANIO,0,Ferrières(FR),0084,0024 FR AIX (DC),1074,909,906,709,197,200,3,0,-165,15.363128491620111,82,73,71,71,0,2,2,0,-9,10.975609756097562,97.26027397260275,97.26027397260275,0.0,99.66996699669967,77.997799779978,21.672167216721675,Qualité
3970,0,2019-05-25,127750,DANIO 0% FRAISE 150X1,0,0,0,DANIO,0,Ferrières(FR),0080,0024 FR METZ (DC),1074,909,906,709,197,200,3,0,-165,15.363128491620111,41,25,25,25,0,0,0,0,-16,39.02439024390244,100.0,100.0,0.0,99.66996699669967,77.997799779978,21.672167216721675,Qualité
3971,0,2019-05-25,127750,DANIO 0% FRAISE 150X1,0,0,0,DANIO,0,Ferrières(FR),0081,0024 FR TOURS (DC),1074,909,906,709,197,200,3,0,-165,15.363128491620111,141,103,103,103,0,0,0,0,-38,26.95035460992908,100.0,100.0,0.0,99.66996699669967,77.997799779978,21.672167216721675,Qualité
3972,0,2019-05-25,127750,DANIO 0% FRAISE 150X1,0,0,0,DANIO,0,Ferrières(FR),0082,0024 FR VALLET (DC),1074,909,906,709,197,200,3,0,-165,15.363128491620111,46,47,47,47,0,0,0,0,1,-2.1739130434782608,100.0,100.0,0.0,99.66996699669967,77.997799779978,21.672167216721675,Qualité
3973,0,2019-05-25,127750,DANIO 0% FRAISE 150X1,0,0,0,DANIO,0,Ferrières(FR),0077,0024 FR LILPARK (DC),1074,909,906,709,197,200,3,0,-165,15.363128491620111,114,106,106,17,89,89,0,0,-8,7.017543859649122,100.0,16.037735849056602,83.9622641509434,99.66996699669967,77.997799779978,21.672167216721675,Qualité
3974,0,2019-05-25,127750,DANIO 0% FRAISE 150X1,0,0,0,DANIO,0,Ferrières(FR),0085,0024 FR TOULOUSE (DC),1074,909,906,709,197,200,3,0,-165,15.363128491620111,101,86,86,86,0,0,0,0,-15,14.851485148514852,100.0,100.0,0.0,99.66996699669967,77.997799779978,21.672167216721675,Qualité
3975,0,2019-05-25,127750,DANIO 0% FRAISE 150X1,0,0,0,DANIO,0,Ferrières(FR),0083,0024 FR CHAPONNAY (DC),1074,909,906,709,197,200,3,0,-165,15.363128491620111,78,65,65,65,0,0,0,0,-13,16.666666666666668,100.0,100.0,0.0,99.66996699669967,77.997799779978,21.672167216721675,Qualité
3976,0,2019-05-25,127750,DANIO 0% FRAISE 150X1,0,0,0,DANIO,0,Ferrières(FR),0079,0024 FR PARIS SUD (DC),1074,909,906,709,197,200,3,0,-165,15.363128491620111,253,219,218,218,0,1,1,0,-34,13.438735177865613,99.54337899543378,99.54337899543378,0.0,99.66996699669967,77.997799779978,21.672167216721675,Qualité
3977,0,2019-05-25,127750,DANIO 0% FRAISE 150X1,0,0,0,DANIO,0,Ferrières(FR),0078,0024 FR PARIS NORD (DC),1074,909,906,709,197,200,3,0,-165,15.363128491620111,218,185,185,77,108,108,0,0,-33,15.137614678899082,100.0,41.62162162162162,58.37837837837838,99.66996699669967,77.997799779978,21.672167216721675,Qualité
3978,0,2019-05-25,127764,DANIO 0% MYRTILLE 150X1,0,0,0,DANIO,0,Ferrières(FR),0084,0024 FR AIX (DC),139,233,118,115,3,118,115,0,94,-67.62589928057554,13,24,24,24,0,0,0,0,11,-84.61538461538461,100.0,100.0,0.0,50.64377682403433,49.35622317596567,1.2875536480686662,Qualité
3979,0,2019-05-25,127764,DANIO 0% MYRTILLE 150X1,0,0,0,DANIO,0,Ferrières(FR),0080,0024 FR METZ (DC),139,233,118,115,3,118,115,0,94,-67.62589928057554,3,10,10,10,0,0,0,0,7,-233.33333333333334,100.0,100.0,0.0,50.64377682403433,49.35622317596567,1.2875536480686662,Qualité
3980,0,2019-05-25,127764,DANIO 0% MYRTILLE 150X1,0,0,0,DANIO,0,Ferrières(FR),0081,0024 FR TOURS (DC),139,233,118,115,3,118,115,0,94,-67.62589928057554,23,20,20,20,0,0,0,0,-3,13.043478260869565,100.0,100.0,0.0,50.64377682403433,49.35622317596567,1.2875536480686662,Qualité
3981,0,2019-05-25,127764,DANIO 0% MYRTILLE 150X1,0,0,0,DANIO,0,Ferrières(FR),0082,0024 FR VALLET (DC),139,233,118,115,3,118,115,0,94,-67.62589928057554,12,14,14,14,0,0,0,0,2,-16.666666666666668,100.0,100.0,0.0,50.64377682403433,49.35622317596567,1.2875536480686662,Qualité
3982,0,2019-05-25,127764,DANIO 0% MYRTILLE 150X1,0,0,0,DANIO,0,Ferrières(FR),0077,0024 FR LILPARK (DC),139,233,118,115,3,118,115,0,94,-67.62589928057554,7,6,6,6,0,0,0,0,-1,14.285714285714286,100.0,100.0,0.0,50.64377682403433,49.35622317596567,1.2875536480686662,Qualité
3983,0,2019-05-25,127764,DANIO 0% MYRTILLE 150X1,0,0,0,DANIO,0,Ferrières(FR),0085,0024 FR TOULOUSE (DC),139,233,118,115,3,118,115,0,94,-67.62589928057554,14,18,18,18,0,0,0,0,4,-28.571428571428573,100.0,100.0,0.0,50.64377682403433,49.35622317596567,1.2875536480686662,Qualité
3984,0,2019-05-25,127764,DANIO 0% MYRTILLE 150X1,0,0,0,DANIO,0,Ferrières(FR),0083,0024 FR CHAPONNAY (DC),139,233,118,115,3,118,115,0,94,-67.62589928057554,30,23,23,23,0,0,0,0,-7,23.333333333333332,100.0,100.0,0.0,50.64377682403433,49.35622317596567,1.2875536480686662,Qualité
3985,0,2019-05-25,127764,DANIO 0% MYRTILLE 150X1,0,0,0,DANIO,0,Ferrières(FR),0078,0024 FR PARIS NORD (DC),139,233,118,115,3,118,115,0,94,-67.62589928057554,37,118,3,0,3,118,115,0,81,-218.9189189189189,2.5423728813559325,0.0,2.5423728813559325,50.64377682403433,49.35622317596567,1.2875536480686662,Qualité
3986,1,2019-05-25,136051,ACTIVIA 4X120G(x6) GRANOLA FR PROMO,1,0,0,ACTIVIA,1,Ochsenfurt(ALL),0081,0024 FR TOURS (DC),27,330,330,303,27,27,0,0,303,-1122.2222222222222,27,27,27,0,27,27,0,0,0,0.0,100.0,0.0,100.0,100.0,91.81818181818183,8.181818181818173,Transport
3987,1,2019-05-25,139609,ALPRO ORGANIC SOYA DRINK 12X1L,0,0,0,ALPRO,1,Wevelgem(BE),0081,0024 FR TOURS (DC),10,169,168,158,10,11,1,0,159,-1590.0,10,10,10,0,10,10,0,0,0,0.0,100.0,0.0,100.0,99.40828402366864,93.49112426035504,5.917159763313606,A Creuser
3988,0,2019-05-25,146531,L2V BRASS NAT 115X4,0,1,0,LES 2 VACHES,0,LeMolay(FR),0081,0024 FR TOURS (DC),991,1355,72,72,0,1283,1283,0,364,-36.730575176589305,182,233,24,24,0,209,209,0,51,-28.021978021978022,10.300429184549357,10.300429184549357,0.0,5.313653136531365,5.313653136531365,0.0,Production
3989,0,2019-05-25,146531,L2V BRASS NAT 115X4,0,1,0,LES 2 VACHES,0,LeMolay(FR),0082,0024 FR VALLET (DC),991,1355,72,72,0,1283,1283,0,364,-36.730575176589305,176,266,20,20,0,246,246,0,90,-51.13636363636363,7.518796992481203,7.518796992481203,0.0,5.313653136531365,5.313653136531365,0.0,Production
3990,0,2019-05-25,146531,L2V BRASS NAT 115X4,0,1,0,LES 2 VACHES,0,LeMolay(FR),0085,0024 FR TOULOUSE (DC),991,1355,72,72,0,1283,1283,0,364,-36.730575176589305,111,169,18,18,0,151,151,0,58,-52.252252252252255,10.650887573964498,10.650887573964498,0.0,5.313653136531365,5.313653136531365,0.0,Production
3991,0,2019-05-25,146531,L2V BRASS NAT 115X4,0,1,0,LES 2 VACHES,0,LeMolay(FR),0083,0024 FR CHAPONNAY (DC),991,1355,72,72,0,1283,1283,0,364,-36.730575176589305,218,387,8,8,0,379,379,0,169,-77.5229357798165,2.0671834625323,2.0671834625323,0.0,5.313653136531365,5.313653136531365,0.0,Production
3992,0,2019-05-25,146531,L2V BRASS NAT 115X4,0,1,0,LES 2 VACHES,0,LeMolay(FR),0078,0024 FR PARIS NORD (DC),991,1355,72,72,0,1283,1283,0,364,-36.730575176589305,304,300,2,2,0,298,298,0,-4,1.3157894736842106,0.6666666666666667,0.6666666666666667,0.0,5.313653136531365,5.313653136531365,0.0,Production
3993,0,2019-05-27,127911,GERVAIS GRIEGO 115X4 VANILLA FR,0,0,0,GERVAIS,1,Rosenheim(ALL),0084,0024 FR AIX (DC),1603,1579,1558,1225,333,354,21,0,-24,1.4971927635683093,170,133,133,133,0,0,0,0,-37,21.764705882352942,100.0,100.0,0.0,98.67004433185559,77.58074730842304,21.08929702343255,Transport
3994,0,2019-05-27,127911,GERVAIS GRIEGO 115X4 VANILLA FR,0,0,0,GERVAIS,1,Rosenheim(ALL),0080,0024 FR METZ (DC),1603,1579,1558,1225,333,354,21,0,-24,1.4971927635683093,175,171,171,26,145,145,0,0,-4,2.2857142857142856,100.0,15.204678362573098,84.7953216374269,98.67004433185559,77.58074730842304,21.08929702343255,Transport
3995,0,2019-05-27,127911,GERVAIS GRIEGO 115X4 VANILLA FR,0,0,0,GERVAIS,1,Rosenheim(ALL),0081,0024 FR TOURS (DC),1603,1579,1558,1225,333,354,21,0,-24,1.4971927635683093,276,262,262,247,15,15,0,0,-14,5.072463768115942,100.0,94.27480916030534,5.725190839694662,98.67004433185559,77.58074730842304,21.08929702343255,Transport
3996,0,2019-05-27,127911,GERVAIS GRIEGO 115X4 VANILLA FR,0,0,0,GERVAIS,1,Rosenheim(ALL),0082,0024 FR VALLET (DC),1603,1579,1558,1225,333,354,21,0,-24,1.4971927635683093,107,103,103,103,0,0,0,0,-4,3.7383177570093458,100.0,100.0,0.0,98.67004433185559,77.58074730842304,21.08929702343255,Transport
3997,0,2019-05-27,127911,GERVAIS GRIEGO 115X4 VANILLA FR,0,0,0,GERVAIS,1,Rosenheim(ALL),0077,0024 FR LILPARK (DC),1603,1579,1558,1225,333,354,21,0,-24,1.4971927635683093,130,109,109,109,0,0,0,0,-21,16.153846153846153,100.0,100.0,0.0,98.67004433185559,77.58074730842304,21.08929702343255,Transport
3998,0,2019-05-27,127911,GERVAIS GRIEGO 115X4 VANILLA FR,0,0,0,GERVAIS,1,Rosenheim(ALL),0085,0024 FR TOULOUSE (DC),1603,1579,1558,1225,333,354,21,0,-24,1.4971927635683093,245,275,275,261,14,14,0,0,30,-12.244897959183673,100.0,94.9090909090909,5.0909090909090935,98.67004433185559,77.58074730842304,21.08929702343255,Transport
3999,0,2019-05-27,127911,GERVAIS GRIEGO 115X4 VANILLA FR,0,0,0,GERVAIS,1,Rosenheim(ALL),0083,0024 FR CHAPONNAY (DC),1603,1579,1558,1225,333,354,21,0,-24,1.4971927635683093,164,170,170,170,0,0,0,0,6,-3.658536585365854,100.0,100.0,0.0,98.67004433185559,77.58074730842304,21.08929702343255,Transport
4000,0,2019-05-27,127911,GERVAIS GRIEGO 115X4 VANILLA FR,0,0,0,GERVAIS,1,Rosenheim(ALL),0079,0024 FR PARIS SUD (DC),1603,1579,1558,1225,333,354,21,0,-24,1.4971927635683093,158,145,124,122,2,23,21,0,-13,8.227848101265822,85.51724137931035,84.13793103448276,1.3793103448275872,98.67004433185559,77.58074730842304,21.08929702343255,Transport
4001,0,2019-05-27,127911,GERVAIS GRIEGO 115X4 VANILLA FR,0,0,0,GERVAIS,1,Rosenheim(ALL),0078,0024 FR PARIS NORD (DC),1603,1579,1558,1225,333,354,21,0,-24,1.4971927635683093,178,211,211,54,157,157,0,0,33,-18.53932584269663,100.0,25.59241706161137,74.40758293838863,98.67004433185559,77.58074730842304,21.08929702343255,Transport
4002,1,2019-05-27,136048,ACTIVIA 4X120G(X6) OAT NUT FR PROMO,1,0,0,ACTIVIA,1,Ochsenfurt(ALL),0077,0024 FR LILPARK (DC),93,317,317,259,58,58,0,0,224,-240.86021505376345,93,73,73,15,58,58,0,0,-20,21.50537634408602,100.0,20.54794520547945,79.45205479452055,100.0,81.70347003154575,18.29652996845425,Transport
4003,1,2019-05-27,139211,ALPRO SOJA RASPB CRANB 150X1,0,0,0,ALPRO,1,Wevelgem(BE),0077,0024 FR LILPARK (DC),38,63,61,51,10,12,2,0,25,-65.78947368421052,38,39,37,27,10,12,2,0,1,-2.6315789473684212,94.87179487179486,69.23076923076923,25.641025641025635,96.82539682539682,80.95238095238095,15.873015873015873,A Creuser
4004,1,2019-05-27,139406,ALPRO SOYA DRINK CHOCO 1LX8,0,0,0,ALPRO,1,Issenheim(FR),0077,0024 FR LILPARK (DC),56,106,97,75,22,31,9,0,50,-89.28571428571429,56,56,56,34,22,22,0,0,0,0.0,100.0,60.71428571428571,39.28571428571429,91.50943396226415,70.75471698113208,20.754716981132077,A Creuser
4005,1,2019-05-27,139609,ALPRO ORGANIC SOYA DRINK 12X1L,0,0,0,ALPRO,1,Wevelgem(BE),0077,0024 FR LILPARK (DC),66,82,80,36,44,46,2,0,16,-24.242424242424242,66,62,62,19,43,43,0,0,-4,6.0606060606060606,100.0,30.64516129032258,69.35483870967742,97.5609756097561,43.90243902439025,53.65853658536585,A Creuser
4006,0,2019-05-28,127911,GERVAIS GRIEGO 115X4 VANILLA FR,0,0,0,GERVAIS,1,Rosenheim(ALL),0084,0024 FR AIX (DC),1478,1476,1253,300,953,1176,223,0,-2,0.13531799729364005,222,244,244,48,196,196,0,0,22,-9.90990990990991,100.0,19.672131147540984,80.32786885245902,84.89159891598916,20.32520325203252,64.56639566395664,Transport
4007,0,2019-05-28,127911,GERVAIS GRIEGO 115X4 VANILLA FR,0,0,0,GERVAIS,1,Rosenheim(ALL),0080,0024 FR METZ (DC),1478,1476,1253,300,953,1176,223,0,-2,0.13531799729364005,107,135,135,3,132,132,0,0,28,-26.16822429906542,100.0,2.2222222222222223,97.77777777777777,84.89159891598916,20.32520325203252,64.56639566395664,Transport
4008,0,2019-05-28,127911,GERVAIS GRIEGO 115X4 VANILLA FR,0,0,0,GERVAIS,1,Rosenheim(ALL),0081,0024 FR TOURS (DC),1478,1476,1253,300,953,1176,223,0,-2,0.13531799729364005,186,193,180,4,176,189,13,0,7,-3.763440860215054,93.26424870466322,2.072538860103627,91.1917098445596,84.89159891598916,20.32520325203252,64.56639566395664,Transport
4009,0,2019-05-28,127911,GERVAIS GRIEGO 115X4 VANILLA FR,0,0,0,GERVAIS,1,Rosenheim(ALL),0082,0024 FR VALLET (DC),1478,1476,1253,300,953,1176,223,0,-2,0.13531799729364005,210,175,79,20,59,155,96,0,-35,16.666666666666668,45.14285714285714,11.428571428571429,33.71428571428571,84.89159891598916,20.32520325203252,64.56639566395664,Transport
4010,0,2019-05-28,127911,GERVAIS GRIEGO 115X4 VANILLA FR,0,0,0,GERVAIS,1,Rosenheim(ALL),0077,0024 FR LILPARK (DC),1478,1476,1253,300,953,1176,223,0,-2,0.13531799729364005,104,139,139,135,4,4,0,0,35,-33.65384615384615,100.0,97.12230215827337,2.8776978417266292,84.89159891598916,20.32520325203252,64.56639566395664,Transport
4011,0,2019-05-28,127911,GERVAIS GRIEGO 115X4 VANILLA FR,0,0,0,GERVAIS,1,Rosenheim(ALL),0085,0024 FR TOULOUSE (DC),1478,1476,1253,300,953,1176,223,0,-2,0.13531799729364005,266,223,223,0,223,223,0,0,-43,16.165413533834588,100.0,0.0,100.0,84.89159891598916,20.32520325203252,64.56639566395664,Transport
4012,0,2019-05-28,127911,GERVAIS GRIEGO 115X4 VANILLA FR,0,0,0,GERVAIS,1,Rosenheim(ALL),0083,0024 FR CHAPONNAY (DC),1478,1476,1253,300,953,1176,223,0,-2,0.13531799729364005,239,204,90,90,0,114,114,0,-35,14.644351464435147,44.11764705882353,44.11764705882353,0.0,84.89159891598916,20.32520325203252,64.56639566395664,Transport
4013,0,2019-05-28,127911,GERVAIS GRIEGO 115X4 VANILLA FR,0,0,0,GERVAIS,1,Rosenheim(ALL),0078,0024 FR PARIS NORD (DC),1478,1476,1253,300,953,1176,223,0,-2,0.13531799729364005,144,163,163,0,163,163,0,0,19,-13.194444444444445,100.0,0.0,100.0,84.89159891598916,20.32520325203252,64.56639566395664,Transport
4014,0,2019-05-28,136162,FJORD NATURE 125X8 D,1,0,0,FJORD,0,LeMolay(FR),0080,0024 FR METZ (DC),1326,1600,1506,802,704,798,94,0,274,-20.663650075414782,217,192,98,98,0,94,94,0,-25,11.52073732718894,51.041666666666664,51.041666666666664,0.0,94.125,50.125,44.0,Production
4015,0,2019-05-28,136162,FJORD NATURE 125X8 D,1,0,0,FJORD,0,LeMolay(FR),0081,0024 FR TOURS (DC),1326,1600,1506,802,704,798,94,0,274,-20.663650075414782,56,64,64,64,0,0,0,0,8,-14.285714285714286,100.0,100.0,0.0,94.125,50.125,44.0,Production
4016,0,2019-05-28,136162,FJORD NATURE 125X8 D,1,0,0,FJORD,0,LeMolay(FR),0077,0024 FR LILPARK (DC),1326,1600,1506,802,704,798,94,0,274,-20.663650075414782,91,320,320,320,0,0,0,0,229,-251.64835164835165,100.0,100.0,0.0,94.125,50.125,44.0,Production
4017,0,2019-05-28,136162,FJORD NATURE 125X8 D,1,0,0,FJORD,0,LeMolay(FR),0085,0024 FR TOULOUSE (DC),1326,1600,1506,802,704,798,94,0,274,-20.663650075414782,324,320,320,320,0,0,0,0,-4,1.2345679012345678,100.0,100.0,0.0,94.125,50.125,44.0,Production
4018,0,2019-05-28,136162,FJORD NATURE 125X8 D,1,0,0,FJORD,0,LeMolay(FR),0083,0024 FR CHAPONNAY (DC),1326,1600,1506,802,704,798,94,0,274,-20.663650075414782,638,704,704,0,704,704,0,0,66,-10.344827586206897,100.0,0.0,100.0,94.125,50.125,44.0,Production
4019,0,2019-05-28,140278,Activia almond/muesli/chia 170g FR-copac,0,0,0,ACTIVIA,1,Roumanie(RO),0084,0024 FR AIX (DC),250,460,369,357,12,103,91,0,210,-84.0,103,128,69,69,0,59,59,0,25,-24.271844660194176,53.90625,53.90625,0.0,80.21739130434783,77.6086956521739,2.608695652173921,Transport
4020,0,2019-05-28,140278,Activia almond/muesli/chia 170g FR-copac,0,0,0,ACTIVIA,1,Roumanie(RO),0077,0024 FR LILPARK (DC),250,460,369,357,12,103,91,0,210,-84.0,40,59,35,34,1,25,24,0,19,-47.5,59.32203389830508,57.6271186440678,1.69491525423728,80.21739130434783,77.6086956521739,2.608695652173921,Transport
4021,0,2019-05-28,140278,Activia almond/muesli/chia 170g FR-copac,0,0,0,ACTIVIA,1,Roumanie(RO),0078,0024 FR PARIS NORD (DC),250,460,369,357,12,103,91,0,210,-84.0,107,273,265,254,11,19,8,0,166,-155.14018691588785,97.06959706959707,93.04029304029304,4.029304029304029,80.21739130434783,77.6086956521739,2.608695652173921,Transport
4022,0,2019-05-28,145085,DANET VANILLE 125GX6 D,0,0,0,DANETTE,0,StJust(FR),0084,0024 FR AIX (DC),3254,3822,3822,3822,0,0,0,0,568,-17.455439459127227,430,364,364,364,0,0,0,0,-66,15.348837209302326,100.0,100.0,0.0,100.0,100.0,0.0,Previsions
4023,0,2019-05-28,145085,DANET VANILLE 125GX6 D,0,0,0,DANETTE,0,StJust(FR),0080,0024 FR METZ (DC),3254,3822,3822,3822,0,0,0,0,568,-17.455439459127227,311,364,364,364,0,0,0,0,53,-17.041800643086816,100.0,100.0,0.0,100.0,100.0,0.0,Previsions
4024,0,2019-05-28,145085,DANET VANILLE 125GX6 D,0,0,0,DANETTE,0,StJust(FR),0081,0024 FR TOURS (DC),3254,3822,3822,3822,0,0,0,0,568,-17.455439459127227,92,182,182,182,0,0,0,0,90,-97.82608695652173,100.0,100.0,0.0,100.0,100.0,0.0,Previsions
4025,0,2019-05-28,145085,DANET VANILLE 125GX6 D,0,0,0,DANETTE,0,StJust(FR),0082,0024 FR VALLET (DC),3254,3822,3822,3822,0,0,0,0,568,-17.455439459127227,214,182,182,182,0,0,0,0,-32,14.953271028037383,100.0,100.0,0.0,100.0,100.0,0.0,Previsions
4026,0,2019-05-28,145085,DANET VANILLE 125GX6 D,0,0,0,DANETTE,0,StJust(FR),0077,0024 FR LILPARK (DC),3254,3822,3822,3822,0,0,0,0,568,-17.455439459127227,179,728,728,728,0,0,0,0,549,-306.7039106145251,100.0,100.0,0.0,100.0,100.0,0.0,Previsions
4027,0,2019-05-28,145085,DANET VANILLE 125GX6 D,0,0,0,DANETTE,0,StJust(FR),0085,0024 FR TOULOUSE (DC),3254,3822,3822,3822,0,0,0,0,568,-17.455439459127227,471,546,546,546,0,0,0,0,75,-15.92356687898089,100.0,100.0,0.0,100.0,100.0,0.0,Previsions
4028,0,2019-05-28,145085,DANET VANILLE 125GX6 D,0,0,0,DANETTE,0,StJust(FR),0083,0024 FR CHAPONNAY (DC),3254,3822,3822,3822,0,0,0,0,568,-17.455439459127227,693,546,546,546,0,0,0,0,-147,21.21212121212121,100.0,100.0,0.0,100.0,100.0,0.0,Previsions
4029,0,2019-05-28,145085,DANET VANILLE 125GX6 D,0,0,0,DANETTE,0,StJust(FR),0079,0024 FR PARIS SUD (DC),3254,3822,3822,3822,0,0,0,0,568,-17.455439459127227,179,364,364,364,0,0,0,0,185,-103.35195530726257,100.0,100.0,0.0,100.0,100.0,0.0,Previsions
4030,0,2019-05-28,145085,DANET VANILLE 125GX6 D,0,0,0,DANETTE,0,StJust(FR),0078,0024 FR PARIS NORD (DC),3254,3822,3822,3822,0,0,0,0,568,-17.455439459127227,685,546,546,546,0,0,0,0,-139,20.291970802919707,100.0,100.0,0.0,100.0,100.0,0.0,Previsions
4031,0,2019-06-01,121314,ACTIMEL STRA 4x(10x100g) FR,0,0,0,ACTIMEL,1,Rotselaar(BE),0084,0024 FR AIX (DC),3573,2519,2519,2380,139,139,0,0,-1054,29.499020431010354,48,83,83,83,0,0,0,0,35,-72.91666666666667,100.0,100.0,0.0,100.0,94.48193727669711,5.51806272330289,Transport
4032,0,2019-06-01,121314,ACTIMEL STRA 4x(10x100g) FR,0,0,0,ACTIMEL,1,Rotselaar(BE),0080,0024 FR METZ (DC),3573,2519,2519,2380,139,139,0,0,-1054,29.499020431010354,4,4,4,4,0,0,0,0,0,0.0,100.0,100.0,0.0,100.0,94.48193727669711,5.51806272330289,Transport
4033,0,2019-06-01,121314,ACTIMEL STRA 4x(10x100g) FR,0,0,0,ACTIMEL,1,Rotselaar(BE),0081,0024 FR TOURS (DC),3573,2519,2519,2380,139,139,0,0,-1054,29.499020431010354,274,267,267,128,139,139,0,0,-7,2.5547445255474455,100.0,47.940074906367045,52.059925093632955,100.0,94.48193727669711,5.51806272330289,Transport
4034,1,2019-06-01,121314,ACTIMEL STRA 4x(10x100g) FR,0,0,0,ACTIMEL,1,Rotselaar(BE),0081,0024 FR TOURS (DC),3573,2519,2519,2380,139,139,0,0,-1054,29.499020431010354,274,267,267,128,139,139,0,0,-7,2.5547445255474455,100.0,47.940074906367045,52.059925093632955,100.0,94.48193727669711,5.51806272330289,Transport
4035,0,2019-06-01,121314,ACTIMEL STRA 4x(10x100g) FR,0,0,0,ACTIMEL,1,Rotselaar(BE),0082,0024 FR VALLET (DC),3573,2519,2519,2380,139,139,0,0,-1054,29.499020431010354,45,91,91,91,0,0,0,0,46,-102.22222222222223,100.0,100.0,0.0,100.0,94.48193727669711,5.51806272330289,Transport
4036,0,2019-06-01,121314,ACTIMEL STRA 4x(10x100g) FR,0,0,0,ACTIMEL,1,Rotselaar(BE),0077,0024 FR LILPARK (DC),3573,2519,2519,2380,139,139,0,0,-1054,29.499020431010354,53,75,75,75,0,0,0,0,22,-41.509433962264154,100.0,100.0,0.0,100.0,94.48193727669711,5.51806272330289,Transport
4037,0,2019-06-01,121314,ACTIMEL STRA 4x(10x100g) FR,0,0,0,ACTIMEL,1,Rotselaar(BE),0085,0024 FR TOULOUSE (DC),3573,2519,2519,2380,139,139,0,0,-1054,29.499020431010354,790,769,769,769,0,0,0,0,-21,2.6582278481012658,100.0,100.0,0.0,100.0,94.48193727669711,5.51806272330289,Transport
4038,0,2019-06-01,121314,ACTIMEL STRA 4x(10x100g) FR,0,0,0,ACTIMEL,1,Rotselaar(BE),0083,0024 FR CHAPONNAY (DC),3573,2519,2519,2380,139,139,0,0,-1054,29.499020431010354,1009,86,86,86,0,0,0,0,-923,91.47670961347869,100.0,100.0,0.0,100.0,94.48193727669711,5.51806272330289,Transport
4039,0,2019-06-01,121314,ACTIMEL STRA 4x(10x100g) FR,0,0,0,ACTIMEL,1,Rotselaar(BE),0079,0024 FR PARIS SUD (DC),3573,2519,2519,2380,139,139,0,0,-1054,29.499020431010354,335,253,253,253,0,0,0,0,-82,24.47761194029851,100.0,100.0,0.0,100.0,94.48193727669711,5.51806272330289,Transport
4040,0,2019-06-01,121314,ACTIMEL STRA 4x(10x100g) FR,0,0,0,ACTIMEL,1,Rotselaar(BE),0078,0024 FR PARIS NORD (DC),3573,2519,2519,2380,139,139,0,0,-1054,29.499020431010354,741,891,891,891,0,0,0,0,150,-20.242914979757085,100.0,100.0,0.0,100.0,94.48193727669711,5.51806272330289,Transport
4041,1,2019-06-01,131384,ACTIVIA FIGUE 125X4 OD,1,0,0,ACTIVIA,0,Ferrières(FR),0081,0024 FR TOURS (DC),86,738,705,649,56,89,33,0,652,-758.1395348837209,86,119,86,42,44,77,33,0,33,-38.372093023255815,72.26890756302521,35.294117647058826,36.97478991596638,95.52845528455285,87.94037940379404,7.588075880758808,Probleme Copacking
4042,1,2019-06-01,131482,ACTIVIA FRT PINEAPPLE 125X4 OD,1,0,0,ACTIVIA,0,Villecomtal(FR),0077,0024 FR LILPARK (DC),69,719,719,626,93,93,0,0,650,-942.0289855072464,69,93,93,0,93,93,0,0,24,-34.78260869565217,100.0,0.0,100.0,100.0,87.0653685674548,12.934631432545203,Transport
4043,1,2019-06-01,132458,ACTIVIA SAV CITRON 125X4 OD,0,0,0,ACTIVIA,0,Bailleul(FR),0085,0024 FR TOULOUSE (DC),80,581,581,551,30,30,0,0,501,-626.25,19,19,19,0,19,19,0,0,0,0.0,100.0,0.0,100.0,100.0,94.83648881239243,5.163511187607568,Qualité
4044,1,2019-06-01,132458,ACTIVIA SAV CITRON 125X4 OD,0,0,0,ACTIVIA,0,Bailleul(FR),0083,0024 FR CHAPONNAY (DC),80,581,581,551,30,30,0,0,501,-626.25,61,61,61,50,11,11,0,0,0,0.0,100.0,81.9672131147541,18.032786885245898,100.0,94.83648881239243,5.163511187607568,Qualité
4045,1,2019-06-01,133396,LIGHT & FREE POIRE VAN 120X4,0,0,0,LIGHT & FREE,0,Ferrières(FR),0079,0024 FR PARIS SUD (DC),123,572,572,377,195,195,0,0,449,-365.0406504065041,123,118,118,0,118,118,0,0,-5,4.065040650406504,100.0,0.0,100.0,100.0,65.9090909090909,34.09090909090909,Expe usine
4046,0,2019-06-01,137710,DANET LIEG CHOCO 100X4,0,0,0,DANETTE,0,StJust(FR),0084,0024 FR AIX (DC),2603,2228,1894,1828,66,400,334,0,-375,14.406454091432963,259,299,299,299,0,0,0,0,40,-15.444015444015443,100.0,100.0,0.0,85.00897666068222,82.04667863554758,2.9622980251346434,Production
4047,0,2019-06-01,137710,DANET LIEG CHOCO 100X4,0,0,0,DANETTE,0,StJust(FR),0080,0024 FR METZ (DC),2603,2228,1894,1828,66,400,334,0,-375,14.406454091432963,261,295,295,293,2,2,0,0,34,-13.026819923371647,100.0,99.32203389830508,0.6779661016949206,85.00897666068222,82.04667863554758,2.9622980251346434,Production
4048,0,2019-06-01,137710,DANET LIEG CHOCO 100X4,0,0,0,DANETTE,0,StJust(FR),0081,0024 FR TOURS (DC),2603,2228,1894,1828,66,400,334,0,-375,14.406454091432963,179,177,177,177,0,0,0,0,-2,1.1173184357541899,100.0,100.0,0.0,85.00897666068222,82.04667863554758,2.9622980251346434,Production
4049,0,2019-06-01,137710,DANET LIEG CHOCO 100X4,0,0,0,DANETTE,0,StJust(FR),0082,0024 FR VALLET (DC),2603,2228,1894,1828,66,400,334,0,-375,14.406454091432963,116,166,166,166,0,0,0,0,50,-43.10344827586207,100.0,100.0,0.0,85.00897666068222,82.04667863554758,2.9622980251346434,Production
4050,0,2019-06-01,137710,DANET LIEG CHOCO 100X4,0,0,0,DANETTE,0,StJust(FR),0077,0024 FR LILPARK (DC),2603,2228,1894,1828,66,400,334,0,-375,14.406454091432963,68,105,105,105,0,0,0,0,37,-54.411764705882355,100.0,100.0,0.0,85.00897666068222,82.04667863554758,2.9622980251346434,Production
4051,0,2019-06-01,137710,DANET LIEG CHOCO 100X4,0,0,0,DANETTE,0,StJust(FR),0085,0024 FR TOULOUSE (DC),2603,2228,1894,1828,66,400,334,0,-375,14.406454091432963,540,552,218,154,64,398,334,0,12,-2.2222222222222223,39.492753623188406,27.898550724637683,11.594202898550723,85.00897666068222,82.04667863554758,2.9622980251346434,Production
4052,1,2019-06-01,137710,DANET LIEG CHOCO 100X4,0,0,0,DANETTE,0,StJust(FR),0085,0024 FR TOULOUSE (DC),2603,2228,1894,1828,66,400,334,0,-375,14.406454091432963,540,552,218,154,64,398,334,0,12,-2.2222222222222223,39.492753623188406,27.898550724637683,11.594202898550723,85.00897666068222,82.04667863554758,2.9622980251346434,Production
4053,0,2019-06-01,137710,DANET LIEG CHOCO 100X4,0,0,0,DANETTE,0,StJust(FR),0083,0024 FR CHAPONNAY (DC),2603,2228,1894,1828,66,400,334,0,-375,14.406454091432963,225,245,245,245,0,0,0,0,20,-8.88888888888889,100.0,100.0,0.0,85.00897666068222,82.04667863554758,2.9622980251346434,Production
4054,0,2019-06-01,137710,DANET LIEG CHOCO 100X4,0,0,0,DANETTE,0,StJust(FR),0079,0024 FR PARIS SUD (DC),2603,2228,1894,1828,66,400,334,0,-375,14.406454091432963,266,213,213,213,0,0,0,0,-53,19.924812030075188,100.0,100.0,0.0,85.00897666068222,82.04667863554758,2.9622980251346434,Production
4055,0,2019-06-01,137710,DANET LIEG CHOCO 100X4,0,0,0,DANETTE,0,StJust(FR),0078,0024 FR PARIS NORD (DC),2603,2228,1894,1828,66,400,334,0,-375,14.406454091432963,149,176,176,176,0,0,0,0,27,-18.120805369127517,100.0,100.0,0.0,85.00897666068222,82.04667863554758,2.9622980251346434,Production
4056,1,2019-06-01,139408,ALPRO COCO DRINK CHOCOLATE 1LX8,0,0,0,ALPRO,1,Wevelgem(BE),0078,0024 FR PARIS NORD (DC),14,72,72,3,69,69,0,0,58,-414.2857142857143,14,14,14,0,14,14,0,0,0,0.0,100.0,0.0,100.0,100.0,4.166666666666666,95.83333333333333,A Creuser
4057,0,2019-06-01,140280,Activia chia/raspb/muesli 170g FR-copack,0,0,0,ACTIVIA,1,Roumanie(RO),0084,0024 FR AIX (DC),1427,1426,1390,1165,225,261,36,0,-1,0.0700770847932726,158,151,151,151,0,0,0,0,-7,4.430379746835443,100.0,100.0,0.0,97.47545582047685,81.69705469845722,15.77840112201963,Transport
4058,0,2019-06-01,140280,Activia chia/raspb/muesli 170g FR-copack,0,0,0,ACTIVIA,1,Roumanie(RO),0080,0024 FR METZ (DC),1427,1426,1390,1165,225,261,36,0,-1,0.0700770847932726,98,149,149,149,0,0,0,0,51,-52.04081632653061,100.0,100.0,0.0,97.47545582047685,81.69705469845722,15.77840112201963,Transport
4059,0,2019-06-01,140280,Activia chia/raspb/muesli 170g FR-copack,0,0,0,ACTIVIA,1,Roumanie(RO),0081,0024 FR TOURS (DC),1427,1426,1390,1165,225,261,36,0,-1,0.0700770847932726,170,158,158,158,0,0,0,0,-12,7.0588235294117645,100.0,100.0,0.0,97.47545582047685,81.69705469845722,15.77840112201963,Transport
4060,0,2019-06-01,140280,Activia chia/raspb/muesli 170g FR-copack,0,0,0,ACTIVIA,1,Roumanie(RO),0082,0024 FR VALLET (DC),1427,1426,1390,1165,225,261,36,0,-1,0.0700770847932726,145,183,183,30,153,153,0,0,38,-26.20689655172414,100.0,16.39344262295082,83.60655737704919,97.47545582047685,81.69705469845722,15.77840112201963,Transport
4061,0,2019-06-01,140280,Activia chia/raspb/muesli 170g FR-copack,0,0,0,ACTIVIA,1,Roumanie(RO),0077,0024 FR LILPARK (DC),1427,1426,1390,1165,225,261,36,0,-1,0.0700770847932726,93,76,40,40,0,36,36,0,-17,18.27956989247312,52.63157894736842,52.63157894736842,0.0,97.47545582047685,81.69705469845722,15.77840112201963,Transport
4062,0,2019-06-01,140280,Activia chia/raspb/muesli 170g FR-copack,0,0,0,ACTIVIA,1,Roumanie(RO),0085,0024 FR TOULOUSE (DC),1427,1426,1390,1165,225,261,36,0,-1,0.0700770847932726,175,125,125,125,0,0,0,0,-50,28.571428571428573,100.0,100.0,0.0,97.47545582047685,81.69705469845722,15.77840112201963,Transport
4063,0,2019-06-01,140280,Activia chia/raspb/muesli 170g FR-copack,0,0,0,ACTIVIA,1,Roumanie(RO),0083,0024 FR CHAPONNAY (DC),1427,1426,1390,1165,225,261,36,0,-1,0.0700770847932726,193,167,167,167,0,0,0,0,-26,13.471502590673575,100.0,100.0,0.0,97.47545582047685,81.69705469845722,15.77840112201963,Transport
4064,0,2019-06-01,140280,Activia chia/raspb/muesli 170g FR-copack,0,0,0,ACTIVIA,1,Roumanie(RO),0079,0024 FR PARIS SUD (DC),1427,1426,1390,1165,225,261,36,0,-1,0.0700770847932726,263,180,180,108,72,72,0,0,-83,31.55893536121673,100.0,60.0,40.0,97.47545582047685,81.69705469845722,15.77840112201963,Transport
4065,0,2019-06-01,140280,Activia chia/raspb/muesli 170g FR-copack,0,0,0,ACTIVIA,1,Roumanie(RO),0078,0024 FR PARIS NORD (DC),1427,1426,1390,1165,225,261,36,0,-1,0.0700770847932726,132,237,237,237,0,0,0,0,105,-79.54545454545455,100.0,100.0,0.0,97.47545582047685,81.69705469845722,15.77840112201963,Transport
4066,1,2019-06-01,146417,OIKOS CARAMELIZED BANANA 115GX2 FR,0,0,0,OIKOS,1,Parets(ES),0079,0024 FR PARIS SUD (DC),67,471,471,439,32,32,0,0,404,-602.9850746268656,67,59,59,27,32,32,0,0,-8,11.940298507462687,100.0,45.76271186440678,54.23728813559322,100.0,93.20594479830149,6.794055201698512,A Creuser
4067,0,2019-06-01,146523,L2V BRASS FRAM 115X4,0,0,0,LES 2 VACHES,0,LeMolay(FR),0084,0024 FR AIX (DC),2139,2352,1608,1489,119,863,744,0,213,-9.957924263674615,343,252,232,232,0,20,20,0,-91,26.53061224489796,92.06349206349206,92.06349206349206,0.0,68.36734693877551,63.30782312925171,5.059523809523803,Production
4068,0,2019-06-01,146523,L2V BRASS FRAM 115X4,0,0,0,LES 2 VACHES,0,LeMolay(FR),0080,0024 FR METZ (DC),2139,2352,1608,1489,119,863,744,0,213,-9.957924263674615,68,119,119,119,0,0,0,0,51,-75.0,100.0,100.0,0.0,68.36734693877551,63.30782312925171,5.059523809523803,Production
4069,0,2019-06-01,146523,L2V BRASS FRAM 115X4,0,0,0,LES 2 VACHES,0,LeMolay(FR),0081,0024 FR TOURS (DC),2139,2352,1608,1489,119,863,744,0,213,-9.957924263674615,333,344,247,247,0,97,97,0,11,-3.3033033033033035,71.80232558139535,71.80232558139535,0.0,68.36734693877551,63.30782312925171,5.059523809523803,Production
4070,0,2019-06-01,146523,L2V BRASS FRAM 115X4,0,0,0,LES 2 VACHES,0,LeMolay(FR),0082,0024 FR VALLET (DC),2139,2352,1608,1489,119,863,744,0,213,-9.957924263674615,225,289,289,289,0,0,0,0,64,-28.444444444444443,100.0,100.0,0.0,68.36734693877551,63.30782312925171,5.059523809523803,Production
4071,0,2019-06-01,146523,L2V BRASS FRAM 115X4,0,0,0,LES 2 VACHES,0,LeMolay(FR),0077,0024 FR LILPARK (DC),2139,2352,1608,1489,119,863,744,0,213,-9.957924263674615,59,111,7,7,0,104,104,0,52,-88.13559322033899,6.306306306306306,6.306306306306306,0.0,68.36734693877551,63.30782312925171,5.059523809523803,Production
4072,0,2019-06-01,146523,L2V BRASS FRAM 115X4,0,0,0,LES 2 VACHES,0,LeMolay(FR),0085,0024 FR TOULOUSE (DC),2139,2352,1608,1489,119,863,744,0,213,-9.957924263674615,160,239,239,120,119,119,0,0,79,-49.375,100.0,50.2092050209205,49.7907949790795,68.36734693877551,63.30782312925171,5.059523809523803,Production
4073,0,2019-06-01,146523,L2V BRASS FRAM 115X4,0,0,0,LES 2 VACHES,0,LeMolay(FR),0083,0024 FR CHAPONNAY (DC),2139,2352,1608,1489,119,863,744,0,213,-9.957924263674615,371,318,317,317,0,1,1,0,-53,14.285714285714286,99.68553459119497,99.68553459119497,0.0,68.36734693877551,63.30782312925171,5.059523809523803,Production
4074,0,2019-06-01,146523,L2V BRASS FRAM 115X4,0,0,0,LES 2 VACHES,0,LeMolay(FR),0079,0024 FR PARIS SUD (DC),2139,2352,1608,1489,119,863,744,0,213,-9.957924263674615,428,408,152,152,0,256,256,0,-20,4.672897196261682,37.254901960784316,37.254901960784316,0.0,68.36734693877551,63.30782312925171,5.059523809523803,Production
4075,0,2019-06-01,146523,L2V BRASS FRAM 115X4,0,0,0,LES 2 VACHES,0,LeMolay(FR),0078,0024 FR PARIS NORD (DC),2139,2352,1608,1489,119,863,744,0,213,-9.957924263674615,152,272,6,6,0,266,266,0,120,-78.94736842105263,2.2058823529411766,2.2058823529411766,0.0,68.36734693877551,63.30782312925171,5.059523809523803,Production
4076,0,2019-06-01,146524,L2V 0% BRASS NAT 115X4,0,0,0,LES 2 VACHES,0,LeMolay(FR),0084,0024 FR AIX (DC),233,271,271,102,169,169,0,0,38,-16.30901287553648,47,40,40,0,40,40,0,0,-7,14.893617021276595,100.0,0.0,100.0,100.0,37.63837638376384,62.36162361623616,Production
4077,0,2019-06-01,146524,L2V 0% BRASS NAT 115X4,0,0,0,LES 2 VACHES,0,LeMolay(FR),0080,0024 FR METZ (DC),233,271,271,102,169,169,0,0,38,-16.30901287553648,2,1,1,0,1,1,0,0,-1,50.0,100.0,0.0,100.0,100.0,37.63837638376384,62.36162361623616,Production
4078,0,2019-06-01,146524,L2V 0% BRASS NAT 115X4,0,0,0,LES 2 VACHES,0,LeMolay(FR),0081,0024 FR TOURS (DC),233,271,271,102,169,169,0,0,38,-16.30901287553648,23,31,31,0,31,31,0,0,8,-34.78260869565217,100.0,0.0,100.0,100.0,37.63837638376384,62.36162361623616,Production
4079,0,2019-06-01,146524,L2V 0% BRASS NAT 115X4,0,0,0,LES 2 VACHES,0,LeMolay(FR),0082,0024 FR VALLET (DC),233,271,271,102,169,169,0,0,38,-16.30901287553648,18,19,19,0,19,19,0,0,1,-5.555555555555555,100.0,0.0,100.0,100.0,37.63837638376384,62.36162361623616,Production
4080,0,2019-06-01,146524,L2V 0% BRASS NAT 115X4,0,0,0,LES 2 VACHES,0,LeMolay(FR),0077,0024 FR LILPARK (DC),233,271,271,102,169,169,0,0,38,-16.30901287553648,1,1,1,0,1,1,0,0,0,0.0,100.0,0.0,100.0,100.0,37.63837638376384,62.36162361623616,Production
4081,0,2019-06-01,146524,L2V 0% BRASS NAT 115X4,0,0,0,LES 2 VACHES,0,LeMolay(FR),0085,0024 FR TOULOUSE (DC),233,271,271,102,169,169,0,0,38,-16.30901287553648,16,22,22,0,22,22,0,0,6,-37.5,100.0,0.0,100.0,100.0,37.63837638376384,62.36162361623616,Production
4082,0,2019-06-01,146524,L2V 0% BRASS NAT 115X4,0,0,0,LES 2 VACHES,0,LeMolay(FR),0083,0024 FR CHAPONNAY (DC),233,271,271,102,169,169,0,0,38,-16.30901287553648,38,45,45,0,45,45,0,0,7,-18.42105263157895,100.0,0.0,100.0,100.0,37.63837638376384,62.36162361623616,Production
4083,0,2019-06-01,146524,L2V 0% BRASS NAT 115X4,0,0,0,LES 2 VACHES,0,LeMolay(FR),0079,0024 FR PARIS SUD (DC),233,271,271,102,169,169,0,0,38,-16.30901287553648,71,102,102,102,0,0,0,0,31,-43.66197183098591,100.0,100.0,0.0,100.0,37.63837638376384,62.36162361623616,Production
4084,0,2019-06-01,146524,L2V 0% BRASS NAT 115X4,0,0,0,LES 2 VACHES,0,LeMolay(FR),0078,0024 FR PARIS NORD (DC),233,271,271,102,169,169,0,0,38,-16.30901287553648,17,10,10,0,10,10,0,0,-7,41.1764705882353,100.0,0.0,100.0,100.0,37.63837638376384,62.36162361623616,Production
4085,0,2019-06-01,146543,L2V BRASS MYRT 115X4,0,0,0,LES 2 VACHES,0,LeMolay(FR),0084,0024 FR AIX (DC),3151,2149,1529,1528,1,621,620,0,-1002,31.799428752776898,450,217,112,112,0,105,105,0,-233,51.77777777777778,51.61290322580645,51.61290322580645,0.0,71.1493718008376,71.10283852954863,0.046533271288964784,Production
4086,0,2019-06-01,146543,L2V BRASS MYRT 115X4,0,0,0,LES 2 VACHES,0,LeMolay(FR),0080,0024 FR METZ (DC),3151,2149,1529,1528,1,621,620,0,-1002,31.799428752776898,94,95,30,29,1,66,65,0,1,-1.0638297872340425,31.57894736842105,30.526315789473685,1.0526315789473664,71.1493718008376,71.10283852954863,0.046533271288964784,Production
4087,0,2019-06-01,146543,L2V BRASS MYRT 115X4,0,0,0,LES 2 VACHES,0,LeMolay(FR),0081,0024 FR TOURS (DC),3151,2149,1529,1528,1,621,620,0,-1002,31.799428752776898,382,342,218,218,0,124,124,0,-40,10.471204188481675,63.74269005847953,63.74269005847953,0.0,71.1493718008376,71.10283852954863,0.046533271288964784,Production
4088,0,2019-06-01,146543,L2V BRASS MYRT 115X4,0,0,0,LES 2 VACHES,0,LeMolay(FR),0082,0024 FR VALLET (DC),3151,2149,1529,1528,1,621,620,0,-1002,31.799428752776898,395,278,278,278,0,0,0,0,-117,29.620253164556964,100.0,100.0,0.0,71.1493718008376,71.10283852954863,0.046533271288964784,Production
4089,0,2019-06-01,146543,L2V BRASS MYRT 115X4,0,0,0,LES 2 VACHES,0,LeMolay(FR),0077,0024 FR LILPARK (DC),3151,2149,1529,1528,1,621,620,0,-1002,31.799428752776898,71,80,80,80,0,0,0,0,9,-12.67605633802817,100.0,100.0,0.0,71.1493718008376,71.10283852954863,0.046533271288964784,Production
4090,0,2019-06-01,146543,L2V BRASS MYRT 115X4,0,0,0,LES 2 VACHES,0,LeMolay(FR),0085,0024 FR TOULOUSE (DC),3151,2149,1529,1528,1,621,620,0,-1002,31.799428752776898,304,244,244,244,0,0,0,0,-60,19.736842105263158,100.0,100.0,0.0,71.1493718008376,71.10283852954863,0.046533271288964784,Production
4091,0,2019-06-01,146543,L2V BRASS MYRT 115X4,0,0,0,LES 2 VACHES,0,LeMolay(FR),0083,0024 FR CHAPONNAY (DC),3151,2149,1529,1528,1,621,620,0,-1002,31.799428752776898,599,315,278,278,0,37,37,0,-284,47.412353923205345,88.25396825396825,88.25396825396825,0.0,71.1493718008376,71.10283852954863,0.046533271288964784,Production
4092,0,2019-06-01,146543,L2V BRASS MYRT 115X4,0,0,0,LES 2 VACHES,0,LeMolay(FR),0079,0024 FR PARIS SUD (DC),3151,2149,1529,1528,1,621,620,0,-1002,31.799428752776898,623,393,145,145,0,248,248,0,-230,36.91813804173355,36.895674300254456,36.895674300254456,0.0,71.1493718008376,71.10283852954863,0.046533271288964784,Production
4093,0,2019-06-01,146543,L2V BRASS MYRT 115X4,0,0,0,LES 2 VACHES,0,LeMolay(FR),0078,0024 FR PARIS NORD (DC),3151,2149,1529,1528,1,621,620,0,-1002,31.799428752776898,233,185,144,144,0,41,41,0,-48,20.600858369098713,77.83783783783784,77.83783783783784,0.0,71.1493718008376,71.10283852954863,0.046533271288964784,Production
4094,0,2019-06-01,147230,L2V GOURMEUH MARRON VAN 115X2,0,1,0,LES 2 VACHES,0,LeMolay(FR),0080,0024 FR METZ (DC),238,485,313,60,253,425,172,0,247,-103.78151260504201,16,15,15,7,8,8,0,0,-1,6.25,100.0,46.666666666666664,53.333333333333336,64.5360824742268,12.371134020618557,52.16494845360825,Production
4095,0,2019-06-01,147230,L2V GOURMEUH MARRON VAN 115X2,0,1,0,LES 2 VACHES,0,LeMolay(FR),0081,0024 FR TOURS (DC),238,485,313,60,253,425,172,0,247,-103.78151260504201,61,87,87,3,84,84,0,0,26,-42.622950819672134,100.0,3.4482758620689653,96.55172413793103,64.5360824742268,12.371134020618557,52.16494845360825,Production
4096,0,2019-06-01,147230,L2V GOURMEUH MARRON VAN 115X2,0,1,0,LES 2 VACHES,0,LeMolay(FR),0082,0024 FR VALLET (DC),238,485,313,60,253,425,172,0,247,-103.78151260504201,35,51,51,9,42,42,0,0,16,-45.714285714285715,100.0,17.647058823529413,82.35294117647058,64.5360824742268,12.371134020618557,52.16494845360825,Production
4097,0,2019-06-01,147230,L2V GOURMEUH MARRON VAN 115X2,0,1,0,LES 2 VACHES,0,LeMolay(FR),0077,0024 FR LILPARK (DC),238,485,313,60,253,425,172,0,247,-103.78151260504201,32,60,16,16,0,44,44,0,28,-87.5,26.666666666666668,26.666666666666668,0.0,64.5360824742268,12.371134020618557,52.16494845360825,Production
4098,0,2019-06-01,147230,L2V GOURMEUH MARRON VAN 115X2,0,1,0,LES 2 VACHES,0,LeMolay(FR),0085,0024 FR TOULOUSE (DC),238,485,313,60,253,425,172,0,247,-103.78151260504201,40,65,65,5,60,60,0,0,25,-62.5,100.0,7.6923076923076925,92.3076923076923,64.5360824742268,12.371134020618557,52.16494845360825,Production
4099,0,2019-06-01,147230,L2V GOURMEUH MARRON VAN 115X2,0,1,0,LES 2 VACHES,0,LeMolay(FR),0079,0024 FR PARIS SUD (DC),238,485,313,60,253,425,172,0,247,-103.78151260504201,29,141,13,13,0,128,128,0,112,-386.2068965517241,9.219858156028367,9.219858156028367,0.0,64.5360824742268,12.371134020618557,52.16494845360825,Production
4100,0,2019-06-01,147230,L2V GOURMEUH MARRON VAN 115X2,0,1,0,LES 2 VACHES,0,LeMolay(FR),0078,0024 FR PARIS NORD (DC),238,485,313,60,253,425,172,0,247,-103.78151260504201,25,66,66,7,59,59,0,0,41,-164.0,100.0,10.606060606060606,89.39393939393939,64.5360824742268,12.371134020618557,52.16494845360825,Production
4101,0,2019-06-03,106396,DANET CHOCO 125X8 OD,1,0,0,DANETTE,0,StJust(FR),0080,0024 FR METZ (DC),4571,4465,4465,4465,0,0,0,0,-106,2.3189674031940495,1933,1933,1933,1933,0,0,0,0,0,0.0,100.0,100.0,0.0,100.0,100.0,0.0,A Creuser
4102,0,2019-06-03,106396,DANET CHOCO 125X8 OD,1,0,0,DANETTE,0,StJust(FR),0082,0024 FR VALLET (DC),4571,4465,4465,4465,0,0,0,0,-106,2.3189674031940495,403,403,403,403,0,0,0,0,0,0.0,100.0,100.0,0.0,100.0,100.0,0.0,A Creuser
4103,0,2019-06-03,106396,DANET CHOCO 125X8 OD,1,0,0,DANETTE,0,StJust(FR),0077,0024 FR LILPARK (DC),4571,4465,4465,4465,0,0,0,0,-106,2.3189674031940495,1991,1912,1912,1912,0,0,0,0,-79,3.9678553490708186,100.0,100.0,0.0,100.0,100.0,0.0,A Creuser
4104,0,2019-06-03,106396,DANET CHOCO 125X8 OD,1,0,0,DANETTE,0,StJust(FR),0083,0024 FR CHAPONNAY (DC),4571,4465,4465,4465,0,0,0,0,-106,2.3189674031940495,91,96,96,96,0,0,0,0,5,-5.4945054945054945,100.0,100.0,0.0,100.0,100.0,0.0,A Creuser
4105,0,2019-06-03,106396,DANET CHOCO 125X8 OD,1,0,0,DANETTE,0,StJust(FR),0079,0024 FR PARIS SUD (DC),4571,4465,4465,4465,0,0,0,0,-106,2.3189674031940495,153,121,121,121,0,0,0,0,-32,20.915032679738562,100.0,100.0,0.0,100.0,100.0,0.0,A Creuser
4106,1,2019-06-03,113939,ACTIVIA NATURE 125X12 OD,1,0,0,ACTIVIA,0,Bailleul(FR),0079,0024 FR PARIS SUD (DC),145,473,470,243,227,230,3,0,328,-226.20689655172413,145,375,372,145,227,230,3,0,230,-158.6206896551724,99.2,38.666666666666664,60.53333333333334,99.36575052854123,51.37420718816068,47.991543340380545,Previsions
4107,1,2019-06-03,121428,ACTIMEL FOREST FR 4x(10x100g) FR,0,0,0,ACTIMEL,1,Rotselaar(BE),0077,0024 FR LILPARK (DC),555,743,740,708,32,35,3,0,188,-33.873873873873876,555,555,555,530,25,25,0,0,0,0.0,100.0,95.4954954954955,4.504504504504496,99.59623149394348,95.28936742934052,4.306864064602962,Production
4108,0,2019-06-03,127911,GERVAIS GRIEGO 115X4 VANILLA FR,0,0,0,GERVAIS,1,Rosenheim(ALL),0084,0024 FR AIX (DC),1358,1606,1115,1091,24,515,491,0,248,-18.262150220913107,202,216,204,204,0,12,12,0,14,-6.930693069306931,94.44444444444444,94.44444444444444,0.0,69.42714819427148,67.93275217932752,1.494396014943959,Transport
4109,0,2019-06-03,127911,GERVAIS GRIEGO 115X4 VANILLA FR,0,0,0,GERVAIS,1,Rosenheim(ALL),0080,0024 FR METZ (DC),1358,1606,1115,1091,24,515,491,0,248,-18.262150220913107,150,202,118,117,1,85,84,0,52,-34.666666666666664,58.415841584158414,57.920792079207914,0.4950495049505008,69.42714819427148,67.93275217932752,1.494396014943959,Transport
4110,0,2019-06-03,127911,GERVAIS GRIEGO 115X4 VANILLA FR,0,0,0,GERVAIS,1,Rosenheim(ALL),0081,0024 FR TOURS (DC),1358,1606,1115,1091,24,515,491,0,248,-18.262150220913107,172,218,75,73,2,145,143,0,46,-26.74418604651163,34.403669724770644,33.48623853211009,0.9174311926605512,69.42714819427148,67.93275217932752,1.494396014943959,Transport
4111,0,2019-06-03,127911,GERVAIS GRIEGO 115X4 VANILLA FR,0,0,0,GERVAIS,1,Rosenheim(ALL),0082,0024 FR VALLET (DC),1358,1606,1115,1091,24,515,491,0,248,-18.262150220913107,103,82,54,54,0,28,28,0,-21,20.388349514563107,65.85365853658537,65.85365853658537,0.0,69.42714819427148,67.93275217932752,1.494396014943959,Transport
4112,0,2019-06-03,127911,GERVAIS GRIEGO 115X4 VANILLA FR,0,0,0,GERVAIS,1,Rosenheim(ALL),0077,0024 FR LILPARK (DC),1358,1606,1115,1091,24,515,491,0,248,-18.262150220913107,58,54,54,54,0,0,0,0,-4,6.896551724137931,100.0,100.0,0.0,69.42714819427148,67.93275217932752,1.494396014943959,Transport
4113,0,2019-06-03,127911,GERVAIS GRIEGO 115X4 VANILLA FR,0,0,0,GERVAIS,1,Rosenheim(ALL),0085,0024 FR TOULOUSE (DC),1358,1606,1115,1091,24,515,491,0,248,-18.262150220913107,264,239,239,239,0,0,0,0,-25,9.469696969696969,100.0,100.0,0.0,69.42714819427148,67.93275217932752,1.494396014943959,Transport
4114,0,2019-06-03,127911,GERVAIS GRIEGO 115X4 VANILLA FR,0,0,0,GERVAIS,1,Rosenheim(ALL),0083,0024 FR CHAPONNAY (DC),1358,1606,1115,1091,24,515,491,0,248,-18.262150220913107,133,159,149,131,18,28,10,0,26,-19.548872180451127,93.71069182389937,82.38993710691824,11.320754716981128,69.42714819427148,67.93275217932752,1.494396014943959,Transport
4115,0,2019-06-03,127911,GERVAIS GRIEGO 115X4 VANILLA FR,0,0,0,GERVAIS,1,Rosenheim(ALL),0079,0024 FR PARIS SUD (DC),1358,1606,1115,1091,24,515,491,0,248,-18.262150220913107,147,214,214,214,0,0,0,0,67,-45.57823129251701,100.0,100.0,0.0,69.42714819427148,67.93275217932752,1.494396014943959,Transport
4116,0,2019-06-03,127911,GERVAIS GRIEGO 115X4 VANILLA FR,0,0,0,GERVAIS,1,Rosenheim(ALL),0078,0024 FR PARIS NORD (DC),1358,1606,1115,1091,24,515,491,0,248,-18.262150220913107,129,222,8,5,3,217,214,0,93,-72.09302325581395,3.6036036036036037,2.2522522522522523,1.3513513513513513,69.42714819427148,67.93275217932752,1.494396014943959,Transport
4117,1,2019-06-03,127962,DANET CHOCO NOISET 125X4 PC,1,0,0,DANETTE,0,StJust(FR),0078,0024 FR PARIS NORD (DC),139,647,647,608,39,39,0,0,508,-365.46762589928056,139,107,107,68,39,39,0,0,-32,23.02158273381295,100.0,63.55140186915887,36.44859813084113,100.0,93.97217928902627,6.027820710973728,A Creuser
4118,0,2019-06-03,127970,DANET CHOCO 125X8,0,0,0,DANETTE,0,StJust(FR),0084,0024 FR AIX (DC),2216,2150,1870,1870,0,280,280,0,-66,2.9783393501805056,80,55,55,55,0,0,0,0,-25,31.25,100.0,100.0,0.0,86.9767441860465,86.9767441860465,0.0,A Creuser
4119,0,2019-06-03,127970,DANET CHOCO 125X8,0,0,0,DANETTE,0,StJust(FR),0080,0024 FR METZ (DC),2216,2150,1870,1870,0,280,280,0,-66,2.9783393501805056,396,518,238,238,0,280,280,0,122,-30.80808080808081,45.94594594594595,45.94594594594595,0.0,86.9767441860465,86.9767441860465,0.0,A Creuser
4120,1,2019-06-03,127970,DANET CHOCO 125X8,0,0,0,DANETTE,0,StJust(FR),0080,0024 FR METZ (DC),2216,2150,1870,1870,0,280,280,0,-66,2.9783393501805056,396,518,238,238,0,280,280,0,122,-30.80808080808081,45.94594594594595,45.94594594594595,0.0,86.9767441860465,86.9767441860465,0.0,A Creuser
4121,0,2019-06-03,127970,DANET CHOCO 125X8,0,0,0,DANETTE,0,StJust(FR),0081,0024 FR TOURS (DC),2216,2150,1870,1870,0,280,280,0,-66,2.9783393501805056,298,274,274,274,0,0,0,0,-24,8.053691275167786,100.0,100.0,0.0,86.9767441860465,86.9767441860465,0.0,A Creuser
4122,0,2019-06-03,127970,DANET CHOCO 125X8,0,0,0,DANETTE,0,StJust(FR),0082,0024 FR VALLET (DC),2216,2150,1870,1870,0,280,280,0,-66,2.9783393501805056,-26,10,10,10,0,0,0,0,36,138.46153846153845,100.0,100.0,0.0,86.9767441860465,86.9767441860465,0.0,A Creuser
4123,0,2019-06-03,127970,DANET CHOCO 125X8,0,0,0,DANETTE,0,StJust(FR),0077,0024 FR LILPARK (DC),2216,2150,1870,1870,0,280,280,0,-66,2.9783393501805056,92,74,74,74,0,0,0,0,-18,19.565217391304348,100.0,100.0,0.0,86.9767441860465,86.9767441860465,0.0,A Creuser
4124,0,2019-06-03,127970,DANET CHOCO 125X8,0,0,0,DANETTE,0,StJust(FR),0085,0024 FR TOULOUSE (DC),2216,2150,1870,1870,0,280,280,0,-66,2.9783393501805056,119,406,406,406,0,0,0,0,287,-241.1764705882353,100.0,100.0,0.0,86.9767441860465,86.9767441860465,0.0,A Creuser
4125,0,2019-06-03,127970,DANET CHOCO 125X8,0,0,0,DANETTE,0,StJust(FR),0083,0024 FR CHAPONNAY (DC),2216,2150,1870,1870,0,280,280,0,-66,2.9783393501805056,101,90,90,90,0,0,0,0,-11,10.891089108910892,100.0,100.0,0.0,86.9767441860465,86.9767441860465,0.0,A Creuser
4126,0,2019-06-03,127970,DANET CHOCO 125X8,0,0,0,DANETTE,0,StJust(FR),0079,0024 FR PARIS SUD (DC),2216,2150,1870,1870,0,280,280,0,-66,2.9783393501805056,276,293,293,293,0,0,0,0,17,-6.159420289855072,100.0,100.0,0.0,86.9767441860465,86.9767441860465,0.0,A Creuser
4127,0,2019-06-03,127970,DANET CHOCO 125X8,0,0,0,DANETTE,0,StJust(FR),0078,0024 FR PARIS NORD (DC),2216,2150,1870,1870,0,280,280,0,-66,2.9783393501805056,484,430,430,430,0,0,0,0,-54,11.15702479338843,100.0,100.0,0.0,86.9767441860465,86.9767441860465,0.0,A Creuser
4128,1,2019-06-03,131477,ACTIVIA FRT PEAR 125X4 OD,1,0,0,ACTIVIA,0,Villecomtal(FR),0077,0024 FR LILPARK (DC),110,436,352,291,61,145,84,0,326,-296.3636363636364,110,120,120,59,61,61,0,0,10,-9.090909090909092,100.0,49.166666666666664,50.833333333333336,80.73394495412845,66.74311926605505,13.9908256880734,A Creuser
4129,1,2019-06-03,131482,ACTIVIA FRT PINEAPPLE 125X4 OD,1,0,0,ACTIVIA,0,Villecomtal(FR),0077,0024 FR LILPARK (DC),110,595,496,435,61,160,99,0,485,-440.90909090909093,110,110,110,49,61,61,0,0,0,0.0,100.0,44.54545454545455,55.45454545454545,83.36134453781513,73.10924369747899,10.25210084033614,A Creuser
4130,1,2019-06-03,131483,ACTIVIA FRT STRAWBERRY 125X4 OD,1,0,0,ACTIVIA,0,Villecomtal(FR),0077,0024 FR LILPARK (DC),155,690,573,488,85,202,117,0,535,-345.16129032258067,155,170,170,87,83,83,0,0,15,-9.67741935483871,100.0,51.17647058823529,48.82352941176471,83.04347826086956,70.72463768115942,12.318840579710141,A Creuser
4131,1,2019-06-03,132459,ACTIVIA SAV VANILLE 125X4 OD,0,0,0,ACTIVIA,0,Bailleul(FR),0085,0024 FR TOULOUSE (DC),65,638,619,607,12,31,19,0,573,-881.5384615384615,19,60,42,42,0,18,18,0,41,-215.78947368421052,70.0,70.0,0.0,97.02194357366771,95.141065830721,1.8808777429467085,Previsions
4132,1,2019-06-03,132459,ACTIVIA SAV VANILLE 125X4 OD,0,0,0,ACTIVIA,0,Bailleul(FR),0078,0024 FR PARIS NORD (DC),65,638,619,607,12,31,19,0,573,-881.5384615384615,46,46,45,33,12,13,1,0,0,0.0,97.82608695652173,71.73913043478261,26.086956521739125,97.02194357366771,95.141065830721,1.8808777429467085,Previsions
4133,0,2019-06-03,136162,FJORD NATURE 125X8 D,1,0,0,FJORD,0,LeMolay(FR),0080,0024 FR METZ (DC),558,832,832,448,384,384,0,0,274,-49.10394265232975,138,192,192,192,0,0,0,0,54,-39.130434782608695,100.0,100.0,0.0,100.0,53.84615384615385,46.15384615384615,Production
4134,0,2019-06-03,136162,FJORD NATURE 125X8 D,1,0,0,FJORD,0,LeMolay(FR),0081,0024 FR TOURS (DC),558,832,832,448,384,384,0,0,274,-49.10394265232975,54,64,64,64,0,0,0,0,10,-18.51851851851852,100.0,100.0,0.0,100.0,53.84615384615385,46.15384615384615,Production
4135,0,2019-06-03,136162,FJORD NATURE 125X8 D,1,0,0,FJORD,0,LeMolay(FR),0077,0024 FR LILPARK (DC),558,832,832,448,384,384,0,0,274,-49.10394265232975,59,64,64,64,0,0,0,0,5,-8.474576271186441,100.0,100.0,0.0,100.0,53.84615384615385,46.15384615384615,Production
4136,0,2019-06-03,136162,FJORD NATURE 125X8 D,1,0,0,FJORD,0,LeMolay(FR),0085,0024 FR TOULOUSE (DC),558,832,832,448,384,384,0,0,274,-49.10394265232975,74,128,128,128,0,0,0,0,54,-72.97297297297297,100.0,100.0,0.0,100.0,53.84615384615385,46.15384615384615,Production
4137,0,2019-06-03,136162,FJORD NATURE 125X8 D,1,0,0,FJORD,0,LeMolay(FR),0083,0024 FR CHAPONNAY (DC),558,832,832,448,384,384,0,0,274,-49.10394265232975,233,384,384,0,384,384,0,0,151,-64.8068669527897,100.0,0.0,100.0,100.0,53.84615384615385,46.15384615384615,Production
4138,1,2019-06-03,136436,ACTIVIA FRT CERISE 125X4 OD,1,0,0,ACTIVIA,0,Villecomtal(FR),0077,0024 FR LILPARK (DC),97,512,439,380,59,132,73,0,415,-427.83505154639175,97,108,108,55,53,53,0,0,11,-11.34020618556701,100.0,50.92592592592593,49.07407407407407,85.7421875,74.21875,11.5234375,A Creuser
4139,0,2019-06-03,146086,ACTIMEL ORIGINAL 4x(6x100g) FR,0,0,0,ACTIMEL,1,Rotselaar(BE),0084,0024 FR AIX (DC),456,960,707,699,8,261,253,0,504,-110.52631578947368,50,121,113,112,1,9,8,0,71,-142.0,93.38842975206612,92.56198347107438,0.8264462809917319,73.64583333333333,72.8125,0.8333333333333286,A Creuser
4140,0,2019-06-03,146086,ACTIMEL ORIGINAL 4x(6x100g) FR,0,0,0,ACTIMEL,1,Rotselaar(BE),0080,0024 FR METZ (DC),456,960,707,699,8,261,253,0,504,-110.52631578947368,63,72,72,72,0,0,0,0,9,-14.285714285714286,100.0,100.0,0.0,73.64583333333333,72.8125,0.8333333333333286,A Creuser
4141,0,2019-06-03,146086,ACTIMEL ORIGINAL 4x(6x100g) FR,0,0,0,ACTIMEL,1,Rotselaar(BE),0081,0024 FR TOURS (DC),456,960,707,699,8,261,253,0,504,-110.52631578947368,74,131,131,131,0,0,0,0,57,-77.02702702702703,100.0,100.0,0.0,73.64583333333333,72.8125,0.8333333333333286,A Creuser
4142,0,2019-06-03,146086,ACTIMEL ORIGINAL 4x(6x100g) FR,0,0,0,ACTIMEL,1,Rotselaar(BE),0082,0024 FR VALLET (DC),456,960,707,699,8,261,253,0,504,-110.52631578947368,48,71,71,71,0,0,0,0,23,-47.916666666666664,100.0,100.0,0.0,73.64583333333333,72.8125,0.8333333333333286,A Creuser
4143,0,2019-06-03,146086,ACTIMEL ORIGINAL 4x(6x100g) FR,0,0,0,ACTIMEL,1,Rotselaar(BE),0077,0024 FR LILPARK (DC),456,960,707,699,8,261,253,0,504,-110.52631578947368,8,39,7,6,1,33,32,0,31,-387.5,17.94871794871795,15.384615384615385,2.564102564102564,73.64583333333333,72.8125,0.8333333333333286,A Creuser
4144,0,2019-06-03,146086,ACTIMEL ORIGINAL 4x(6x100g) FR,0,0,0,ACTIMEL,1,Rotselaar(BE),0085,0024 FR TOULOUSE (DC),456,960,707,699,8,261,253,0,504,-110.52631578947368,50,112,90,84,6,28,22,0,62,-124.0,80.35714285714286,75.0,5.357142857142861,73.64583333333333,72.8125,0.8333333333333286,A Creuser
4145,0,2019-06-03,146086,ACTIMEL ORIGINAL 4x(6x100g) FR,0,0,0,ACTIMEL,1,Rotselaar(BE),0083,0024 FR CHAPONNAY (DC),456,960,707,699,8,261,253,0,504,-110.52631578947368,55,121,121,121,0,0,0,0,66,-120.0,100.0,100.0,0.0,73.64583333333333,72.8125,0.8333333333333286,A Creuser
4146,0,2019-06-03,146086,ACTIMEL ORIGINAL 4x(6x100g) FR,0,0,0,ACTIMEL,1,Rotselaar(BE),0079,0024 FR PARIS SUD (DC),456,960,707,699,8,261,253,0,504,-110.52631578947368,64,206,48,48,0,158,158,0,142,-221.875,23.300970873786408,23.300970873786408,0.0,73.64583333333333,72.8125,0.8333333333333286,A Creuser
4147,0,2019-06-03,146086,ACTIMEL ORIGINAL 4x(6x100g) FR,0,0,0,ACTIMEL,1,Rotselaar(BE),0078,0024 FR PARIS NORD (DC),456,960,707,699,8,261,253,0,504,-110.52631578947368,44,87,54,54,0,33,33,0,43,-97.72727272727273,62.06896551724138,62.06896551724138,0.0,73.64583333333333,72.8125,0.8333333333333286,A Creuser
4148,0,2019-06-03,146376,L2V BRASS VAN 115X4,0,0,0,LES 2 VACHES,0,LeMolay(FR),0084,0024 FR AIX (DC),4860,3527,2597,2596,1,931,930,0,-1333,27.42798353909465,430,233,233,233,0,0,0,0,-197,45.81395348837209,100.0,100.0,0.0,73.63198185426708,73.6036291465835,0.028352707683581002,Production
4149,0,2019-06-03,146376,L2V BRASS VAN 115X4,0,0,0,LES 2 VACHES,0,LeMolay(FR),0080,0024 FR METZ (DC),4860,3527,2597,2596,1,931,930,0,-1333,27.42798353909465,429,351,161,161,0,190,190,0,-78,18.181818181818183,45.86894586894587,45.86894586894587,0.0,73.63198185426708,73.6036291465835,0.028352707683581002,Production
4150,0,2019-06-03,146376,L2V BRASS VAN 115X4,0,0,0,LES 2 VACHES,0,LeMolay(FR),0081,0024 FR TOURS (DC),4860,3527,2597,2596,1,931,930,0,-1333,27.42798353909465,543,380,326,326,0,54,54,0,-163,30.01841620626151,85.78947368421052,85.78947368421052,0.0,73.63198185426708,73.6036291465835,0.028352707683581002,Production
4151,0,2019-06-03,146376,L2V BRASS VAN 115X4,0,0,0,LES 2 VACHES,0,LeMolay(FR),0082,0024 FR VALLET (DC),4860,3527,2597,2596,1,931,930,0,-1333,27.42798353909465,439,229,205,205,0,24,24,0,-210,47.83599088838269,89.51965065502183,89.51965065502183,0.0,73.63198185426708,73.6036291465835,0.028352707683581002,Production
4152,0,2019-06-03,146376,L2V BRASS VAN 115X4,0,0,0,LES 2 VACHES,0,LeMolay(FR),0077,0024 FR LILPARK (DC),4860,3527,2597,2596,1,931,930,0,-1333,27.42798353909465,311,257,257,257,0,0,0,0,-54,17.363344051446944,100.0,100.0,0.0,73.63198185426708,73.6036291465835,0.028352707683581002,Production
4153,0,2019-06-03,146376,L2V BRASS VAN 115X4,0,0,0,LES 2 VACHES,0,LeMolay(FR),0085,0024 FR TOULOUSE (DC),4860,3527,2597,2596,1,931,930,0,-1333,27.42798353909465,896,651,370,369,1,282,281,0,-245,27.34375,56.83563748079877,56.68202764976959,0.15360983102918624,73.63198185426708,73.6036291465835,0.028352707683581002,Production
4154,0,2019-06-03,146376,L2V BRASS VAN 115X4,0,0,0,LES 2 VACHES,0,LeMolay(FR),0083,0024 FR CHAPONNAY (DC),4860,3527,2597,2596,1,931,930,0,-1333,27.42798353909465,522,479,294,294,0,185,185,0,-43,8.237547892720306,61.37787056367432,61.37787056367432,0.0,73.63198185426708,73.6036291465835,0.028352707683581002,Production
4155,0,2019-06-03,146376,L2V BRASS VAN 115X4,0,0,0,LES 2 VACHES,0,LeMolay(FR),0079,0024 FR PARIS SUD (DC),4860,3527,2597,2596,1,931,930,0,-1333,27.42798353909465,585,709,621,621,0,88,88,0,124,-21.196581196581196,87.58815232722144,87.58815232722144,0.0,73.63198185426708,73.6036291465835,0.028352707683581002,Production
4156,0,2019-06-03,146376,L2V BRASS VAN 115X4,0,0,0,LES 2 VACHES,0,LeMolay(FR),0078,0024 FR PARIS NORD (DC),4860,3527,2597,2596,1,931,930,0,-1333,27.42798353909465,705,238,130,130,0,108,108,0,-467,66.24113475177305,54.621848739495796,54.621848739495796,0.0,73.63198185426708,73.6036291465835,0.028352707683581002,Production
4157,0,2019-06-04,121428,ACTIMEL FOREST FR 4x(10x100g) FR,0,0,0,ACTIMEL,1,Rotselaar(BE),0084,0024 FR AIX (DC),2086,1219,1155,908,247,311,64,0,-867,41.56279961649089,9,9,9,9,0,0,0,0,0,0.0,100.0,100.0,0.0,94.74979491386382,74.48728465955702,20.262510254306804,Production
4158,0,2019-06-04,121428,ACTIMEL FOREST FR 4x(10x100g) FR,0,0,0,ACTIMEL,1,Rotselaar(BE),0080,0024 FR METZ (DC),2086,1219,1155,908,247,311,64,0,-867,41.56279961649089,289,288,288,288,0,0,0,0,-1,0.3460207612456747,100.0,100.0,0.0,94.74979491386382,74.48728465955702,20.262510254306804,Production
4159,0,2019-06-04,121428,ACTIMEL FOREST FR 4x(10x100g) FR,0,0,0,ACTIMEL,1,Rotselaar(BE),0081,0024 FR TOURS (DC),2086,1219,1155,908,247,311,64,0,-867,41.56279961649089,263,263,263,201,62,62,0,0,0,0.0,100.0,76.42585551330798,23.57414448669202,94.74979491386382,74.48728465955702,20.262510254306804,Production
4160,1,2019-06-04,121428,ACTIMEL FOREST FR 4x(10x100g) FR,0,0,0,ACTIMEL,1,Rotselaar(BE),0081,0024 FR TOURS (DC),2086,1219,1155,908,247,311,64,0,-867,41.56279961649089,263,263,263,201,62,62,0,0,0,0.0,100.0,76.42585551330798,23.57414448669202,94.74979491386382,74.48728465955702,20.262510254306804,Production
4161,0,2019-06-04,121428,ACTIMEL FOREST FR 4x(10x100g) FR,0,0,0,ACTIMEL,1,Rotselaar(BE),0082,0024 FR VALLET (DC),2086,1219,1155,908,247,311,64,0,-867,41.56279961649089,118,118,118,0,118,118,0,0,0,0.0,100.0,0.0,100.0,94.74979491386382,74.48728465955702,20.262510254306804,Production
4162,1,2019-06-04,121428,ACTIMEL FOREST FR 4x(10x100g) FR,0,0,0,ACTIMEL,1,Rotselaar(BE),0082,0024 FR VALLET (DC),2086,1219,1155,908,247,311,64,0,-867,41.56279961649089,118,118,118,0,118,118,0,0,0,0.0,100.0,0.0,100.0,94.74979491386382,74.48728465955702,20.262510254306804,Production
4163,0,2019-06-04,121428,ACTIMEL FOREST FR 4x(10x100g) FR,0,0,0,ACTIMEL,1,Rotselaar(BE),0077,0024 FR LILPARK (DC),2086,1219,1155,908,247,311,64,0,-867,41.56279961649089,67,50,50,50,0,0,0,0,-17,25.37313432835821,100.0,100.0,0.0,94.74979491386382,74.48728465955702,20.262510254306804,Production
4164,0,2019-06-04,121428,ACTIMEL FOREST FR 4x(10x100g) FR,0,0,0,ACTIMEL,1,Rotselaar(BE),0085,0024 FR TOULOUSE (DC),2086,1219,1155,908,247,311,64,0,-867,41.56279961649089,27,26,26,26,0,0,0,0,-1,3.7037037037037037,100.0,100.0,0.0,94.74979491386382,74.48728465955702,20.262510254306804,Production
4165,0,2019-06-04,121428,ACTIMEL FOREST FR 4x(10x100g) FR,0,0,0,ACTIMEL,1,Rotselaar(BE),0083,0024 FR CHAPONNAY (DC),2086,1219,1155,908,247,311,64,0,-867,41.56279961649089,247,246,246,185,61,61,0,0,-1,0.4048582995951417,100.0,75.20325203252033,24.796747967479675,94.74979491386382,74.48728465955702,20.262510254306804,Production
4166,1,2019-06-04,121428,ACTIMEL FOREST FR 4x(10x100g) FR,0,0,0,ACTIMEL,1,Rotselaar(BE),0083,0024 FR CHAPONNAY (DC),2086,1219,1155,908,247,311,64,0,-867,41.56279961649089,247,246,246,185,61,61,0,0,-1,0.4048582995951417,100.0,75.20325203252033,24.796747967479675,94.74979491386382,74.48728465955702,20.262510254306804,Production
4167,0,2019-06-04,121428,ACTIMEL FOREST FR 4x(10x100g) FR,0,0,0,ACTIMEL,1,Rotselaar(BE),0078,0024 FR PARIS NORD (DC),2086,1219,1155,908,247,311,64,0,-867,41.56279961649089,219,219,155,149,6,70,64,0,0,0.0,70.77625570776256,68.0365296803653,2.7397260273972535,94.74979491386382,74.48728465955702,20.262510254306804,Production
4168,1,2019-06-04,121428,ACTIMEL FOREST FR 4x(10x100g) FR,0,0,0,ACTIMEL,1,Rotselaar(BE),0078,0024 FR PARIS NORD (DC),2086,1219,1155,908,247,311,64,0,-867,41.56279961649089,219,219,155,149,6,70,64,0,0,0.0,70.77625570776256,68.0365296803653,2.7397260273972535,94.74979491386382,74.48728465955702,20.262510254306804,Production
4169,1,2019-06-04,132458,ACTIVIA SAV CITRON 125X4 OD,0,0,0,ACTIVIA,0,Bailleul(FR),0084,0024 FR AIX (DC),18,326,310,250,60,76,16,0,308,-1711.111111111111,11,66,66,7,59,59,0,0,55,-500.0,100.0,10.606060606060606,89.39393939393939,95.0920245398773,76.68711656441718,18.40490797546012,Previsions
4170,1,2019-06-04,132458,ACTIVIA SAV CITRON 125X4 OD,0,0,0,ACTIVIA,0,Bailleul(FR),0079,0024 FR PARIS SUD (DC),18,326,310,250,60,76,16,0,308,-1711.111111111111,7,17,1,0,1,17,16,0,10,-142.85714285714286,5.88235294117647,0.0,5.88235294117647,95.0920245398773,76.68711656441718,18.40490797546012,Previsions
4171,0,2019-06-04,133234,VELOUTE FRUIX PANACHE 125X12 D,1,0,0,VELOUTE,0,Villecomtal(FR),0084,0024 FR AIX (DC),3362,3168,2962,2962,0,206,206,0,-194,5.7703747769185005,182,144,144,144,0,0,0,0,-38,20.87912087912088,100.0,100.0,0.0,93.49747474747475,93.49747474747475,0.0,Production
4172,0,2019-06-04,133234,VELOUTE FRUIX PANACHE 125X12 D,1,0,0,VELOUTE,0,Villecomtal(FR),0080,0024 FR METZ (DC),3362,3168,2962,2962,0,206,206,0,-194,5.7703747769185005,246,432,432,432,0,0,0,0,186,-75.60975609756098,100.0,100.0,0.0,93.49747474747475,93.49747474747475,0.0,Production
4173,0,2019-06-04,133234,VELOUTE FRUIX PANACHE 125X12 D,1,0,0,VELOUTE,0,Villecomtal(FR),0081,0024 FR TOURS (DC),3362,3168,2962,2962,0,206,206,0,-194,5.7703747769185005,381,432,432,432,0,0,0,0,51,-13.385826771653543,100.0,100.0,0.0,93.49747474747475,93.49747474747475,0.0,Production
4174,0,2019-06-04,133234,VELOUTE FRUIX PANACHE 125X12 D,1,0,0,VELOUTE,0,Villecomtal(FR),0082,0024 FR VALLET (DC),3362,3168,2962,2962,0,206,206,0,-194,5.7703747769185005,203,144,144,144,0,0,0,0,-59,29.064039408866996,100.0,100.0,0.0,93.49747474747475,93.49747474747475,0.0,Production
4175,0,2019-06-04,133234,VELOUTE FRUIX PANACHE 125X12 D,1,0,0,VELOUTE,0,Villecomtal(FR),0077,0024 FR LILPARK (DC),3362,3168,2962,2962,0,206,206,0,-194,5.7703747769185005,264,288,288,288,0,0,0,0,24,-9.090909090909092,100.0,100.0,0.0,93.49747474747475,93.49747474747475,0.0,Production
4176,0,2019-06-04,133234,VELOUTE FRUIX PANACHE 125X12 D,1,0,0,VELOUTE,0,Villecomtal(FR),0083,0024 FR CHAPONNAY (DC),3362,3168,2962,2962,0,206,206,0,-194,5.7703747769185005,720,576,576,576,0,0,0,0,-144,20.0,100.0,100.0,0.0,93.49747474747475,93.49747474747475,0.0,Production
4177,0,2019-06-04,133234,VELOUTE FRUIX PANACHE 125X12 D,1,0,0,VELOUTE,0,Villecomtal(FR),0079,0024 FR PARIS SUD (DC),3362,3168,2962,2962,0,206,206,0,-194,5.7703747769185005,240,432,226,226,0,206,206,0,192,-80.0,52.31481481481482,52.31481481481482,0.0,93.49747474747475,93.49747474747475,0.0,Production
4178,0,2019-06-04,133234,VELOUTE FRUIX PANACHE 125X12 D,1,0,0,VELOUTE,0,Villecomtal(FR),0078,0024 FR PARIS NORD (DC),3362,3168,2962,2962,0,206,206,0,-194,5.7703747769185005,1126,720,720,720,0,0,0,0,-406,36.05683836589698,100.0,100.0,0.0,93.49747474747475,93.49747474747475,0.0,Production
4179,0,2019-06-04,140280,Activia chia/raspb/muesli 170g FR-copack,0,0,0,ACTIVIA,1,Roumanie(RO),0084,0024 FR AIX (DC),826,1359,1232,1031,201,328,127,0,533,-64.52784503631962,103,164,164,164,0,0,0,0,61,-59.22330097087379,100.0,100.0,0.0,90.65489330389993,75.86460632818248,14.79028697571745,A Creuser
4180,0,2019-06-04,140280,Activia chia/raspb/muesli 170g FR-copack,0,0,0,ACTIVIA,1,Roumanie(RO),0080,0024 FR METZ (DC),826,1359,1232,1031,201,328,127,0,533,-64.52784503631962,51,64,64,64,0,0,0,0,13,-25.49019607843137,100.0,100.0,0.0,90.65489330389993,75.86460632818248,14.79028697571745,A Creuser
4181,0,2019-06-04,140280,Activia chia/raspb/muesli 170g FR-copack,0,0,0,ACTIVIA,1,Roumanie(RO),0081,0024 FR TOURS (DC),826,1359,1232,1031,201,328,127,0,533,-64.52784503631962,80,159,159,159,0,0,0,0,79,-98.75,100.0,100.0,0.0,90.65489330389993,75.86460632818248,14.79028697571745,A Creuser
4182,0,2019-06-04,140280,Activia chia/raspb/muesli 170g FR-copack,0,0,0,ACTIVIA,1,Roumanie(RO),0082,0024 FR VALLET (DC),826,1359,1232,1031,201,328,127,0,533,-64.52784503631962,74,201,201,29,172,172,0,0,127,-171.6216216216216,100.0,14.427860696517413,85.57213930348259,90.65489330389993,75.86460632818248,14.79028697571745,A Creuser
4183,0,2019-06-04,140280,Activia chia/raspb/muesli 170g FR-copack,0,0,0,ACTIVIA,1,Roumanie(RO),0077,0024 FR LILPARK (DC),826,1359,1232,1031,201,328,127,0,533,-64.52784503631962,72,111,28,0,28,111,83,0,39,-54.166666666666664,25.225225225225223,0.0,25.225225225225223,90.65489330389993,75.86460632818248,14.79028697571745,A Creuser
4184,0,2019-06-04,140280,Activia chia/raspb/muesli 170g FR-copack,0,0,0,ACTIVIA,1,Roumanie(RO),0085,0024 FR TOULOUSE (DC),826,1359,1232,1031,201,328,127,0,533,-64.52784503631962,93,137,137,137,0,0,0,0,44,-47.31182795698925,100.0,100.0,0.0,90.65489330389993,75.86460632818248,14.79028697571745,A Creuser
4185,0,2019-06-04,140280,Activia chia/raspb/muesli 170g FR-copack,0,0,0,ACTIVIA,1,Roumanie(RO),0083,0024 FR CHAPONNAY (DC),826,1359,1232,1031,201,328,127,0,533,-64.52784503631962,107,134,134,134,0,0,0,0,27,-25.233644859813083,100.0,100.0,0.0,90.65489330389993,75.86460632818248,14.79028697571745,A Creuser
4186,0,2019-06-04,140280,Activia chia/raspb/muesli 170g FR-copack,0,0,0,ACTIVIA,1,Roumanie(RO),0079,0024 FR PARIS SUD (DC),826,1359,1232,1031,201,328,127,0,533,-64.52784503631962,80,149,149,149,0,0,0,0,69,-86.25,100.0,100.0,0.0,90.65489330389993,75.86460632818248,14.79028697571745,A Creuser
4187,0,2019-06-04,140280,Activia chia/raspb/muesli 170g FR-copack,0,0,0,ACTIVIA,1,Roumanie(RO),0078,0024 FR PARIS NORD (DC),826,1359,1232,1031,201,328,127,0,533,-64.52784503631962,166,240,196,195,1,45,44,0,74,-44.57831325301205,81.66666666666667,81.25,0.4166666666666714,90.65489330389993,75.86460632818248,14.79028697571745,A Creuser
4188,0,2019-06-05,32788,TAILLEF CHEESE VANILLA 120X4,0,0,0,TAILLEFINE,0,Ferrières(FR),0084,0024 FR AIX (DC),2967,2897,2627,2627,0,270,270,0,-70,2.3592854735422986,473,363,363,363,0,0,0,0,-110,23.25581395348837,100.0,100.0,0.0,90.68001380738696,90.68001380738696,0.0,Previsions
4189,0,2019-06-05,32788,TAILLEF CHEESE VANILLA 120X4,0,0,0,TAILLEFINE,0,Ferrières(FR),0080,0024 FR METZ (DC),2967,2897,2627,2627,0,270,270,0,-70,2.3592854735422986,222,239,239,239,0,0,0,0,17,-7.657657657657658,100.0,100.0,0.0,90.68001380738696,90.68001380738696,0.0,Previsions
4190,0,2019-06-05,32788,TAILLEF CHEESE VANILLA 120X4,0,0,0,TAILLEFINE,0,Ferrières(FR),0081,0024 FR TOURS (DC),2967,2897,2627,2627,0,270,270,0,-70,2.3592854735422986,214,220,220,220,0,0,0,0,6,-2.803738317757009,100.0,100.0,0.0,90.68001380738696,90.68001380738696,0.0,Previsions
4191,0,2019-06-05,32788,TAILLEF CHEESE VANILLA 120X4,0,0,0,TAILLEFINE,0,Ferrières(FR),0082,0024 FR VALLET (DC),2967,2897,2627,2627,0,270,270,0,-70,2.3592854735422986,248,120,120,120,0,0,0,0,-128,51.61290322580645,100.0,100.0,0.0,90.68001380738696,90.68001380738696,0.0,Previsions
4192,0,2019-06-05,32788,TAILLEF CHEESE VANILLA 120X4,0,0,0,TAILLEFINE,0,Ferrières(FR),0077,0024 FR LILPARK (DC),2967,2897,2627,2627,0,270,270,0,-70,2.3592854735422986,191,181,181,181,0,0,0,0,-10,5.2356020942408374,100.0,100.0,0.0,90.68001380738696,90.68001380738696,0.0,Previsions
4193,0,2019-06-05,32788,TAILLEF CHEESE VANILLA 120X4,0,0,0,TAILLEFINE,0,Ferrières(FR),0085,0024 FR TOULOUSE (DC),2967,2897,2627,2627,0,270,270,0,-70,2.3592854735422986,361,365,365,365,0,0,0,0,4,-1.10803324099723,100.0,100.0,0.0,90.68001380738696,90.68001380738696,0.0,Previsions
4194,0,2019-06-05,32788,TAILLEF CHEESE VANILLA 120X4,0,0,0,TAILLEFINE,0,Ferrières(FR),0083,0024 FR CHAPONNAY (DC),2967,2897,2627,2627,0,270,270,0,-70,2.3592854735422986,288,306,306,306,0,0,0,0,18,-6.25,100.0,100.0,0.0,90.68001380738696,90.68001380738696,0.0,Previsions
4195,0,2019-06-05,32788,TAILLEF CHEESE VANILLA 120X4,0,0,0,TAILLEFINE,0,Ferrières(FR),0079,0024 FR PARIS SUD (DC),2967,2897,2627,2627,0,270,270,0,-70,2.3592854735422986,499,605,411,411,0,194,194,0,106,-21.24248496993988,67.93388429752066,67.93388429752066,0.0,90.68001380738696,90.68001380738696,0.0,Previsions
4196,0,2019-06-05,32788,TAILLEF CHEESE VANILLA 120X4,0,0,0,TAILLEFINE,0,Ferrières(FR),0078,0024 FR PARIS NORD (DC),2967,2897,2627,2627,0,270,270,0,-70,2.3592854735422986,471,498,422,422,0,76,76,0,27,-5.732484076433121,84.73895582329317,84.73895582329317,0.0,90.68001380738696,90.68001380738696,0.0,Previsions
4197,1,2019-06-06,132458,ACTIVIA SAV CITRON 125X4 OD,0,0,0,ACTIVIA,0,Bailleul(FR),0083,0024 FR CHAPONNAY (DC),319,841,781,734,47,107,60,0,522,-163.63636363636363,319,324,264,219,45,105,60,0,5,-1.567398119122257,81.48148148148148,67.5925925925926,13.888888888888886,92.86563614744352,87.27705112960761,5.588585017835911,Previsions
4198,0,2019-06-06,133234,VELOUTE FRUIX PANACHE 125X12 D,1,0,0,VELOUTE,0,Villecomtal(FR),0084,0024 FR AIX (DC),2551,5903,5565,5421,144,482,338,0,3352,-131.39945119560957,197,432,432,432,0,0,0,0,235,-119.28934010152284,100.0,100.0,0.0,94.27409791631374,91.83466034219889,2.439437574114848,A Creuser
4199,0,2019-06-06,133234,VELOUTE FRUIX PANACHE 125X12 D,1,0,0,VELOUTE,0,Villecomtal(FR),0080,0024 FR METZ (DC),2551,5903,5565,5421,144,482,338,0,3352,-131.39945119560957,228,576,576,576,0,0,0,0,348,-152.6315789473684,100.0,100.0,0.0,94.27409791631374,91.83466034219889,2.439437574114848,A Creuser
4200,0,2019-06-06,133234,VELOUTE FRUIX PANACHE 125X12 D,1,0,0,VELOUTE,0,Villecomtal(FR),0081,0024 FR TOURS (DC),2551,5903,5565,5421,144,482,338,0,3352,-131.39945119560957,225,288,237,237,0,51,51,0,63,-28.0,82.29166666666666,82.29166666666666,0.0,94.27409791631374,91.83466034219889,2.439437574114848,A Creuser
4201,0,2019-06-06,133234,VELOUTE FRUIX PANACHE 125X12 D,1,0,0,VELOUTE,0,Villecomtal(FR),0077,0024 FR LILPARK (DC),2551,5903,5565,5421,144,482,338,0,3352,-131.39945119560957,318,720,720,720,0,0,0,0,402,-126.41509433962264,100.0,100.0,0.0,94.27409791631374,91.83466034219889,2.439437574114848,A Creuser
4202,0,2019-06-06,133234,VELOUTE FRUIX PANACHE 125X12 D,1,0,0,VELOUTE,0,Villecomtal(FR),0085,0024 FR TOULOUSE (DC),2551,5903,5565,5421,144,482,338,0,3352,-131.39945119560957,474,1583,1296,1296,0,287,287,0,1109,-233.9662447257384,81.86986734049273,81.86986734049273,0.0,94.27409791631374,91.83466034219889,2.439437574114848,A Creuser
4203,0,2019-06-06,133234,VELOUTE FRUIX PANACHE 125X12 D,1,0,0,VELOUTE,0,Villecomtal(FR),0083,0024 FR CHAPONNAY (DC),2551,5903,5565,5421,144,482,338,0,3352,-131.39945119560957,758,1152,1152,1008,144,144,0,0,394,-51.97889182058047,100.0,87.5,12.5,94.27409791631374,91.83466034219889,2.439437574114848,A Creuser
4204,0,2019-06-06,133234,VELOUTE FRUIX PANACHE 125X12 D,1,0,0,VELOUTE,0,Villecomtal(FR),0079,0024 FR PARIS SUD (DC),2551,5903,5565,5421,144,482,338,0,3352,-131.39945119560957,157,144,144,144,0,0,0,0,-13,8.280254777070065,100.0,100.0,0.0,94.27409791631374,91.83466034219889,2.439437574114848,A Creuser
4205,0,2019-06-06,133234,VELOUTE FRUIX PANACHE 125X12 D,1,0,0,VELOUTE,0,Villecomtal(FR),0078,0024 FR PARIS NORD (DC),2551,5903,5565,5421,144,482,338,0,3352,-131.39945119560957,194,1008,1008,1008,0,0,0,0,814,-419.58762886597935,100.0,100.0,0.0,94.27409791631374,91.83466034219889,2.439437574114848,A Creuser
4206,0,2019-06-06,146531,L2V BRASS NAT 115X4,0,0,0,LES 2 VACHES,0,LeMolay(FR),0084,0024 FR AIX (DC),2631,3398,3398,2117,1281,1281,0,0,767,-29.152413530976816,411,416,416,0,416,416,0,0,5,-1.2165450121654502,100.0,0.0,100.0,100.0,62.30135373749264,37.69864626250736,Production
4207,0,2019-06-06,146531,L2V BRASS NAT 115X4,0,0,0,LES 2 VACHES,0,LeMolay(FR),0080,0024 FR METZ (DC),2631,3398,3398,2117,1281,1281,0,0,767,-29.152413530976816,224,203,203,203,0,0,0,0,-21,9.375,100.0,100.0,0.0,100.0,62.30135373749264,37.69864626250736,Production
4208,0,2019-06-06,146531,L2V BRASS NAT 115X4,0,0,0,LES 2 VACHES,0,LeMolay(FR),0081,0024 FR TOURS (DC),2631,3398,3398,2117,1281,1281,0,0,767,-29.152413530976816,318,456,456,456,0,0,0,0,138,-43.39622641509434,100.0,100.0,0.0,100.0,62.30135373749264,37.69864626250736,Production
4209,0,2019-06-06,146531,L2V BRASS NAT 115X4,0,0,0,LES 2 VACHES,0,LeMolay(FR),0082,0024 FR VALLET (DC),2631,3398,3398,2117,1281,1281,0,0,767,-29.152413530976816,206,286,286,286,0,0,0,0,80,-38.83495145631068,100.0,100.0,0.0,100.0,62.30135373749264,37.69864626250736,Production
4210,0,2019-06-06,146531,L2V BRASS NAT 115X4,0,0,0,LES 2 VACHES,0,LeMolay(FR),0077,0024 FR LILPARK (DC),2631,3398,3398,2117,1281,1281,0,0,767,-29.152413530976816,135,165,165,75,90,90,0,0,30,-22.22222222222222,100.0,45.45454545454545,54.54545454545455,100.0,62.30135373749264,37.69864626250736,Production
4211,0,2019-06-06,146531,L2V BRASS NAT 115X4,0,0,0,LES 2 VACHES,0,LeMolay(FR),0085,0024 FR TOULOUSE (DC),2631,3398,3398,2117,1281,1281,0,0,767,-29.152413530976816,338,364,364,169,195,195,0,0,26,-7.6923076923076925,100.0,46.42857142857143,53.57142857142857,100.0,62.30135373749264,37.69864626250736,Production
4212,0,2019-06-06,146531,L2V BRASS NAT 115X4,0,0,0,LES 2 VACHES,0,LeMolay(FR),0083,0024 FR CHAPONNAY (DC),2631,3398,3398,2117,1281,1281,0,0,767,-29.152413530976816,376,547,547,547,0,0,0,0,171,-45.47872340425532,100.0,100.0,0.0,100.0,62.30135373749264,37.69864626250736,Production
4213,0,2019-06-06,146531,L2V BRASS NAT 115X4,0,0,0,LES 2 VACHES,0,LeMolay(FR),0079,0024 FR PARIS SUD (DC),2631,3398,3398,2117,1281,1281,0,0,767,-29.152413530976816,306,504,504,202,302,302,0,0,198,-64.70588235294117,100.0,40.07936507936508,59.92063492063492,100.0,62.30135373749264,37.69864626250736,Production
4214,0,2019-06-06,146531,L2V BRASS NAT 115X4,0,0,0,LES 2 VACHES,0,LeMolay(FR),0078,0024 FR PARIS NORD (DC),2631,3398,3398,2117,1281,1281,0,0,767,-29.152413530976816,317,457,457,179,278,278,0,0,140,-44.16403785488959,100.0,39.16849015317287,60.83150984682713,100.0,62.30135373749264,37.69864626250736,Production
4215,0,2019-06-06,148355,ACTIVIA SHOT NAT 80X6,0,1,0,ACTIVIA,1,Benesov(CZ),0084,0024 FR AIX (DC),563,20760,502,178,324,20582,20258,0,20197,-3587.3889875666073,56,37,37,0,37,37,0,0,-19,33.92857142857143,100.0,0.0,100.0,2.418111753371869,0.8574181117533719,1.560693641618497,Client
4216,0,2019-06-06,148355,ACTIVIA SHOT NAT 80X6,0,1,0,ACTIVIA,1,Benesov(CZ),0080,0024 FR METZ (DC),563,20760,502,178,324,20582,20258,0,20197,-3587.3889875666073,33,48,48,48,0,0,0,0,15,-45.45454545454545,100.0,100.0,0.0,2.418111753371869,0.8574181117533719,1.560693641618497,Client
4217,0,2019-06-06,148355,ACTIVIA SHOT NAT 80X6,0,1,0,ACTIVIA,1,Benesov(CZ),0081,0024 FR TOURS (DC),563,20760,502,178,324,20582,20258,0,20197,-3587.3889875666073,44,36,36,36,0,0,0,0,-8,18.181818181818183,100.0,100.0,0.0,2.418111753371869,0.8574181117533719,1.560693641618497,Client
4218,0,2019-06-06,148355,ACTIVIA SHOT NAT 80X6,0,1,0,ACTIVIA,1,Benesov(CZ),0082,0024 FR VALLET (DC),563,20760,502,178,324,20582,20258,0,20197,-3587.3889875666073,33,14,14,14,0,0,0,0,-19,57.57575757575758,100.0,100.0,0.0,2.418111753371869,0.8574181117533719,1.560693641618497,Client
4219,0,2019-06-06,148355,ACTIVIA SHOT NAT 80X6,0,1,0,ACTIVIA,1,Benesov(CZ),0077,0024 FR LILPARK (DC),563,20760,502,178,324,20582,20258,0,20197,-3587.3889875666073,67,70,15,15,0,55,55,0,3,-4.477611940298507,21.428571428571427,21.428571428571427,0.0,2.418111753371869,0.8574181117533719,1.560693641618497,Client
4220,0,2019-06-06,148355,ACTIVIA SHOT NAT 80X6,0,1,0,ACTIVIA,1,Benesov(CZ),0085,0024 FR TOULOUSE (DC),563,20760,502,178,324,20582,20258,0,20197,-3587.3889875666073,75,89,89,0,89,89,0,0,14,-18.666666666666668,100.0,0.0,100.0,2.418111753371869,0.8574181117533719,1.560693641618497,Client
4221,0,2019-06-06,148355,ACTIVIA SHOT NAT 80X6,0,1,0,ACTIVIA,1,Benesov(CZ),0083,0024 FR CHAPONNAY (DC),563,20760,502,178,324,20582,20258,0,20197,-3587.3889875666073,94,79,67,8,59,71,12,0,-15,15.957446808510639,84.81012658227847,10.126582278481013,74.68354430379746,2.418111753371869,0.8574181117533719,1.560693641618497,Client
4222,0,2019-06-06,148355,ACTIVIA SHOT NAT 80X6,0,1,0,ACTIVIA,1,Benesov(CZ),0079,0024 FR PARIS SUD (DC),563,20760,502,178,324,20582,20258,0,20197,-3587.3889875666073,94,330,139,0,139,330,191,0,236,-251.06382978723406,42.12121212121212,0.0,42.12121212121212,2.418111753371869,0.8574181117533719,1.560693641618497,Client
4223,0,2019-06-06,148355,ACTIVIA SHOT NAT 80X6,0,1,0,ACTIVIA,1,Benesov(CZ),0078,0024 FR PARIS NORD (DC),563,20760,502,178,324,20582,20258,0,20197,-3587.3889875666073,67,20057,57,57,0,20000,20000,0,19990,-29835.82089552239,0.28419005833374883,0.28419005833374883,0.0,2.418111753371869,0.8574181117533719,1.560693641618497,Client
4224,1,2019-06-07,133126,LIGHT & FREE MYRTILLE 120X4 OD,1,0,0,LIGHT & FREE,0,Ferrières(FR),0084,0024 FR AIX (DC),34,492,487,450,37,42,5,0,458,-1347.0588235294117,34,34,34,0,34,34,0,0,0,0.0,100.0,0.0,100.0,98.98373983739837,91.46341463414635,7.520325203252028,Déploiement/Quarantaine
4225,0,2019-06-07,140280,Activia chia/raspb/muesli 170g FR-copack,0,0,0,ACTIVIA,1,Roumanie(RO),0081,0024 FR TOURS (DC),245,477,243,69,174,408,234,0,232,-94.6938775510204,72,156,38,37,1,119,118,0,84,-116.66666666666667,24.358974358974358,23.717948717948715,0.6410256410256423,50.943396226415096,14.465408805031446,36.47798742138365,Transport
4226,0,2019-06-07,140280,Activia chia/raspb/muesli 170g FR-copack,0,0,0,ACTIVIA,1,Roumanie(RO),0082,0024 FR VALLET (DC),245,477,243,69,174,408,234,0,232,-94.6938775510204,75,202,202,29,173,173,0,0,127,-169.33333333333334,100.0,14.356435643564355,85.64356435643565,50.943396226415096,14.465408805031446,36.47798742138365,Transport
4227,0,2019-06-07,140280,Activia chia/raspb/muesli 170g FR-copack,0,0,0,ACTIVIA,1,Roumanie(RO),0083,0024 FR CHAPONNAY (DC),245,477,243,69,174,408,234,0,232,-94.6938775510204,98,119,3,3,0,116,116,0,21,-21.428571428571427,2.5210084033613445,2.5210084033613445,0.0,50.943396226415096,14.465408805031446,36.47798742138365,Transport
4228,1,2019-06-07,140838,ACTIVIA BIO NATURE 125X4,0,0,0,ACTIVIA,0,Bailleul(FR),0080,0024 FR METZ (DC),119,1862,1862,1730,132,132,0,0,1743,-1464.7058823529412,119,134,134,2,132,132,0,0,15,-12.605042016806722,100.0,1.4925373134328357,98.50746268656717,100.0,92.9108485499463,7.089151450053706,Qualité
4229,0,2019-06-07,146376,L2V BRASS VAN 115X4,0,0,0,LES 2 VACHES,0,LeMolay(FR),0084,0024 FR AIX (DC),6125,5440,2484,2443,41,2997,2956,0,-685,11.183673469387756,603,596,443,404,39,192,153,0,-7,1.1608623548922057,74.32885906040269,67.78523489932886,6.543624161073836,45.661764705882355,44.908088235294116,0.7536764705882391,Production
4230,0,2019-06-07,146376,L2V BRASS VAN 115X4,0,0,0,LES 2 VACHES,0,LeMolay(FR),0081,0024 FR TOURS (DC),6125,5440,2484,2443,41,2997,2956,0,-685,11.183673469387756,764,914,479,479,0,435,435,0,150,-19.63350785340314,52.4070021881838,52.4070021881838,0.0,45.661764705882355,44.908088235294116,0.7536764705882391,Production
4231,0,2019-06-07,146376,L2V BRASS VAN 115X4,0,0,0,LES 2 VACHES,0,LeMolay(FR),0082,0024 FR VALLET (DC),6125,5440,2484,2443,41,2997,2956,0,-685,11.183673469387756,526,572,252,250,2,322,320,0,46,-8.745247148288973,44.05594405594406,43.70629370629371,0.3496503496503536,45.661764705882355,44.908088235294116,0.7536764705882391,Production
4232,0,2019-06-07,146376,L2V BRASS VAN 115X4,0,0,0,LES 2 VACHES,0,LeMolay(FR),0077,0024 FR LILPARK (DC),6125,5440,2484,2443,41,2997,2956,0,-685,11.183673469387756,391,326,234,234,0,92,92,0,-65,16.624040920716112,71.77914110429448,71.77914110429448,0.0,45.661764705882355,44.908088235294116,0.7536764705882391,Production
4233,0,2019-06-07,146376,L2V BRASS VAN 115X4,0,0,0,LES 2 VACHES,0,LeMolay(FR),0085,0024 FR TOULOUSE (DC),6125,5440,2484,2443,41,2997,2956,0,-685,11.183673469387756,912,755,361,361,0,394,394,0,-157,17.214912280701753,47.81456953642384,47.81456953642384,0.0,45.661764705882355,44.908088235294116,0.7536764705882391,Production
4234,0,2019-06-07,146376,L2V BRASS VAN 115X4,0,0,0,LES 2 VACHES,0,LeMolay(FR),0083,0024 FR CHAPONNAY (DC),6125,5440,2484,2443,41,2997,2956,0,-685,11.183673469387756,780,637,85,85,0,552,552,0,-143,18.333333333333332,13.343799058084773,13.343799058084773,0.0,45.661764705882355,44.908088235294116,0.7536764705882391,Production
4235,0,2019-06-07,146376,L2V BRASS VAN 115X4,0,0,0,LES 2 VACHES,0,LeMolay(FR),0079,0024 FR PARIS SUD (DC),6125,5440,2484,2443,41,2997,2956,0,-685,11.183673469387756,1428,1004,511,511,0,493,493,0,-424,29.69187675070028,50.896414342629484,50.896414342629484,0.0,45.661764705882355,44.908088235294116,0.7536764705882391,Production
4236,0,2019-06-07,146376,L2V BRASS VAN 115X4,0,0,0,LES 2 VACHES,0,LeMolay(FR),0078,0024 FR PARIS NORD (DC),6125,5440,2484,2443,41,2997,2956,0,-685,11.183673469387756,721,636,119,119,0,517,517,0,-85,11.789181692094314,18.71069182389937,18.71069182389937,0.0,45.661764705882355,44.908088235294116,0.7536764705882391,Production
4237,0,2019-06-07,146534,L2V BRASS CIT 115X4,0,0,0,LES 2 VACHES,0,LeMolay(FR),0084,0024 FR AIX (DC),5256,4699,3491,3446,45,1253,1208,0,-557,10.597412480974125,125,191,62,62,0,129,129,0,66,-52.8,32.460732984293195,32.460732984293195,0.0,74.29240263885933,73.33475207490956,0.9576505639497697,Production
4238,0,2019-06-07,146534,L2V BRASS CIT 115X4,0,0,0,LES 2 VACHES,0,LeMolay(FR),0080,0024 FR METZ (DC),5256,4699,3491,3446,45,1253,1208,0,-557,10.597412480974125,743,787,609,608,1,179,178,0,44,-5.921938088829071,77.38246505717916,77.2554002541296,0.12706480304956358,74.29240263885933,73.33475207490956,0.9576505639497697,Production
4239,0,2019-06-07,146534,L2V BRASS CIT 115X4,0,0,0,LES 2 VACHES,0,LeMolay(FR),0081,0024 FR TOURS (DC),5256,4699,3491,3446,45,1253,1208,0,-557,10.597412480974125,797,763,734,733,1,30,29,0,-34,4.265997490589712,96.19921363040629,96.06815203145477,0.13106159895151848,74.29240263885933,73.33475207490956,0.9576505639497697,Production
4240,0,2019-06-07,146534,L2V BRASS CIT 115X4,0,0,0,LES 2 VACHES,0,LeMolay(FR),0082,0024 FR VALLET (DC),5256,4699,3491,3446,45,1253,1208,0,-557,10.597412480974125,1059,1059,772,762,10,297,287,0,0,0.0,72.8989612842304,71.95467422096317,0.9442870632672253,74.29240263885933,73.33475207490956,0.9576505639497697,Production
4241,0,2019-06-07,146534,L2V BRASS CIT 115X4,0,0,0,LES 2 VACHES,0,LeMolay(FR),0077,0024 FR LILPARK (DC),5256,4699,3491,3446,45,1253,1208,0,-557,10.597412480974125,129,98,32,0,32,98,66,0,-31,24.031007751937985,32.6530612244898,0.0,32.6530612244898,74.29240263885933,73.33475207490956,0.9576505639497697,Production
4242,0,2019-06-07,146534,L2V BRASS CIT 115X4,0,0,0,LES 2 VACHES,0,LeMolay(FR),0085,0024 FR TOULOUSE (DC),5256,4699,3491,3446,45,1253,1208,0,-557,10.597412480974125,1012,991,733,733,0,258,258,0,-21,2.075098814229249,73.9656912209889,73.9656912209889,0.0,74.29240263885933,73.33475207490956,0.9576505639497697,Production
4243,0,2019-06-07,146534,L2V BRASS CIT 115X4,0,0,0,LES 2 VACHES,0,LeMolay(FR),0083,0024 FR CHAPONNAY (DC),5256,4699,3491,3446,45,1253,1208,0,-557,10.597412480974125,251,193,193,193,0,0,0,0,-58,23.10756972111554,100.0,100.0,0.0,74.29240263885933,73.33475207490956,0.9576505639497697,Production
4244,0,2019-06-07,146534,L2V BRASS CIT 115X4,0,0,0,LES 2 VACHES,0,LeMolay(FR),0079,0024 FR PARIS SUD (DC),5256,4699,3491,3446,45,1253,1208,0,-557,10.597412480974125,916,311,200,200,0,111,111,0,-605,66.04803493449782,64.30868167202573,64.30868167202573,0.0,74.29240263885933,73.33475207490956,0.9576505639497697,Production
4245,0,2019-06-07,146534,L2V BRASS CIT 115X4,0,0,0,LES 2 VACHES,0,LeMolay(FR),0078,0024 FR PARIS NORD (DC),5256,4699,3491,3446,45,1253,1208,0,-557,10.597412480974125,224,306,156,155,1,151,150,0,82,-36.607142857142854,50.98039215686274,50.65359477124183,0.32679738562091387,74.29240263885933,73.33475207490956,0.9576505639497697,Production
4246,1,2019-06-07,147034,ACTIVIA 4x120g(x6) HONEY FR,0,1,0,ACTIVIA,1,Ochsenfurt(ALL),0083,0024 FR CHAPONNAY (DC),138,408,398,371,27,37,10,0,270,-195.65217391304347,138,130,120,93,27,37,10,0,-8,5.797101449275362,92.3076923076923,71.53846153846153,20.769230769230774,97.54901960784314,90.93137254901961,6.617647058823522,Transport
4247,1,2019-06-07,147035,ACTIVIA 4x120g(x6) COCONUT FR,0,1,0,ACTIVIA,1,Ochsenfurt(ALL),0084,0024 FR AIX (DC),441,772,525,408,117,364,247,0,331,-75.05668934240363,88,99,43,43,0,56,56,0,11,-12.5,43.43434343434344,43.43434343434344,0.0,68.00518134715026,52.84974093264248,15.155440414507773,Transport
4248,1,2019-06-07,147035,ACTIVIA 4x120g(x6) COCONUT FR,0,1,0,ACTIVIA,1,Ochsenfurt(ALL),0082,0024 FR VALLET (DC),441,772,525,408,117,364,247,0,331,-75.05668934240363,147,155,74,71,3,84,81,0,8,-5.442176870748299,47.74193548387097,45.806451612903224,1.9354838709677438,68.00518134715026,52.84974093264248,15.155440414507773,Transport
4249,1,2019-06-07,147035,ACTIVIA 4x120g(x6) COCONUT FR,0,1,0,ACTIVIA,1,Ochsenfurt(ALL),0083,0024 FR CHAPONNAY (DC),441,772,525,408,117,364,247,0,331,-75.05668934240363,160,163,163,51,112,112,0,0,3,-1.875,100.0,31.28834355828221,68.71165644171779,68.00518134715026,52.84974093264248,15.155440414507773,Transport
4250,1,2019-06-07,147035,ACTIVIA 4x120g(x6) COCONUT FR,0,1,0,ACTIVIA,1,Ochsenfurt(ALL),0079,0024 FR PARIS SUD (DC),441,772,525,408,117,364,247,0,331,-75.05668934240363,46,58,22,22,0,36,36,0,12,-26.08695652173913,37.93103448275862,37.93103448275862,0.0,68.00518134715026,52.84974093264248,15.155440414507773,Transport
4251,0,2019-06-07,147230,L2V GOURMEUH MARRON VAN 115X2,0,1,0,LES 2 VACHES,0,LeMolay(FR),0081,0024 FR TOURS (DC),411,386,56,54,2,332,330,0,-25,6.082725060827251,229,279,55,54,1,225,224,0,50,-21.83406113537118,19.71326164874552,19.35483870967742,0.35842293906809886,14.507772020725387,13.989637305699482,0.518134715025905,Production
4252,0,2019-06-07,147230,L2V GOURMEUH MARRON VAN 115X2,0,1,0,LES 2 VACHES,0,LeMolay(FR),0079,0024 FR PARIS SUD (DC),411,386,56,54,2,332,330,0,-25,6.082725060827251,182,107,1,0,1,107,106,0,-75,41.20879120879121,0.9345794392523363,0.0,0.9345794392523363,14.507772020725387,13.989637305699482,0.518134715025905,Production
